ID_customer;avg_ticket;total_amount;ticket_std_dev;purchases;frequency;inactive_days;web_purchases;app_purchases;mon_thur_purchases;frid_sund_purchases;lunch_purchases;evening_purchases;low_ticket;medium_ticket;big_ticket
1; 19.3 ; 38.6 ; 2.3 ;2;49;100;0;2;0;2;0;2;2;0;0
2; 28.3 ; 85.0 ; 3.0 ;3;56;22;0;3;0;3;2;1;2;1;0
3; 41.1 ; 329.1 ; 13.9 ;8;28;62;0;8;0;8;5;3;3;2;3
4; 29.6 ; 650.8 ; 8.2 ;22;16;21;0;22;5;17;6;16;15;7;0
5; 34.5 ; 172.3 ; 17.6 ;5;33;14;0;5;1;4;1;4;2;3;0
6; 20.3 ; 101.3 ; 1.0 ;5;28;25;0;5;4;1;3;2;5;0;0
7; 39.3 ; 78.7 ; 5.3 ;2;19;152;0;2;0;2;2;0;0;2;0
8; 15.6 ; 343.9 ; 2.1 ;22;11;177;0;22;14;8;5;17;22;0;0
9; 47.0 ; 657.6 ; 26.0 ;14;14;18;2;12;11;3;4;10;5;4;5
10; 29.7 ; 89.0 ; 16.9 ;3;27;38;0;3;0;3;2;1;2;1;0
11; 52.2 ; 104.3 ; 7.0 ;2;8;70;0;2;2;0;1;1;0;1;1
12; 15.0 ; 30.0 ; -   ;2;68;47;0;2;0;2;2;0;2;0;0
13; 17.7 ; 265.5 ; 5.8 ;15;22;0;0;15;4;11;6;9;15;0;0
14; 34.8 ; 139.0 ; 18.0 ;4;23;20;0;4;1;3;2;2;1;3;0
15; 39.0 ; 506.9 ; 8.7 ;13;12;82;0;13;4;9;6;7;0;13;0
16; 24.8 ; 74.3 ; 9.0 ;3;5;79;0;3;0;3;0;3;2;1;0
17; 51.4 ; 205.7 ; 2.8 ;4;23;69;0;4;0;4;2;2;0;4;0
18; 30.5 ; 61.1 ; 0.9 ;2;145;43;0;2;0;2;2;0;1;1;0
19; 26.3 ; 52.5 ; 5.1 ;2;20;92;0;2;1;1;0;2;1;1;0
20; 43.3 ; 216.3 ; 9.7 ;5;29;15;1;4;0;5;0;5;0;5;0
21; 25.5 ; 102.1 ; 16.0 ;4;40;163;0;4;1;3;4;0;3;1;0
22; 47.5 ; 570.1 ; 17.4 ;12;19;87;0;12;7;5;11;1;0;8;4
23; 33.5 ; 66.9 ; 4.9 ;2;70;148;0;2;1;1;1;1;1;1;0
24; 16.2 ; 48.6 ; 2.2 ;3;41;160;0;3;3;0;1;2;3;0;0
25; 53.2 ; 106.3 ; -   ;2;3;2;0;2;1;1;2;0;0;2;0
26; 44.9 ; 89.8 ; 12.5 ;2;13;36;0;2;0;2;1;1;0;1;1
27; 57.1 ; 171.2 ; 5.6 ;3;9;100;3;0;1;2;1;2;0;0;3
28; 45.5 ; 227.7 ; 27.1 ;5;5;3;0;5;5;0;1;4;2;1;2
29; 61.2 ; 122.3 ; 36.8 ;2;11;230;0;2;2;0;2;0;1;0;1
30; 36.6 ; 256.1 ; 22.0 ;7;23;14;7;0;3;4;5;2;2;3;2
31; 15.0 ; 45.0 ; -   ;3;30;77;0;3;1;2;1;2;3;0;0
32; 51.3 ; 153.9 ; 16.4 ;3;57;188;0;3;3;0;1;2;0;2;1
33; 47.0 ; 141.0 ; 0.4 ;3;151;99;2;1;0;3;3;0;0;3;0
34; 21.1 ; 105.3 ; 8.8 ;5;42;141;0;5;2;3;2;3;5;0;0
35; 18.3 ; 55.0 ; 6.2 ;3;28;281;0;3;3;0;0;3;3;0;0
36; 44.3 ; 88.6 ; 11.2 ;2;1;42;0;2;1;1;1;1;0;1;1
37; 21.0 ; 1,051.9 ; 11.1 ;50;7;2;0;50;18;32;32;18;33;17;0
38; 33.3 ; 66.6 ; 12.3 ;2;9;13;0;2;1;1;1;1;1;1;0
39; 25.1 ; 125.3 ; -   ;5;10;244;0;5;2;3;5;0;5;0;0
40; 19.7 ; 39.5 ; 7.1 ;2;6;272;0;2;0;2;2;0;2;0;0
41; 32.2 ; 193.3 ; 12.0 ;6;29;67;0;6;3;3;4;2;2;4;0
42; 36.6 ; 73.2 ; -   ;2;8;127;2;0;1;1;0;2;0;2;0
43; 63.3 ; 189.9 ; 10.2 ;3;118;71;0;3;1;2;3;0;0;0;3
44; 16.5 ; 33.0 ; 2.3 ;2;32;110;0;2;0;2;1;1;2;0;0
45; 36.9 ; 110.7 ; 6.4 ;3;112;149;0;3;1;2;1;2;0;3;0
46; 52.3 ; 209.1 ; 29.1 ;4;107;24;0;4;1;3;1;3;1;2;1
47; 43.1 ; 301.7 ; 16.0 ;7;21;0;0;7;1;6;6;1;2;3;2
48; 43.5 ; 695.9 ; 5.2 ;16;25;3;0;16;2;14;6;10;0;16;0
49; 99.1 ; 594.7 ; 49.6 ;6;30;194;0;6;0;6;4;2;0;0;6
50; 44.9 ; 224.3 ; 18.1 ;5;55;89;0;5;1;4;5;0;2;1;2
51; 49.3 ; 197.1 ; 4.8 ;4;41;86;0;4;1;3;4;0;0;4;0
52; 30.6 ; 337.1 ; 15.6 ;11;10;73;0;11;2;9;4;7;4;7;0
53; 51.7 ; 207.0 ; 4.1 ;4;24;42;0;4;1;3;4;0;0;3;1
54; 89.5 ; 357.9 ; 105.4 ;4;31;171;0;4;1;3;3;1;1;0;3
55; 34.2 ; 68.4 ; 10.0 ;2;12;221;0;2;0;2;0;2;1;1;0
56; 15.0 ; 30.0 ; -   ;2;5;212;0;2;1;1;0;2;2;0;0
57; 18.6 ; 37.2 ; 1.1 ;2;5;46;2;0;2;0;2;0;2;0;0
58; 50.4 ; 100.7 ; 5.4 ;2;119;11;2;0;0;2;1;1;0;1;1
59; 36.5 ; 109.6 ; 6.7 ;3;16;172;3;0;1;2;1;2;1;2;0
60; 30.5 ; 152.7 ; 15.8 ;5;46;20;0;5;0;5;2;3;2;3;0
61; 30.0 ; 60.1 ; 7.4 ;2;139;28;0;2;2;0;0;2;1;1;0
62; 64.1 ; 320.7 ; 16.8 ;5;9;179;0;5;1;4;2;3;0;0;5
63; 54.7 ; 109.3 ; 11.9 ;2;1;343;0;2;2;0;0;2;0;1;1
64; 26.8 ; 133.8 ; 16.3 ;5;32;23;0;5;3;2;2;3;3;2;0
65; 21.1 ; 105.3 ; 8.8 ;5;104;45;0;5;5;0;5;0;5;0;0
66; 24.0 ; 120.0 ; 7.3 ;5;59;2;0;5;3;2;1;4;3;2;0
67; 16.7 ; 599.5 ; 4.3 ;36;5;5;0;36;21;15;18;18;36;0;0
68; 29.8 ; 59.5 ; 7.0 ;2;45;55;0;2;2;0;2;0;1;1;0
69; 41.0 ; 287.2 ; 6.3 ;7;23;5;0;7;1;6;5;2;0;7;0
70; 27.6 ; 110.5 ; 3.1 ;4;56;120;0;4;3;1;4;0;3;1;0
71; 27.3 ; 136.3 ; 16.5 ;5;10;106;0;5;2;3;1;4;3;2;0
72; 47.5 ; 94.9 ; 1.1 ;2;221;10;0;2;0;2;0;2;0;2;0
73; 20.5 ; 205.0 ; 5.1 ;10;12;75;0;10;2;8;5;5;10;0;0
74; 37.8 ; 113.5 ; 16.3 ;3;115;80;0;3;1;2;2;1;1;2;0
75; 45.0 ; 1,304.2 ; 22.9 ;29;6;1;29;0;5;24;14;15;10;9;10
76; 23.0 ; 115.0 ; 19.0 ;5;27;10;5;0;3;2;5;0;3;2;0
77; 53.3 ; 426.1 ; 25.4 ;8;47;22;0;8;0;8;5;3;3;2;3
78; 29.3 ; 146.5 ; 13.0 ;5;13;8;0;5;4;1;3;2;3;2;0
79; 23.2 ; 162.7 ; 16.2 ;7;26;37;7;0;6;1;6;1;5;2;0
80; 57.4 ; 976.2 ; 20.1 ;17;13;20;0;17;4;13;16;1;0;0;17
81; 21.3 ; 340.1 ; 6.2 ;16;23;0;0;16;0;16;12;4;16;0;0
82; 31.4 ; 125.7 ; 2.2 ;4;35;22;4;0;0;4;3;1;1;3;0
83; 35.0 ; 140.1 ; 16.6 ;4;55;10;0;4;0;4;4;0;1;3;0
84; 25.0 ; 100.1 ; 10.6 ;4;48;90;4;0;0;4;1;3;3;1;0
85; 36.6 ; 292.9 ; 10.2 ;8;31;10;7;1;1;7;7;1;3;5;0
86; 20.0 ; 40.1 ; -   ;2;8;16;1;1;1;1;1;1;2;0;0
87; 61.3 ; 122.5 ; 14.3 ;2;221;99;0;2;0;2;2;0;0;0;2
88; 24.4 ; 48.8 ; 8.7 ;2;191;16;0;2;1;1;2;0;1;1;0
89; 47.1 ; 94.2 ; 0.5 ;2;256;47;0;2;1;1;0;2;0;2;0
90; 79.2 ; 237.6 ; 25.6 ;3;23;61;0;3;1;2;3;0;0;0;3
91; 44.6 ; 89.3 ; 25.3 ;2;7;152;0;2;0;2;2;0;1;0;1
92; 48.1 ; 96.2 ; 0.9 ;2;50;62;2;0;0;2;2;0;0;2;0
93; 17.5 ; 69.9 ; 2.9 ;4;32;28;0;4;3;1;2;2;4;0;0
94; 20.2 ; 302.7 ; 6.8 ;15;15;20;0;15;5;10;9;6;15;0;0
95; 25.5 ; 51.0 ; 4.2 ;2;84;2;0;2;2;0;2;0;2;0;0
96; 66.1 ; 132.2 ; 13.6 ;2;10;292;0;2;2;0;2;0;0;0;2
97; 47.1 ; 188.4 ; 0.8 ;4;63;21;3;1;0;4;2;2;0;4;0
98; 53.4 ; 747.7 ; 15.3 ;14;24;16;0;14;0;14;13;1;0;9;5
99; 46.7 ; 140.2 ; 0.8 ;3;168;26;0;3;2;1;1;2;0;3;0
100; 15.6 ; 77.9 ; 1.4 ;5;6;160;0;5;5;0;1;4;5;0;0
101; 24.9 ; 74.6 ; 8.0 ;3;61;179;0;3;2;1;2;1;2;1;0
102; 35.8 ; 286.5 ; 11.9 ;8;27;32;1;7;2;6;5;3;3;5;0
103; 52.6 ; 578.5 ; 11.8 ;11;18;32;11;0;0;11;11;0;0;7;4
104; 33.3 ; 166.6 ; 21.3 ;5;40;41;0;5;4;1;3;2;2;3;0
105; 30.2 ; 150.9 ; -   ;5;31;74;5;0;4;1;2;3;0;5;0
106; 20.7 ; 83.0 ; 3.1 ;4;66;66;0;4;3;1;3;1;4;0;0
107; 48.7 ; 146.1 ; 25.3 ;3;147;15;0;3;1;2;1;2;1;1;1
108; 24.4 ; 537.4 ; 9.4 ;22;14;5;0;22;6;16;14;8;15;7;0
109; 25.1 ; 50.1 ; -   ;2;45;101;0;2;2;0;0;2;2;0;0
110; 32.6 ; 260.5 ; 12.1 ;8;11;5;0;8;3;5;2;6;3;5;0
111; 33.0 ; 66.1 ; 4.6 ;2;8;8;0;2;1;1;1;1;1;1;0
112; 45.0 ; 225.1 ; 12.0 ;5;77;32;0;5;0;5;1;4;0;3;2
113; 37.1 ; 111.4 ; 12.7 ;3;56;30;0;3;3;0;1;2;1;2;0
114; 39.1 ; 273.6 ; 14.7 ;7;23;5;0;7;2;5;1;6;2;5;0
115; 23.0 ; 436.1 ; 8.1 ;19;10;20;19;0;2;17;13;6;13;6;0
116; 16.5 ; 66.0 ; 4.4 ;4;8;14;0;4;4;0;1;3;4;0;0
117; 28.3 ; 56.7 ; 2.7 ;2;125;43;2;0;0;2;1;1;1;1;0
118; 46.8 ; 93.5 ; -   ;2;9;344;0;2;1;1;0;2;0;2;0
119; 26.6 ; 159.8 ; 8.0 ;6;16;63;6;0;0;6;2;4;4;2;0
120; 36.9 ; 184.3 ; 16.6 ;5;40;69;0;5;3;2;5;0;2;3;0
121; 41.4 ; 82.7 ; 16.7 ;2;65;142;1;1;1;1;2;0;1;0;1
122; 65.0 ; 260.1 ; 37.2 ;4;12;69;0;4;0;4;1;3;1;0;3
123; 54.4 ; 163.1 ; 21.5 ;3;50;5;0;3;1;2;0;3;0;2;1
124; 29.1 ; 261.7 ; 9.2 ;9;5;145;0;9;2;7;7;2;6;3;0
125; 34.7 ; 69.3 ; 22.3 ;2;17;205;0;2;1;1;1;1;1;0;1
126; 77.9 ; 155.7 ; 41.6 ;2;74;22;0;2;0;2;1;1;0;0;2
127; 36.6 ; 219.5 ; 6.2 ;6;54;5;0;6;3;3;2;4;0;6;0
128; 38.2 ; 114.6 ; 21.6 ;3;31;149;0;3;1;2;0;3;1;1;1
129; 53.3 ; 160.0 ; 8.0 ;3;30;82;3;0;1;2;0;3;0;2;1
130; 36.6 ; 109.8 ; -   ;3;45;107;0;3;2;1;1;2;0;3;0
131; 53.7 ; 161.2 ; 1.2 ;3;79;20;0;3;0;3;3;0;0;3;0
132; 30.2 ; 60.4 ; -   ;2;80;149;2;0;1;1;2;0;0;2;0
133; 61.6 ; 308.1 ; 44.6 ;5;53;20;0;5;1;4;3;2;2;0;3
134; 36.6 ; 73.2 ; -   ;2;19;105;0;2;0;2;1;1;0;2;0
135; 49.4 ; 345.6 ; 2.8 ;7;27;15;0;7;0;7;7;0;0;7;0
136; 39.0 ; 233.9 ; 9.4 ;6;31;23;0;6;2;4;4;2;2;4;0
137; 18.6 ; 92.9 ; 9.3 ;5;26;23;0;5;2;3;2;3;5;0;0
138; 45.6 ; 182.3 ; 11.3 ;4;25;65;0;4;3;1;3;1;0;3;1
139; 52.5 ; 105.0 ; 1.1 ;2;18;62;0;2;0;2;2;0;0;2;0
140; 55.2 ; 110.4 ; 12.7 ;2;132;1;1;1;1;1;0;2;0;0;2
141; 30.3 ; 211.9 ; 0.3 ;7;23;11;0;7;1;6;2;5;0;7;0
142; 47.5 ; 189.9 ; 0.6 ;4;74;10;0;4;0;4;4;0;0;4;0
143; 23.5 ; 188.3 ; 6.8 ;8;13;40;0;8;0;8;6;2;5;3;0
144; 251.1 ; 753.4 ; 186.8 ;3;1;85;0;3;2;1;1;2;0;0;3
145; 37.1 ; 185.6 ; 6.7 ;5;6;165;5;0;4;1;2;3;0;5;0
146; 24.5 ; 122.3 ; 18.9 ;5;13;139;5;0;5;0;5;0;3;2;0
147; 46.8 ; 93.5 ; -   ;2;4;139;0;2;1;1;0;2;0;2;0
148; 32.5 ; 357.4 ; 16.1 ;11;24;22;0;11;5;6;9;2;4;7;0
149; 25.3 ; 75.9 ; 11.1 ;3;9;5;3;0;0;3;2;1;2;1;0
150; 65.6 ; 131.2 ; -   ;2;249;7;2;0;1;1;0;2;0;0;2
151; 66.1 ; 594.8 ; 34.7 ;9;39;5;0;9;0;9;9;0;0;0;9
152; 49.2 ; 196.8 ; 24.2 ;4;69;35;0;4;2;2;2;2;1;2;1
153; 55.1 ; 275.4 ; 39.9 ;5;27;40;5;0;4;1;3;2;2;0;3
154; 43.6 ; 130.7 ; -   ;3;2;45;3;0;3;0;2;1;0;3;0
155; 54.6 ; 163.8 ; 40.9 ;3;40;52;3;0;2;1;3;0;1;1;1
156; 18.7 ; 74.9 ; 7.9 ;4;16;41;0;4;3;1;1;3;4;0;0
157; 41.4 ; 455.7 ; 9.7 ;11;20;10;0;11;2;9;7;4;0;11;0
158; 20.3 ; 101.3 ; 9.5 ;5;14;152;5;0;3;2;4;1;5;0;0
159; 54.5 ; 871.2 ; 39.0 ;16;13;11;16;0;9;7;9;7;5;6;5
160; 20.0 ; 40.1 ; 7.6 ;2;18;111;0;2;0;2;0;2;2;0;0
161; 50.9 ; 101.8 ; 31.3 ;2;176;141;0;2;0;2;1;1;1;0;1
162; 43.2 ; 216.2 ; 10.5 ;5;32;95;0;5;1;4;3;2;0;5;0
163; 15.0 ; 74.9 ; -   ;5;70;41;0;5;4;1;4;1;5;0;0
164; 49.7 ; 149.2 ; 21.6 ;3;25;181;3;0;3;0;1;2;1;1;1
165; 29.9 ; 149.5 ; 11.0 ;5;3;200;0;5;1;4;4;1;3;2;0
166; 51.4 ; 102.9 ; 7.0 ;2;14;104;2;0;0;2;1;1;0;1;1
167; 41.2 ; 123.7 ; 12.9 ;3;11;17;0;3;2;1;1;2;1;2;0
168; 40.6 ; 121.7 ; 24.2 ;3;30;24;0;3;1;2;1;2;1;1;1
169; 26.6 ; 53.2 ; 2.3 ;2;26;43;2;0;1;1;1;1;2;0;0
170; 51.2 ; 153.7 ; 2.3 ;3;42;148;3;0;2;1;3;0;0;3;0
171; 35.4 ; 70.7 ; 30.5 ;2;23;41;2;0;2;0;0;2;1;0;1
172; 47.5 ; 94.9 ; -   ;2;6;26;0;2;0;2;1;1;0;2;0
173; 32.6 ; 456.0 ; 9.4 ;14;13;25;0;14;8;6;7;7;5;9;0
174; 42.7 ; 170.9 ; 16.6 ;4;59;69;0;4;1;3;1;3;1;2;1
175; 36.0 ; 324.0 ; 10.4 ;9;23;5;0;9;0;9;2;7;3;6;0
176; 17.3 ; 34.7 ; 3.5 ;2;1;335;0;2;0;2;0;2;2;0;0
177; 15.0 ; 30.0 ; -   ;2;45;173;2;0;0;2;2;0;2;0;0
178; 52.9 ; 158.6 ; 14.4 ;3;65;4;0;3;3;0;1;2;0;2;1
179; 54.9 ; 219.4 ; 26.6 ;4;13;134;4;0;3;1;1;3;1;2;1
180; 53.9 ; 107.8 ; 9.6 ;2;5;37;0;2;0;2;2;0;0;1;1
181; 28.1 ; 56.3 ; 4.6 ;2;36;179;0;2;0;2;0;2;1;1;0
182; 25.1 ; 75.4 ; 9.3 ;3;59;161;0;3;2;1;1;2;2;1;0
183; 49.3 ; 147.8 ; 4.0 ;3;72;32;0;3;0;3;2;1;0;3;0
184; 38.5 ; 76.9 ; 3.7 ;2;13;31;2;0;0;2;1;1;0;2;0
185; 43.8 ; 87.7 ; 20.4 ;2;44;131;2;0;0;2;0;2;1;0;1
186; 21.1 ; 42.3 ; 2.1 ;2;164;44;0;2;2;0;2;0;2;0;0
187; 26.2 ; 445.9 ; 23.3 ;17;11;12;0;17;4;13;8;9;11;6;0
188; 37.0 ; 74.0 ; 10.5 ;2;1;363;0;2;1;1;2;0;1;1;0
189; 30.8 ; 123.0 ; 14.4 ;4;88;47;0;4;1;3;4;0;1;3;0
190; 46.8 ; 93.5 ; -   ;2;5;213;1;1;2;0;1;1;0;2;0
191; 15.0 ; 89.9 ; -   ;6;39;15;2;4;0;6;5;1;6;0;0
192; 60.5 ; 181.5 ; 55.5 ;3;95;11;0;3;1;2;3;0;1;0;2
193; 58.0 ; 115.9 ; 14.0 ;2;184;30;0;2;1;1;1;1;0;0;2
194; 46.5 ; 139.5 ; 12.8 ;3;13;47;1;2;0;3;1;2;0;2;1
195; 47.3 ; 141.8 ; 17.5 ;3;158;17;0;3;2;1;1;2;1;1;1
196; 83.8 ; 922.2 ; 21.5 ;11;18;26;0;11;0;11;11;0;0;0;11
197; 44.6 ; 312.5 ; 20.9 ;7;32;31;0;7;1;6;7;0;2;3;2
198; 29.8 ; 149.1 ; 12.8 ;5;47;76;0;5;3;2;1;4;3;2;0
199; 47.5 ; 94.9 ; -   ;2;46;62;2;0;1;1;0;2;0;2;0
200; 50.1 ; 100.3 ; -   ;2;142;125;0;2;1;1;0;2;0;2;0
201; 51.0 ; 101.9 ; 3.4 ;2;7;78;0;2;0;2;2;0;0;2;0
202; 37.4 ; 112.3 ; 13.8 ;3;37;31;3;0;2;1;3;0;1;2;0
203; 16.8 ; 101.0 ; 3.9 ;6;19;18;2;4;3;3;4;2;6;0;0
204; 35.9 ; 71.8 ; 16.2 ;2;52;217;0;2;2;0;1;1;1;1;0
205; 33.4 ; 233.7 ; 3.6 ;7;28;5;0;7;1;6;4;3;2;5;0
206; 68.3 ; 819.8 ; 28.2 ;12;12;28;0;12;5;7;2;10;0;0;12
207; 24.1 ; 96.3 ; 6.6 ;4;29;31;0;4;1;3;1;3;3;1;0
208; 23.2 ; 69.7 ; 8.0 ;3;63;9;1;2;2;1;2;1;2;1;0
209; 30.2 ; 60.5 ; 5.6 ;2;12;196;0;2;2;0;1;1;1;1;0
210; 36.6 ; 73.2 ; -   ;2;19;183;0;2;0;2;0;2;0;2;0
211; 31.6 ; 63.1 ; 7.6 ;2;5;43;0;2;0;2;1;1;1;1;0
212; 56.7 ; 113.5 ; 10.7 ;2;42;91;2;0;1;1;1;1;0;0;2
213; 50.6 ; 151.8 ; 25.2 ;3;50;20;0;3;0;3;2;1;1;1;1
214; 47.1 ; 94.2 ; 0.5 ;2;118;100;2;0;1;1;0;2;0;2;0
215; 30.8 ; 61.7 ; 8.6 ;2;124;160;0;2;2;0;1;1;1;1;0
216; 59.6 ; 119.3 ; 9.2 ;2;18;154;0;2;1;1;1;1;0;0;2
217; 23.6 ; 47.3 ; 3.8 ;2;84;226;0;2;1;1;1;1;2;0;0
218; 52.1 ; 104.2 ; 1.6 ;2;105;16;1;1;0;2;2;0;0;2;0
219; 90.4 ; 271.3 ; 5.5 ;3;25;0;0;3;0;3;2;1;0;0;3
220; 30.6 ; 152.8 ; 9.6 ;5;33;15;0;5;1;4;4;1;2;3;0
221; 58.2 ; 1,572.1 ; 24.5 ;27;12;5;0;27;2;25;25;2;0;0;27
222; 47.1 ; 282.3 ; 0.6 ;6;40;22;0;6;0;6;2;4;0;6;0
223; 58.5 ; 175.5 ; 6.1 ;3;68;113;0;3;1;2;2;1;0;0;3
224; 52.4 ; 261.8 ; 26.1 ;5;5;57;0;5;3;2;0;5;2;1;2
225; 26.8 ; 322.1 ; 11.2 ;12;20;20;0;12;6;6;5;7;8;4;0
226; 33.2 ; 66.4 ; 4.5 ;2;133;28;2;0;2;0;2;0;1;1;0
227; 29.1 ; 87.2 ; 8.0 ;3;72;26;2;1;0;3;2;1;2;1;0
228; 47.5 ; 94.9 ; -   ;2;19;78;2;0;0;2;2;0;0;2;0
229; 60.6 ; 545.4 ; 15.8 ;9;21;110;0;9;1;8;8;1;0;0;9
230; 57.7 ; 115.3 ; 0.3 ;2;136;110;1;1;1;1;2;0;0;0;2
231; 57.1 ; 114.3 ; 14.5 ;2;202;53;1;1;0;2;2;0;0;0;2
232; 21.3 ; 276.5 ; 5.6 ;13;11;184;0;13;1;12;9;4;13;0;0
233; 16.0 ; 80.2 ; 1.6 ;5;16;107;0;5;4;1;5;0;5;0;0
234; 72.5 ; 362.6 ; 12.3 ;5;48;120;0;5;0;5;5;0;0;0;5
235; 36.8 ; 147.3 ; 17.2 ;4;16;74;0;4;1;3;2;2;1;3;0
236; 19.7 ; 216.3 ; 11.7 ;11;12;5;0;11;6;5;8;3;7;4;0
237; 50.3 ; 301.5 ; 12.1 ;6;25;16;0;6;2;4;2;4;0;4;2
238; 18.8 ; 56.5 ; 5.7 ;3;13;31;0;3;0;3;3;0;3;0;0
239; 20.4 ; 81.5 ; 6.8 ;4;40;8;0;4;2;2;1;3;4;0;0
240; 37.4 ; 74.9 ; 16.9 ;2;130;113;0;2;2;0;2;0;1;1;0
241; 35.0 ; 490.4 ; 7.1 ;14;23;32;0;14;6;8;6;8;5;9;0
242; 48.4 ; 193.7 ; 5.5 ;4;55;5;0;4;0;4;3;1;0;4;0
243; 47.0 ; 281.9 ; 13.3 ;6;23;5;0;6;0;6;6;0;0;4;2
244; 16.4 ; 82.1 ; 2.1 ;5;68;19;0;5;2;3;3;2;5;0;0
245; 21.8 ; 43.7 ; 4.9 ;2;95;16;0;2;0;2;2;0;2;0;0
246; 34.2 ; 102.6 ; 16.6 ;3;11;116;0;3;2;1;2;1;1;2;0
247; 15.0 ; 30.0 ; -   ;2;41;21;0;2;1;1;1;1;2;0;0
248; 38.7 ; 232.3 ; 9.1 ;6;20;127;0;6;2;4;3;3;2;4;0
249; 44.2 ; 221.1 ; 7.7 ;5;47;15;0;5;3;2;2;3;0;5;0
250; 27.8 ; 83.3 ; 9.5 ;3;28;53;3;0;0;3;1;2;2;1;0
251; 22.4 ; 111.8 ; 5.0 ;5;56;34;0;5;2;3;1;4;5;0;0
252; 17.3 ; 34.7 ; 3.5 ;2;25;7;2;0;2;0;0;2;2;0;0
253; 41.4 ; 206.9 ; 23.4 ;5;13;52;1;4;2;3;4;1;2;1;2
254; 28.5 ; 426.9 ; 15.4 ;15;14;9;13;2;9;6;3;12;10;5;0
255; 29.8 ; 387.5 ; 8.8 ;13;17;11;0;13;3;10;1;12;9;4;0
256; 44.2 ; 88.3 ; 11.3 ;2;38;68;0;2;0;2;2;0;0;1;1
257; 45.9 ; 229.4 ; 11.0 ;5;51;14;0;5;2;3;5;0;0;3;2
258; 51.7 ; 155.2 ; 9.1 ;3;50;78;3;0;0;3;3;0;0;2;1
259; 31.3 ; 156.3 ; 12.8 ;5;23;15;4;1;3;2;5;0;2;3;0
260; 75.9 ; 151.8 ; 35.0 ;2;7;250;0;2;2;0;2;0;0;0;2
261; 28.0 ; 84.1 ; 15.6 ;3;157;13;0;3;2;1;1;2;2;1;0
262; 25.7 ; 128.4 ; 5.3 ;5;16;153;0;5;3;2;1;4;3;2;0
263; 15.9 ; 31.8 ; 1.4 ;2;51;231;0;2;0;2;1;1;2;0;0
264; 66.7 ; 200.0 ; 13.7 ;3;83;125;0;3;0;3;3;0;0;0;3
265; 19.6 ; 39.2 ; 2.7 ;2;6;203;0;2;2;0;0;2;2;0;0
266; 72.3 ; 289.0 ; 16.1 ;4;46;53;0;4;2;2;1;3;0;0;4
267; 20.5 ; 143.6 ; 7.2 ;7;41;25;0;7;3;4;3;4;7;0;0
268; 41.8 ; 167.0 ; 8.9 ;4;73;23;0;4;1;3;2;2;0;4;0
269; 15.7 ; 62.8 ; 0.9 ;4;1;7;0;4;3;1;2;2;4;0;0
270; 21.0 ; 63.1 ; 4.8 ;3;7;186;0;3;2;1;3;0;3;0;0
271; 42.8 ; 128.4 ; 11.4 ;3;113;79;2;1;0;3;2;1;0;3;0
272; 18.8 ; 150.3 ; 6.9 ;8;19;133;1;7;6;2;8;0;8;0;0
273; 44.8 ; 223.9 ; 22.2 ;5;16;21;0;5;3;2;1;4;2;1;2
274; 27.5 ; 109.9 ; 21.2 ;4;40;32;0;4;0;4;4;0;3;1;0
275; 45.1 ; 1,036.9 ; 13.0 ;23;9;1;0;23;13;10;6;17;0;15;8
276; 94.1 ; 188.2 ; 54.8 ;2;5;37;0;2;0;2;2;0;0;0;2
277; 40.9 ; 614.2 ; 14.4 ;15;14;0;0;15;5;10;12;3;5;5;5
278; 46.8 ; 140.3 ; -   ;3;35;151;3;0;1;2;3;0;0;3;0
279; 24.3 ; 72.8 ; 7.5 ;3;9;25;3;0;2;1;1;2;2;1;0
280; 58.9 ; 117.8 ; 18.2 ;2;65;105;1;1;1;1;1;1;0;0;2
281; 59.9 ; 119.7 ; 19.6 ;2;75;99;0;2;0;2;1;1;0;0;2
282; 46.8 ; 93.5 ; -   ;2;5;269;0;2;0;2;2;0;0;2;0
283; 28.2 ; 535.9 ; 14.8 ;19;13;9;0;19;6;13;11;8;13;6;0
284; 55.2 ; 110.4 ; 2.3 ;2;37;78;0;2;0;2;2;0;0;0;2
285; 61.6 ; 123.3 ; 18.1 ;2;86;160;0;2;1;1;2;0;0;0;2
286; 47.2 ; 236.1 ; 24.6 ;5;33;141;0;5;0;5;3;2;2;1;2
287; 47.1 ; 94.2 ; 0.5 ;2;163;41;0;2;0;2;2;0;0;2;0
288; 33.6 ; 67.3 ; 22.5 ;2;15;63;0;2;1;1;1;1;1;0;1
289; 31.5 ; 189.1 ; 3.7 ;6;32;47;6;0;1;5;3;3;2;4;0
290; 34.0 ; 102.0 ; 12.0 ;3;163;33;0;3;1;2;2;1;1;2;0
291; 15.0 ; 30.0 ; -   ;2;18;80;0;2;0;2;0;2;2;0;0
292; 39.5 ; 118.6 ; 13.3 ;3;13;158;1;2;1;2;1;2;1;2;0
293; 85.6 ; 171.2 ; 10.5 ;2;14;131;0;2;0;2;2;0;0;0;2
294; 24.9 ; 99.6 ; 15.6 ;4;38;85;4;0;2;2;3;1;3;1;0
295; 24.7 ; 49.4 ; -   ;2;25;49;0;2;2;0;0;2;2;0;0
296; 22.7 ; 136.3 ; 6.0 ;6;25;102;0;6;2;4;3;3;6;0;0
297; 25.1 ; 75.4 ; 9.3 ;3;32;94;3;0;1;2;3;0;2;1;0
298; 37.5 ; 74.9 ; 11.2 ;2;67;77;0;2;2;0;0;2;1;1;0
299; 36.5 ; 73.0 ; 9.5 ;2;31;193;0;2;2;0;0;2;1;1;0
300; 60.9 ; 304.6 ; 19.0 ;5;45;5;1;4;2;3;4;1;0;0;5
301; 15.0 ; 30.0 ; -   ;2;24;27;0;2;0;2;1;1;2;0;0
302; 50.4 ; 100.7 ; 4.3 ;2;18;68;0;2;0;2;1;1;0;2;0
303; 42.4 ; 127.3 ; 14.9 ;3;101;99;0;3;0;3;2;1;1;1;1
304; 27.6 ; 55.3 ; 3.8 ;2;15;205;2;0;1;1;0;2;1;1;0
305; 48.7 ; 97.3 ; 0.1 ;2;125;272;0;2;0;2;2;0;0;2;0
306; 49.6 ; 99.3 ; 4.3 ;2;5;320;0;2;0;2;2;0;0;2;0
307; 21.7 ; 65.1 ; 6.2 ;3;67;5;0;3;1;2;2;1;3;0;0
308; 29.9 ; 239.5 ; 2.0 ;8;30;3;5;3;3;5;6;2;5;3;0
309; 64.7 ; 129.3 ; 26.8 ;2;5;259;0;2;1;1;0;2;0;0;2
310; 39.3 ; 78.7 ; 36.5 ;2;12;89;0;2;0;2;1;1;1;0;1
311; 25.1 ; 50.1 ; -   ;2;47;44;0;2;2;0;2;0;2;0;0
312; 42.0 ; 84.1 ; 8.1 ;2;214;83;0;2;0;2;2;0;0;2;0
313; 15.0 ; 30.0 ; -   ;2;86;253;0;2;0;2;1;1;2;0;0
314; 15.7 ; 31.4 ; 1.1 ;2;34;13;0;2;1;1;1;1;2;0;0
315; 26.4 ; 79.1 ; -   ;3;2;39;0;3;2;1;2;1;3;0;0
316; 20.8 ; 291.4 ; 10.1 ;14;11;25;0;14;9;5;7;7;9;5;0
317; 52.8 ; 105.6 ; 9.1 ;2;37;173;1;1;0;2;2;0;0;1;1
318; 23.3 ; 70.0 ; 8.1 ;3;25;143;0;3;2;1;0;3;2;1;0
319; 22.4 ; 44.8 ; 9.5 ;2;88;3;0;2;2;0;2;0;1;1;0
320; 20.3 ; 40.6 ; 7.9 ;2;12;32;0;2;0;2;1;1;2;0;0
321; 43.4 ; 130.3 ; 6.3 ;3;95;26;1;2;0;3;1;2;0;3;0
322; 45.1 ; 90.3 ; 4.3 ;2;11;190;0;2;0;2;0;2;0;2;0
323; 27.2 ; 108.9 ; 17.0 ;4;48;88;0;4;4;0;4;0;3;1;0
324; 44.7 ; 89.4 ; 7.0 ;2;115;92;1;1;1;1;2;0;0;2;0
325; 47.5 ; 94.9 ; 24.4 ;2;24;227;0;2;1;1;1;1;1;0;1
326; 56.2 ; 112.4 ; 8.0 ;2;216;10;1;1;0;2;0;2;0;0;2
327; 56.9 ; 454.9 ; 25.5 ;8;59;0;0;8;2;6;5;3;0;0;8
328; 39.4 ; 197.2 ; 9.4 ;5;22;30;0;5;5;0;1;4;0;5;0
329; 45.4 ; 136.3 ; 2.4 ;3;16;158;1;2;2;1;1;2;0;3;0
330; 22.5 ; 89.9 ; 9.2 ;4;13;84;0;4;0;4;4;0;3;1;0
331; 64.9 ; 194.8 ; 36.6 ;3;34;161;3;0;2;1;2;1;1;0;2
332; 18.8 ; 281.6 ; 1.5 ;15;14;5;10;5;2;13;5;10;15;0;0
333; 37.8 ; 415.9 ; 16.9 ;11;14;68;0;11;4;7;8;3;4;7;0
334; 49.2 ; 98.5 ; 3.7 ;2;214;62;0;2;0;2;2;0;0;2;0
335; 36.6 ; 402.9 ; 5.9 ;11;11;0;11;0;1;10;1;10;0;11;0
336; 19.0 ; 76.2 ; 5.2 ;4;45;112;0;4;2;2;1;3;4;0;0
337; 35.2 ; 70.4 ; 7.9 ;2;163;43;0;2;0;2;1;1;1;1;0
338; 17.8 ; 249.1 ; 6.4 ;14;10;5;0;14;3;11;6;8;14;0;0
339; 46.7 ; 233.6 ; 18.5 ;5;1;290;0;5;4;1;3;2;2;1;2
340; 42.0 ; 84.1 ; 8.1 ;2;149;69;1;1;0;2;2;0;0;2;0
341; 47.7 ; 334.0 ; 19.7 ;7;11;152;1;6;0;7;7;0;2;3;2
342; 53.5 ; 427.7 ; 20.4 ;8;16;110;0;8;1;7;6;2;0;5;3
343; 35.9 ; 215.5 ; 4.7 ;6;4;101;0;6;6;0;0;6;0;6;0
344; 47.7 ; 190.9 ; 14.1 ;4;22;26;0;4;1;3;2;2;0;3;1
345; 49.2 ; 98.5 ; 3.7 ;2;94;74;2;0;0;2;2;0;0;2;0
346; 40.6 ; 81.2 ; 9.2 ;2;56;131;2;0;0;2;2;0;0;2;0
347; 74.3 ; 148.7 ; 37.1 ;2;5;178;2;0;0;2;1;1;0;0;2
348; 83.7 ; 251.0 ; 41.7 ;3;56;14;2;1;3;0;1;2;0;0;3
349; 30.2 ; 60.4 ; -   ;2;68;158;2;0;0;2;2;0;0;2;0
350; 59.8 ; 598.3 ; 22.3 ;10;1;244;0;10;3;7;6;4;0;0;10
351; 29.3 ; 263.8 ; 12.3 ;9;10;127;0;9;4;5;3;6;6;3;0
352; 71.7 ; 502.2 ; 42.4 ;7;20;90;1;6;3;4;6;1;2;0;5
353; 21.2 ; 42.4 ; 3.9 ;2;31;50;0;2;2;0;0;2;2;0;0
354; 52.3 ; 209.1 ; 7.5 ;4;56;21;0;4;1;3;4;0;0;3;1
355; 43.7 ; 218.5 ; 14.0 ;5;11;41;0;5;0;5;5;0;2;1;2
356; 67.9 ; 203.8 ; 9.7 ;3;2;203;0;3;2;1;1;2;0;0;3
357; 29.7 ; 118.7 ; 9.6 ;4;17;7;0;4;3;1;1;3;3;1;0
358; 54.6 ; 109.3 ; 3.2 ;2;21;263;0;2;1;1;0;2;0;1;1
359; 20.6 ; 41.3 ; 1.4 ;2;4;118;0;2;1;1;1;1;2;0;0
360; 20.0 ; 60.1 ; -   ;3;25;146;0;3;3;0;1;2;3;0;0
361; 46.9 ; 1,266.4 ; 1.3 ;27;9;5;0;27;14;13;9;18;0;27;0
362; 15.8 ; 47.5 ; -   ;3;13;83;2;1;3;0;1;2;3;0;0
363; 47.0 ; 141.0 ; 0.4 ;3;110;78;0;3;0;3;3;0;0;3;0
364; 59.9 ; 119.8 ; 11.1 ;2;25;158;1;1;0;2;1;1;0;0;2
365; 88.2 ; 264.7 ; 47.1 ;3;54;48;0;3;1;2;1;2;0;0;3
366; 47.4 ; 142.1 ; 2.7 ;3;49;57;3;0;1;2;3;0;0;3;0
367; 41.5 ; 373.5 ; 10.7 ;9;17;0;0;9;4;5;1;8;0;9;0
368; 32.8 ; 229.4 ; 17.1 ;7;34;3;0;7;1;6;4;3;2;5;0
369; 31.7 ; 285.0 ; 16.0 ;9;21;0;0;9;0;9;8;1;3;6;0
370; 24.6 ; 49.3 ; 14.5 ;2;75;77;2;0;2;0;1;1;1;1;0
371; 56.4 ; 564.2 ; 10.4 ;10;32;53;0;10;3;7;5;5;0;0;10
372; 23.5 ; 46.9 ; 12.7 ;2;5;95;0;2;0;2;0;2;1;1;0
373; 19.8 ; 39.6 ; 2.7 ;2;6;58;0;2;0;2;0;2;2;0;0
374; 44.4 ; 133.2 ; 2.8 ;3;14;92;3;0;3;0;0;3;0;3;0
375; 42.0 ; 84.1 ; 8.1 ;2;200;42;1;1;0;2;1;1;0;2;0
376; 15.0 ; 45.0 ; -   ;3;11;136;3;0;1;2;2;1;3;0;0
377; 24.9 ; 274.4 ; 10.3 ;11;19;0;0;11;1;10;8;3;7;4;0
378; 18.6 ; 37.2 ; -   ;2;5;104;2;0;2;0;2;0;2;0;0
379; 46.6 ; 139.9 ; 20.1 ;3;34;168;0;3;1;2;1;2;1;1;1
380; 44.2 ; 574.5 ; 24.0 ;13;8;80;0;13;3;10;8;5;4;5;4
381; 28.8 ; 115.3 ; 7.9 ;4;50;71;0;4;2;2;0;4;3;1;0
382; 47.4 ; 189.7 ; 25.4 ;4;41;141;0;4;3;1;3;1;1;2;1
383; 27.2 ; 136.1 ; 7.8 ;5;75;5;4;1;4;1;5;0;3;2;0
384; 23.1 ; 46.2 ; 3.0 ;2;6;176;0;2;2;0;0;2;2;0;0
385; 62.6 ; 125.1 ; 22.6 ;2;15;38;0;2;2;0;1;1;0;0;2
386; 40.1 ; 440.8 ; 14.1 ;11;30;28;0;11;3;8;9;2;4;7;0
387; 28.9 ; 144.5 ; 12.4 ;5;27;35;0;5;1;4;3;2;3;2;0
388; 76.9 ; 153.8 ; 11.0 ;2;5;106;2;0;0;2;0;2;0;0;2
389; 41.9 ; 125.8 ; 10.1 ;3;34;15;2;1;0;3;2;1;0;3;0
390; 54.2 ; 108.4 ; 26.4 ;2;113;31;0;2;0;2;2;0;1;0;1
391; 52.4 ; 209.5 ; 34.5 ;4;68;89;1;3;1;3;2;2;1;2;1
392; 20.1 ; 241.0 ; 6.5 ;12;8;63;0;12;6;6;5;7;12;0;0
393; 47.1 ; 94.2 ; 0.5 ;2;32;89;2;0;0;2;1;1;0;2;0
394; 51.4 ; 102.9 ; 7.0 ;2;176;120;0;2;0;2;2;0;0;1;1
395; 19.7 ; 39.5 ; -   ;2;5;44;0;2;1;1;0;2;2;0;0
396; 15.5 ; 185.4 ; 1.2 ;12;22;0;1;11;3;9;5;7;12;0;0
397; 15.0 ; 74.9 ; -   ;5;38;74;0;5;0;5;1;4;5;0;0
398; 30.2 ; 60.4 ; -   ;2;47;98;0;2;1;1;0;2;0;2;0
399; 21.6 ; 303.0 ; 13.8 ;14;23;3;0;14;7;7;7;7;9;5;0
400; 59.9 ; 539.1 ; 12.6 ;9;21;5;0;9;0;9;9;0;0;0;9
401; 17.2 ; 34.4 ; 1.2 ;2;90;44;1;1;2;0;2;0;2;0;0
402; 81.7 ; 1,307.6 ; 40.6 ;16;3;208;0;16;11;5;8;8;0;0;16
403; 47.5 ; 94.9 ; -   ;2;31;29;2;0;2;0;0;2;0;2;0
404; 56.6 ; 113.2 ; 7.6 ;2;3;151;2;0;1;1;0;2;0;0;2
405; 66.4 ; 199.1 ; 13.6 ;3;11;131;0;3;2;1;1;2;0;0;3
406; 73.3 ; 146.6 ; 10.7 ;2;12;0;0;2;0;2;2;0;0;0;2
407; 44.9 ; 179.5 ; 12.5 ;4;52;18;2;2;2;2;3;1;0;3;1
408; 52.3 ; 104.5 ; 15.3 ;2;12;69;2;0;0;2;2;0;0;1;1
409; 32.6 ; 358.3 ; 14.3 ;11;23;63;0;11;5;6;4;7;4;7;0
410; 69.4 ; 138.7 ; 20.0 ;2;31;94;0;2;1;1;2;0;0;0;2
411; 85.5 ; 342.2 ; 10.2 ;4;96;20;0;4;0;4;4;0;0;0;4
412; 18.4 ; 36.9 ; -   ;2;6;200;0;2;0;2;2;0;2;0;0
413; 20.0 ; 60.0 ; 4.8 ;3;114;25;0;3;2;1;1;2;3;0;0
414; 27.6 ; 55.3 ; 3.8 ;2;1;193;0;2;1;1;2;0;1;1;0
415; 27.9 ; 279.2 ; 16.5 ;10;27;65;0;10;5;5;10;0;7;3;0
416; 22.2 ; 44.4 ; 4.3 ;2;279;34;0;2;1;1;0;2;2;0;0
417; 61.1 ; 244.4 ; 12.6 ;4;76;0;0;4;0;4;4;0;0;0;4
418; 15.0 ; 45.0 ; -   ;3;12;119;2;1;2;1;3;0;3;0;0
419; 26.6 ; 53.2 ; 2.3 ;2;5;53;1;1;0;2;2;0;2;0;0
420; 32.2 ; 64.4 ; 10.7 ;2;2;128;0;2;1;1;1;1;1;1;0
421; 18.4 ; 36.8 ; 5.1 ;2;3;275;0;2;2;0;2;0;2;0;0
422; 42.1 ; 336.8 ; 13.6 ;8;20;4;0;8;6;2;1;7;3;2;3
423; 29.6 ; 59.3 ; 6.8 ;2;75;167;0;2;0;2;1;1;1;1;0
424; 29.0 ; 145.0 ; 10.2 ;5;33;27;0;5;1;4;4;1;3;2;0
425; 30.6 ; 367.5 ; 8.9 ;12;18;89;0;12;3;9;5;7;4;8;0
426; 16.8 ; 33.6 ; 2.7 ;2;4;8;0;2;1;1;1;1;2;0;0
427; 45.2 ; 994.5 ; 23.1 ;22;21;5;0;22;10;12;9;13;7;8;7
428; 19.7 ; 78.7 ; 0.0 ;4;86;29;0;4;4;0;4;0;4;0;0
429; 35.7 ; 285.5 ; 12.6 ;8;29;8;0;8;2;6;6;2;3;5;0
430; 33.7 ; 504.9 ; 19.5 ;15;28;0;0;15;10;5;12;3;5;10;0
431; 46.6 ; 466.3 ; 11.3 ;10;27;34;0;10;3;7;7;3;0;7;3
432; 61.4 ; 245.6 ; 26.5 ;4;5;63;0;4;2;2;2;2;0;0;4
433; 38.6 ; 154.6 ; 12.8 ;4;57;47;2;2;0;4;2;2;1;3;0
434; 65.7 ; 131.5 ; 11.3 ;2;85;17;0;2;1;1;0;2;0;0;2
435; 66.0 ; 198.0 ; 16.6 ;3;14;136;0;3;1;2;2;1;0;0;3
436; 50.1 ; 250.3 ; 13.8 ;5;50;104;1;4;4;1;4;1;0;3;2
437; 89.3 ; 178.5 ; 31.8 ;2;83;169;0;2;1;1;1;1;0;0;2
438; 28.8 ; 143.8 ; 13.7 ;5;17;17;0;5;0;5;5;0;3;2;0
439; 20.0 ; 239.6 ; 19.0 ;12;5;1;0;12;10;2;12;0;8;4;0
440; 68.2 ; 136.4 ; 7.6 ;2;43;7;0;2;1;1;0;2;0;0;2
441; 55.4 ; 110.9 ; 8.0 ;2;24;2;0;2;1;1;0;2;0;0;2
442; 37.7 ; 188.5 ; 18.0 ;5;20;107;0;5;3;2;2;3;2;1;2
443; 55.9 ; 335.2 ; 24.5 ;6;22;21;0;6;0;6;6;0;0;0;6
444; 42.9 ; 128.6 ; 11.7 ;3;45;8;3;0;3;0;1;2;0;3;0
445; 37.5 ; 224.8 ; 12.3 ;6;18;173;0;6;1;5;0;6;2;4;0
446; 36.6 ; 73.2 ; -   ;2;204;91;0;2;2;0;2;0;0;2;0
447; 38.5 ; 76.9 ; 12.4 ;2;51;188;0;2;0;2;1;1;1;1;0
448; 143.3 ; 1,289.6 ; 52.9 ;9;32;26;0;9;0;9;7;2;0;0;9
449; 36.9 ; 73.8 ; 10.0 ;2;170;125;0;2;0;2;0;2;1;1;0
450; 48.6 ; 194.5 ; -   ;4;17;237;0;4;1;3;2;2;0;4;0
451; 29.4 ; 58.9 ; 21.6 ;2;131;0;0;2;0;2;0;2;1;1;0
452; 26.4 ; 105.4 ; 15.1 ;4;39;176;0;4;1;3;2;2;3;1;0
453; 32.5 ; 260.3 ; 15.4 ;8;33;53;0;8;0;8;6;2;3;5;0
454; 39.2 ; 156.7 ; 5.5 ;4;11;20;0;4;0;4;4;0;0;4;0
455; 27.1 ; 189.7 ; 12.6 ;7;14;9;0;7;6;1;2;5;5;2;0
456; 63.3 ; 189.8 ; 27.8 ;3;34;110;0;3;0;3;3;0;0;0;3
457; 32.3 ; 742.7 ; 14.9 ;23;15;5;0;23;11;12;3;20;8;15;0
458; 25.0 ; 124.9 ; 13.0 ;5;56;9;0;5;2;3;1;4;3;2;0
459; 19.7 ; 590.3 ; 9.5 ;30;11;2;0;30;18;12;19;11;30;0;0
460; 52.1 ; 104.2 ; 33.3 ;2;79;297;0;2;1;1;0;2;1;0;1
461; 48.7 ; 243.3 ; 28.3 ;5;18;215;0;5;1;4;3;2;2;1;2
462; 29.9 ; 89.7 ; 5.0 ;3;32;115;0;3;1;2;2;1;2;1;0
463; 55.5 ; 277.6 ; 7.1 ;5;53;110;0;5;0;5;3;2;0;0;5
464; 50.5 ; 353.4 ; 14.2 ;7;33;0;7;0;1;6;7;0;0;5;2
465; 19.6 ; 39.1 ; 2.3 ;2;2;173;0;2;1;1;1;1;2;0;0
466; 56.7 ; 283.6 ; 21.4 ;5;27;20;0;5;1;4;4;1;0;0;5
467; 27.7 ; 83.0 ; 12.7 ;3;3;111;0;3;0;3;2;1;2;1;0
468; 29.4 ; 117.5 ; 10.8 ;4;14;121;0;4;1;3;2;2;3;1;0
469; 42.2 ; 253.0 ; 2.6 ;6;41;68;0;6;0;6;0;6;0;6;0
470; 20.0 ; 40.1 ; 7.6 ;2;6;267;0;2;0;2;0;2;2;0;0
471; 34.5 ; 207.0 ; 32.0 ;6;54;1;0;6;0;6;2;4;2;2;2
472; 116.5 ; 582.5 ; 28.3 ;5;38;152;0;5;0;5;4;1;0;0;5
473; 35.8 ; 107.4 ; 25.7 ;3;49;41;3;0;1;2;2;1;1;1;1
474; 19.8 ; 39.7 ; 7.3 ;2;20;133;0;2;2;0;1;1;2;0;0
475; 47.7 ; 95.5 ; 1.5 ;2;115;152;0;2;1;1;2;0;0;2;0
476; 49.8 ; 99.7 ; 10.5 ;2;21;98;2;0;1;1;2;0;0;1;1
477; 17.8 ; 142.3 ; 6.1 ;8;16;185;0;8;1;7;5;3;8;0;0
478; 19.6 ; 39.1 ; 2.3 ;2;12;36;0;2;0;2;2;0;2;0;0
479; 22.5 ; 44.9 ; 11.2 ;2;62;125;0;2;0;2;2;0;1;1;0
480; 32.7 ; 196.2 ; 14.9 ;6;11;46;0;6;2;4;0;6;2;4;0
481; 30.0 ; 149.8 ; 10.3 ;5;44;25;0;5;2;3;1;4;3;2;0
482; 40.4 ; 242.4 ; 9.8 ;6;51;21;0;6;1;5;3;3;0;6;0
483; 37.9 ; 75.7 ; 0.8 ;2;12;137;0;2;0;2;1;1;0;2;0
484; 28.2 ; 281.9 ; 9.1 ;10;11;76;0;10;5;5;5;5;7;3;0
485; 19.5 ; 39.0 ; 0.3 ;2;35;3;0;2;2;0;0;2;2;0;0
486; 36.4 ; 218.3 ; 22.2 ;6;19;78;0;6;2;4;0;6;2;2;2
487; 41.7 ; 83.4 ; 7.6 ;2;67;104;1;1;1;1;2;0;0;2;0
488; 56.4 ; 112.7 ; 0.7 ;2;56;53;2;0;0;2;2;0;0;0;2
489; 36.8 ; 846.3 ; 10.1 ;23;15;1;0;23;14;9;12;11;8;15;0
490; 44.7 ; 178.6 ; 11.9 ;4;87;5;0;4;3;1;2;2;0;3;1
491; 27.1 ; 108.3 ; 3.7 ;4;14;136;0;4;0;4;4;0;3;1;0
492; 47.5 ; 94.9 ; -   ;2;31;48;0;2;0;2;1;1;0;2;0
493; 22.8 ; 705.9 ; 6.7 ;31;10;5;0;31;12;19;12;19;31;0;0
494; 38.1 ; 228.5 ; 4.4 ;6;39;79;0;6;0;6;4;2;0;6;0
495; 28.2 ; 140.9 ; 10.9 ;5;57;104;0;5;0;5;2;3;3;2;0
496; 64.3 ; 192.8 ; 29.5 ;3;5;6;0;3;1;2;3;0;0;0;3
497; 55.2 ; 110.4 ; 12.6 ;2;58;230;0;2;0;2;1;1;0;0;2
498; 51.0 ; 102.1 ; 2.2 ;2;117;141;0;2;1;1;0;2;0;2;0
499; 20.7 ; 41.5 ; -   ;2;66;20;0;2;1;1;1;1;2;0;0
500; 78.2 ; 234.5 ; 28.1 ;3;35;93;3;0;1;2;2;1;0;0;3
501; 40.5 ; 567.5 ; 13.2 ;14;19;117;0;14;12;2;8;6;5;9;0
502; 18.6 ; 37.2 ; 3.2 ;2;152;136;0;2;0;2;0;2;2;0;0
503; 42.5 ; 85.0 ; 19.7 ;2;125;53;0;2;0;2;2;0;1;0;1
504; 43.8 ; 131.5 ; 17.2 ;3;211;36;0;3;1;2;3;0;1;1;1
505; 38.2 ; 114.7 ; 12.2 ;3;9;206;0;3;0;3;2;1;1;2;0
506; 33.9 ; 101.8 ; 13.6 ;3;18;127;0;3;0;3;1;2;1;2;0
507; 47.1 ; 659.1 ; 41.6 ;14;14;11;0;14;5;9;2;12;5;4;5
508; 19.0 ; 95.1 ; 5.9 ;5;38;156;0;5;2;3;2;3;5;0;0
509; 63.1 ; 126.2 ; 24.5 ;2;165;133;1;1;2;0;1;1;0;0;2
510; 71.5 ; 357.3 ; 35.3 ;5;30;36;0;5;0;5;2;3;0;0;5
511; 22.8 ; 295.8 ; 8.9 ;13;21;3;0;13;3;10;5;8;9;4;0
512; 15.0 ; 30.0 ; -   ;2;49;161;0;2;2;0;0;2;2;0;0
513; 38.9 ; 116.8 ; 22.1 ;3;50;89;0;3;0;3;3;0;1;1;1
514; 51.2 ; 204.6 ; 10.5 ;4;41;105;4;0;0;4;3;1;0;3;1
515; 61.3 ; 306.7 ; 39.4 ;5;107;5;0;5;0;5;2;3;2;0;3
516; 33.6 ; 402.7 ; 8.2 ;12;26;2;0;12;4;8;9;3;4;8;0
517; 17.5 ; 87.5 ; 5.1 ;5;19;77;0;5;4;1;0;5;5;0;0
518; 17.6 ; 246.6 ; 8.8 ;14;16;43;0;14;10;4;13;1;14;0;0
519; 54.9 ; 493.7 ; 17.9 ;9;32;22;0;9;4;5;2;7;0;6;3
520; 20.3 ; 101.5 ; 7.8 ;5;52;140;0;5;3;2;2;3;5;0;0
521; 47.1 ; 94.2 ; 9.2 ;2;19;36;2;0;0;2;1;1;0;1;1
522; 15.0 ; 45.0 ; -   ;3;76;5;0;3;0;3;3;0;3;0;0
523; 73.1 ; 146.2 ; 4.8 ;2;3;239;0;2;1;1;1;1;0;0;2
524; 61.4 ; 675.8 ; 48.9 ;11;27;10;0;11;3;8;8;3;4;0;7
525; 53.8 ; 268.8 ; 21.6 ;5;67;107;0;5;3;2;1;4;0;3;2
526; 76.6 ; 153.2 ; 26.5 ;2;212;21;0;2;0;2;2;0;0;0;2
527; 52.5 ; 105.0 ; -   ;2;69;116;0;2;0;2;2;0;0;2;0
528; 31.8 ; 159.2 ; 17.4 ;5;20;95;0;5;2;3;5;0;2;3;0
529; 48.4 ; 145.3 ; 4.2 ;3;2;245;0;3;3;0;2;1;0;3;0
530; 48.3 ; 386.5 ; 25.1 ;8;34;5;0;8;2;6;6;2;3;2;3
531; 52.4 ; 314.2 ; 10.6 ;6;31;5;0;6;2;4;1;5;0;4;2
532; 102.1 ; 816.6 ; 22.1 ;8;47;62;0;8;0;8;8;0;0;0;8
533; 31.6 ; 63.2 ; 24.9 ;2;392;20;1;1;0;2;0;2;1;0;1
534; 24.0 ; 216.4 ; 10.8 ;9;16;221;0;9;8;1;9;0;6;3;0
535; 53.1 ; 106.2 ; 6.6 ;2;50;305;0;2;0;2;2;0;0;1;1
536; 52.7 ; 368.9 ; 9.3 ;7;47;53;0;7;1;6;7;0;0;5;2
537; 120.1 ; 4,203.1 ; 27.0 ;35;12;5;0;35;0;35;35;0;0;0;35
538; 24.9 ; 124.3 ; 3.1 ;5;38;53;0;5;2;3;1;4;5;0;0
539; 37.8 ; 113.4 ; 14.2 ;3;61;31;0;3;1;2;0;3;1;2;0
540; 29.5 ; 118.2 ; 23.9 ;4;130;37;0;4;0;4;1;3;3;1;0
541; 50.7 ; 152.1 ; 13.5 ;3;78;24;3;0;3;0;2;1;0;2;1
542; 23.7 ; 521.7 ; 1.1 ;22;14;5;0;22;1;21;3;19;22;0;0
543; 22.3 ; 133.6 ; 4.7 ;6;7;229;0;6;4;2;4;2;6;0;0
544; 38.8 ; 77.7 ; 12.9 ;2;63;95;0;2;0;2;1;1;1;1;0
545; 21.1 ; 84.3 ; 6.8 ;4;15;275;0;4;3;1;3;1;4;0;0
546; 41.2 ; 82.5 ; 9.3 ;2;270;62;0;2;0;2;2;0;0;2;0
547; 46.8 ; 93.5 ; -   ;2;95;280;0;2;2;0;0;2;0;2;0
548; 58.3 ; 116.6 ; 32.5 ;2;32;59;0;2;2;0;0;2;1;0;1
549; 25.6 ; 102.6 ; 1.4 ;4;21;248;0;4;1;3;2;2;4;0;0
550; 49.8 ; 199.2 ; 2.3 ;4;42;160;0;4;2;2;2;2;0;4;0
551; 40.7 ; 691.7 ; 9.5 ;17;11;53;0;17;2;15;2;15;0;17;0
552; 19.2 ; 95.8 ; 7.0 ;5;69;104;0;5;1;4;2;3;5;0;0
553; 29.3 ; 146.4 ; 14.4 ;5;19;244;0;5;4;1;2;3;3;2;0
554; 59.3 ; 118.5 ; 2.1 ;2;30;185;2;0;0;2;2;0;0;0;2
555; 56.5 ; 282.7 ; 5.2 ;5;78;15;0;5;3;2;2;3;0;0;5
556; 59.5 ; 297.6 ; 12.3 ;5;21;22;0;5;1;4;4;1;0;0;5
557; 70.1 ; 140.3 ; 35.0 ;2;12;196;2;0;1;1;0;2;0;0;2
558; 39.4 ; 354.3 ; 11.7 ;9;32;36;0;9;4;5;3;6;3;6;0
559; 37.4 ; 112.3 ; 12.5 ;3;32;164;1;2;2;1;3;0;1;2;0
560; 77.6 ; 155.2 ; 30.2 ;2;19;241;0;2;0;2;2;0;0;0;2
561; 25.9 ; 77.6 ; 19.2 ;3;4;107;0;3;2;1;3;0;2;1;0
562; 44.6 ; 89.1 ; 24.7 ;2;9;77;0;2;1;1;0;2;1;0;1
563; 39.3 ; 78.7 ; 19.7 ;2;57;209;0;2;0;2;0;2;1;0;1
564; 60.0 ; 120.0 ; 11.2 ;2;205;121;0;2;1;1;1;1;0;0;2
565; 43.6 ; 567.3 ; 35.3 ;13;16;80;0;13;7;6;12;1;4;5;4
566; 25.5 ; 51.1 ; 10.4 ;2;23;26;0;2;0;2;2;0;1;1;0
567; 24.3 ; 48.6 ; 7.6 ;2;5;42;0;2;0;2;2;0;1;1;0
568; 51.4 ; 154.1 ; 37.5 ;3;5;221;0;3;0;3;1;2;1;1;1
569; 15.0 ; 45.0 ; -   ;3;22;232;0;3;0;3;1;2;3;0;0
570; 46.6 ; 326.4 ; 16.4 ;7;43;8;0;7;3;4;7;0;0;5;2
571; 15.4 ; 30.8 ; -   ;2;25;26;0;2;0;2;1;1;2;0;0
572; 15.0 ; 30.0 ; -   ;2;1;197;0;2;2;0;2;0;2;0;0
573; 45.1 ; 135.2 ; 3.3 ;3;21;285;0;3;1;2;1;2;0;3;0
574; 30.8 ; 215.9 ; 17.2 ;7;28;34;0;7;4;3;7;0;2;5;0
575; 50.7 ; 253.4 ; 9.1 ;5;63;2;0;5;2;3;1;4;0;3;2
576; 15.0 ; 30.0 ; -   ;2;2;42;0;2;1;1;2;0;2;0;0
577; 24.6 ; 172.4 ; 7.3 ;7;19;89;0;7;2;5;4;3;5;2;0
578; 88.6 ; 177.2 ; 4.3 ;2;7;188;2;0;1;1;1;1;0;0;2
579; 37.9 ; 265.0 ; 12.9 ;7;25;82;0;7;6;1;1;6;2;5;0
580; 77.8 ; 856.1 ; 22.2 ;11;25;8;0;11;7;4;4;7;0;0;11
581; 25.1 ; 50.1 ; -   ;2;17;47;0;2;0;2;2;0;2;0;0
582; 49.5 ; 297.1 ; 5.0 ;6;40;11;0;6;3;3;2;4;0;6;0
583; 42.6 ; 681.6 ; 20.3 ;16;14;4;16;0;14;2;16;0;5;6;5
584; 29.1 ; 87.2 ; 5.5 ;3;49;74;3;0;1;2;0;3;2;1;0
585; 63.8 ; 3,764.8 ; 13.3 ;59;7;4;0;59;32;27;18;41;0;0;59
586; 19.5 ; 97.7 ; 4.8 ;5;14;14;0;5;3;2;2;3;5;0;0
587; 94.2 ; 188.4 ; 68.9 ;2;447;5;0;2;0;2;2;0;1;0;1
588; 24.9 ; 671.5 ; 18.7 ;27;11;2;0;27;16;11;17;10;18;9;0
589; 15.0 ; 89.9 ; -   ;6;26;59;0;6;3;3;1;5;6;0;0
590; 55.4 ; 443.0 ; 11.5 ;8;41;0;0;8;0;8;5;3;0;0;8
591; 49.9 ; 99.8 ; 10.5 ;2;55;133;2;0;1;1;0;2;0;1;1
592; 31.4 ; 94.1 ; 17.6 ;3;27;0;0;3;1;2;3;0;1;2;0
593; 54.5 ; 217.9 ; 7.9 ;4;42;10;0;4;0;4;4;0;0;3;1
594; 15.0 ; 119.9 ; -   ;8;12;68;0;8;2;6;4;4;8;0;0
595; 22.9 ; 68.7 ; 4.0 ;3;56;33;2;1;2;1;2;1;3;0;0
596; 63.9 ; 255.7 ; 14.1 ;4;42;183;0;4;0;4;3;1;0;0;4
597; 64.7 ; 194.1 ; 8.4 ;3;164;121;0;3;0;3;2;1;0;0;3
598; 61.7 ; 123.3 ; 31.5 ;2;205;92;0;2;1;1;2;0;0;0;2
599; 17.1 ; 68.6 ; -   ;4;32;170;0;4;4;0;4;0;4;0;0
600; 30.6 ; 367.7 ; 8.6 ;12;18;2;2;10;8;4;6;6;4;8;0
601; 24.2 ; 72.5 ; 4.7 ;3;2;189;0;3;1;2;3;0;3;0;0
602; 19.9 ; 99.4 ; 6.7 ;5;16;5;0;5;1;4;3;2;5;0;0
603; 73.9 ; 147.8 ; 34.3 ;2;209;62;0;2;0;2;1;1;0;0;2
604; 36.7 ; 1,174.5 ; 8.8 ;32;9;13;0;32;7;25;32;0;11;21;0
605; 17.4 ; 330.4 ; 4.5 ;19;14;53;18;1;7;12;4;15;19;0;0
606; 47.2 ; 188.9 ; 1.0 ;4;59;152;0;4;2;2;1;3;0;4;0
607; 23.1 ; 253.9 ; 7.9 ;11;16;0;0;11;7;4;11;0;7;4;0
608; 26.6 ; 106.3 ; 15.8 ;4;61;65;0;4;2;2;2;2;3;1;0
609; 81.3 ; 569.1 ; 13.8 ;7;23;86;0;7;2;5;3;4;0;0;7
610; 28.6 ; 286.4 ; 27.5 ;10;36;1;0;10;2;8;2;8;7;0;3
611; 40.7 ; 162.7 ; 6.0 ;4;41;79;1;3;1;3;4;0;0;4;0
612; 38.5 ; 76.9 ; 12.4 ;2;186;165;0;2;1;1;0;2;1;1;0
613; 57.2 ; 228.9 ; 3.2 ;4;33;53;0;4;0;4;1;3;0;0;4
614; 25.2 ; 50.4 ; 7.1 ;2;58;278;0;2;0;2;2;0;1;1;0
615; 44.4 ; 222.2 ; 10.2 ;5;58;23;0;5;1;4;3;2;0;5;0
616; 31.2 ; 62.4 ; -   ;2;63;62;0;2;0;2;2;0;0;2;0
617; 16.2 ; 81.0 ; 1.8 ;5;25;48;0;5;2;3;1;4;5;0;0
618; 38.1 ; 114.2 ; 14.6 ;3;5;242;0;3;0;3;0;3;1;2;0
619; 104.3 ; 417.2 ; 120.5 ;4;67;40;2;2;3;1;2;2;1;0;3
620; 53.9 ; 161.8 ; 2.6 ;3;29;163;2;1;0;3;3;0;0;2;1
621; 43.1 ; 258.7 ; 18.9 ;6;22;183;0;6;0;6;6;0;2;2;2
622; 22.0 ; 373.7 ; 9.4 ;17;15;148;0;17;9;8;17;0;11;6;0
623; 38.5 ; 76.9 ; 12.4 ;2;150;136;1;1;0;2;1;1;1;1;0
624; 39.0 ; 77.9 ; 11.7 ;2;16;239;0;2;1;1;1;1;1;1;0
625; 41.8 ; 125.5 ; 4.2 ;3;34;136;0;3;0;3;3;0;0;3;0
626; 45.5 ; 91.1 ; 4.0 ;2;177;4;1;1;1;1;0;2;0;2;0
627; 18.6 ; 37.2 ; -   ;2;58;101;0;2;1;1;2;0;2;0;0
628; 40.8 ; 122.5 ; 6.1 ;3;22;160;2;1;2;1;1;2;0;3;0
629; 38.4 ; 76.8 ; 20.0 ;2;17;69;2;0;0;2;1;1;1;0;1
630; 21.7 ; 672.2 ; 8.0 ;31;10;115;0;31;20;11;24;7;31;0;0
631; 33.4 ; 133.6 ; 5.8 ;4;12;21;4;0;2;2;4;0;1;3;0
632; 26.0 ; 104.1 ; 7.5 ;4;10;173;0;4;3;1;4;0;3;1;0
633; 38.3 ; 114.9 ; 12.8 ;3;124;75;0;3;2;1;3;0;1;2;0
634; 48.1 ; 480.8 ; 7.0 ;10;43;10;0;10;0;10;10;0;0;7;3
635; 15.7 ; 31.4 ; 1.1 ;2;62;42;0;2;0;2;2;0;2;0;0
636; 61.8 ; 123.7 ; 22.6 ;2;54;178;0;2;1;1;2;0;0;0;2
637; 24.4 ; 122.2 ; 14.0 ;5;39;124;0;5;3;2;2;3;3;2;0
638; 40.3 ; 80.7 ; 10.7 ;2;33;4;0;2;1;1;2;0;1;1;0
639; 32.1 ; 160.4 ; 3.3 ;5;38;22;0;5;4;1;2;3;2;3;0
640; 69.7 ; 278.9 ; 32.1 ;4;46;47;0;4;1;3;4;0;0;0;4
641; 17.5 ; 70.0 ; 5.3 ;4;144;11;3;1;0;4;2;2;4;0;0
642; 28.3 ; 85.0 ; 16.9 ;3;10;259;0;3;3;0;2;1;2;1;0
643; 30.0 ; 59.9 ; -   ;2;158;134;0;2;1;1;0;2;2;0;0
644; 30.8 ; 862.8 ; 11.4 ;28;13;108;0;28;15;13;22;6;9;19;0
645; 15.0 ; 45.0 ; -   ;3;26;245;0;3;2;1;2;1;3;0;0
646; 16.8 ; 33.6 ; 2.7 ;2;5;141;0;2;0;2;0;2;2;0;0
647; 30.0 ; 839.4 ; 19.5 ;28;14;0;0;28;13;15;17;11;19;9;0
648; 64.1 ; 448.6 ; 48.5 ;7;36;123;0;7;1;6;4;3;2;0;5
649; 48.2 ; 96.3 ; 2.1 ;2;26;221;0;2;0;2;2;0;0;2;0
650; 35.6 ; 71.2 ; 8.1 ;2;20;75;2;0;2;0;0;2;1;1;0
651; 124.7 ; 249.3 ; 40.8 ;2;40;31;2;0;0;2;0;2;0;0;2
652; 26.8 ; 53.5 ; 7.7 ;2;159;35;0;2;1;1;2;0;1;1;0
653; 52.3 ; 104.6 ; 33.4 ;2;165;11;0;2;1;1;0;2;1;0;1
654; 54.7 ; 328.5 ; 20.6 ;6;50;5;0;6;2;4;2;4;0;4;2
655; 58.7 ; 528.5 ; 16.5 ;9;33;0;0;9;1;8;7;2;0;0;9
656; 61.8 ; 865.6 ; 43.5 ;14;21;5;0;14;0;14;8;6;5;0;9
657; 32.2 ; 64.5 ; 6.5 ;2;76;200;0;2;1;1;1;1;1;1;0
658; 42.8 ; 257.0 ; 9.3 ;6;74;22;0;6;1;5;6;0;0;6;0
659; 27.0 ; 54.0 ; 6.1 ;2;184;17;0;2;2;0;2;0;1;1;0
660; 37.4 ; 74.9 ; 14.0 ;2;55;113;0;2;1;1;1;1;1;1;0
661; 29.1 ; 436.3 ; 16.1 ;15;27;21;0;15;3;12;8;7;10;5;0
662; 35.1 ; 70.2 ; 2.3 ;2;281;12;0;2;1;1;1;1;0;2;0
663; 70.1 ; 140.3 ; 35.0 ;2;116;121;0;2;1;1;1;1;0;0;2
664; 18.9 ; 37.9 ; 1.1 ;2;112;5;0;2;0;2;2;0;2;0;0
665; 32.7 ; 65.5 ; 22.1 ;2;29;62;1;1;1;1;2;0;1;1;0
666; 15.0 ; 30.0 ; -   ;2;119;65;0;2;2;0;0;2;2;0;0
667; 18.9 ; 624.4 ; 3.0 ;33;9;4;0;33;28;5;33;0;33;0;0
668; 27.2 ; 163.4 ; 15.1 ;6;32;176;0;6;2;4;3;3;4;2;0
669; 34.2 ; 820.5 ; 36.5 ;24;13;17;0;24;18;6;23;1;8;8;8
670; 64.2 ; 449.4 ; 31.6 ;7;15;2;0;7;1;6;3;4;0;0;7
671; 15.0 ; 89.9 ; -   ;6;14;62;0;6;3;3;1;5;6;0;0
672; 66.1 ; 132.1 ; 47.4 ;2;37;69;1;1;0;2;2;0;1;0;1
673; 103.3 ; 310.0 ; 14.9 ;3;97;120;0;3;0;3;3;0;0;0;3
674; 61.4 ; 122.8 ; 17.7 ;2;59;220;0;2;1;1;1;1;0;0;2
675; 23.3 ; 46.7 ; 2.6 ;2;10;30;0;2;2;0;0;2;2;0;0
676; 41.9 ; 167.6 ; 22.9 ;4;69;26;0;4;0;4;1;3;1;2;1
677; 32.9 ; 164.7 ; 7.2 ;5;60;59;1;4;2;3;2;3;2;3;0
678; 58.3 ; 175.0 ; 13.4 ;3;104;99;0;3;0;3;3;0;0;0;3
679; 81.5 ; 325.8 ; 41.6 ;4;63;13;0;4;4;0;1;3;0;0;4
680; 66.9 ; 267.6 ; 75.1 ;4;52;142;0;4;2;2;2;2;1;0;3
681; 46.9 ; 234.5 ; 28.6 ;5;67;52;0;5;0;5;4;1;2;1;2
682; 21.2 ; 190.7 ; 10.8 ;9;30;149;0;9;6;3;1;8;6;3;0
683; 60.0 ; 120.0 ; 67.4 ;2;10;143;0;2;1;1;1;1;1;0;1
684; 70.8 ; 141.6 ; 15.6 ;2;44;205;0;2;0;2;2;0;0;0;2
685; 15.5 ; 46.4 ; 0.9 ;3;29;32;0;3;0;3;2;1;3;0;0
686; 31.7 ; 95.2 ; 21.2 ;3;83;10;0;3;1;2;1;2;1;2;0
687; 27.2 ; 81.5 ; 14.4 ;3;10;259;0;3;3;0;0;3;2;1;0
688; 46.8 ; 93.5 ; -   ;2;15;146;0;2;1;1;2;0;0;2;0
689; 63.2 ; 252.9 ; 10.6 ;4;41;95;0;4;0;4;2;2;0;0;4
690; 24.5 ; 171.2 ; 15.0 ;7;32;16;0;7;0;7;0;7;5;2;0
691; 25.1 ; 50.1 ; -   ;2;5;28;0;2;1;1;0;2;2;0;0
692; 22.9 ; 595.8 ; 12.3 ;26;11;11;0;26;13;13;16;10;17;9;0
693; 24.3 ; 535.2 ; 8.6 ;22;8;0;0;22;11;11;11;11;15;7;0
694; 73.2 ; 146.4 ; -   ;2;19;269;0;2;2;0;0;2;0;0;2
695; 43.8 ; 175.3 ; 2.1 ;4;11;250;0;4;1;3;1;3;0;4;0
696; 19.2 ; 211.1 ; 0.4 ;11;11;32;0;11;10;1;11;0;11;0;0
697; 29.4 ; 440.3 ; 13.2 ;15;27;35;1;14;7;8;8;7;10;5;0
698; 50.9 ; 101.7 ; 21.4 ;2;76;47;0;2;0;2;1;1;1;0;1
699; 43.2 ; 86.4 ; 0.5 ;2;63;100;0;2;0;2;0;2;0;2;0
700; 21.4 ; 278.6 ; 15.4 ;13;14;10;0;13;3;10;5;8;9;4;0
701; 63.7 ; 127.4 ; 50.5 ;2;2;131;0;2;1;1;0;2;1;0;1
702; 19.8 ; 177.9 ; 6.0 ;9;20;229;0;9;5;4;4;5;9;0;0
703; 34.7 ; 278.0 ; 29.8 ;8;41;17;0;8;3;5;6;2;3;2;3
704; 37.5 ; 224.9 ; 2.5 ;6;40;22;0;6;4;2;6;0;0;6;0
705; 15.0 ; 45.0 ; -   ;3;25;19;0;3;1;2;2;1;3;0;0
706; 48.1 ; 144.3 ; 1.1 ;3;13;38;0;3;1;2;2;1;0;3;0
707; 48.5 ; 97.0 ; 11.4 ;2;181;59;0;2;1;1;0;2;0;1;1
708; 18.1 ; 36.2 ; 4.7 ;2;6;278;0;2;0;2;0;2;2;0;0
709; 18.3 ; 732.0 ; 5.0 ;40;5;57;0;40;19;21;17;23;40;0;0
710; 17.1 ; 34.2 ; 3.2 ;2;176;16;0;2;0;2;2;0;2;0;0
711; 52.5 ; 105.0 ; -   ;2;6;110;0;2;0;2;2;0;0;2;0
712; 23.4 ; 421.8 ; 8.9 ;18;14;12;0;18;12;6;5;13;12;6;0
713; 34.5 ; 103.4 ; 17.2 ;3;39;0;3;0;1;2;3;0;1;2;0
714; 56.7 ; 113.5 ; 1.8 ;2;448;41;0;2;0;2;2;0;0;0;2
715; 50.7 ; 202.6 ; 15.9 ;4;21;68;0;4;2;2;4;0;0;3;1
716; 15.0 ; 30.0 ; -   ;2;22;86;0;2;2;0;2;0;2;0;0
717; 16.5 ; 33.0 ; 2.3 ;2;5;140;0;2;2;0;0;2;2;0;0
718; 58.7 ; 117.5 ; 8.4 ;2;19;15;0;2;0;2;0;2;0;0;2
719; 36.9 ; 184.3 ; 20.0 ;5;40;115;0;5;1;4;3;2;2;1;2
720; 16.6 ; 116.3 ; 1.9 ;7;25;57;0;7;0;7;5;2;7;0;0
721; 60.0 ; 119.9 ; 19.8 ;2;2;251;0;2;1;1;1;1;0;0;2
722; 47.3 ; 141.8 ; 7.4 ;3;16;330;0;3;1;2;3;0;0;3;0
723; 38.4 ; 76.7 ; 12.6 ;2;32;239;0;2;2;0;1;1;1;1;0
724; 30.5 ; 122.0 ; 11.5 ;4;4;213;0;4;2;2;1;3;1;3;0
725; 25.9 ; 51.8 ; 0.8 ;2;26;20;0;2;0;2;2;0;2;0;0
726; 29.7 ; 148.6 ; 14.4 ;5;59;71;1;4;4;1;5;0;3;2;0
727; 38.7 ; 619.1 ; 15.9 ;16;20;19;0;16;5;11;3;13;5;11;0
728; 43.3 ; 476.4 ; 10.6 ;11;29;2;0;11;5;6;5;6;0;11;0
729; 31.2 ; 62.5 ; 24.3 ;2;251;31;0;2;0;2;1;1;1;0;1
730; 16.6 ; 33.2 ; 2.4 ;2;15;17;0;2;2;0;2;0;2;0;0
731; 18.3 ; 55.0 ; 6.2 ;3;65;99;0;3;1;2;1;2;3;0;0
732; 27.3 ; 246.1 ; 12.4 ;9;31;37;0;9;3;6;6;3;6;3;0
733; 16.6 ; 132.8 ; 3.7 ;8;23;99;0;8;6;2;2;6;8;0;0
734; 33.0 ; 131.9 ; 14.1 ;4;25;44;2;2;3;1;2;2;1;3;0
735; 20.5 ; 266.0 ; 4.9 ;13;13;154;0;13;7;6;4;9;13;0;0
736; 26.2 ; 104.7 ; 15.9 ;4;67;95;0;4;2;2;1;3;3;1;0
737; 25.2 ; 100.8 ; 8.1 ;4;55;162;0;4;0;4;3;1;3;1;0
738; 47.9 ; 335.3 ; 9.1 ;7;9;0;0;7;0;7;3;4;0;5;2
739; 17.1 ; 34.2 ; 3.2 ;2;32;73;2;0;0;2;2;0;2;0;0
740; 41.0 ; 205.1 ; 15.8 ;5;78;11;0;5;4;1;4;1;2;1;2
741; 55.5 ; 443.8 ; 14.7 ;8;27;2;0;8;6;2;7;1;0;0;8
742; 18.7 ; 74.9 ; 7.9 ;4;8;4;0;4;2;2;1;3;4;0;0
743; 30.0 ; 60.0 ; 0.1 ;2;82;1;0;2;0;2;1;1;1;1;0
744; 26.4 ; 79.3 ; 21.0 ;3;5;47;0;3;1;2;1;2;2;1;0
745; 31.9 ; 223.2 ; 10.1 ;7;28;9;0;7;4;3;5;2;2;5;0
746; 28.9 ; 86.7 ; 7.0 ;3;104;100;0;3;1;2;1;2;2;1;0
747; 82.7 ; 165.4 ; -   ;2;186;125;0;2;1;1;1;1;0;0;2
748; 32.7 ; 130.8 ; 20.9 ;4;29;138;4;0;3;1;4;0;1;3;0
749; 48.2 ; 96.5 ; 10.9 ;2;7;93;0;2;1;1;2;0;0;1;1
750; 47.3 ; 236.7 ; 3.4 ;5;40;48;1;4;2;3;1;4;0;5;0
751; 19.9 ; 79.5 ; 7.6 ;4;30;189;0;4;1;3;2;2;4;0;0
752; 62.3 ; 186.8 ; 30.5 ;3;25;173;0;3;0;3;3;0;0;0;3
753; 46.8 ; 93.5 ; -   ;2;113;179;0;2;0;2;2;0;0;2;0
754; 50.2 ; 501.5 ; 9.7 ;10;23;36;0;10;1;9;8;2;0;7;3
755; 16.5 ; 33.0 ; 2.3 ;2;73;99;0;2;1;1;1;1;2;0;0
756; 46.8 ; 93.5 ; -   ;2;5;256;0;2;2;0;2;0;0;2;0
757; 32.5 ; 746.6 ; 16.4 ;23;12;9;0;23;10;13;7;16;8;15;0
758; 54.5 ; 109.0 ; 0.3 ;2;52;48;1;1;1;1;1;1;0;2;0
759; 18.5 ; 55.5 ; 1.5 ;3;13;92;3;0;3;0;3;0;3;0;0
760; 59.3 ; 652.3 ; 13.7 ;11;30;36;0;11;0;11;8;3;0;0;11
761; 39.2 ; 314.0 ; 9.7 ;8;13;185;0;8;2;6;6;2;3;5;0
762; 36.6 ; 73.2 ; -   ;2;6;230;0;2;0;2;2;0;0;2;0
763; 44.0 ; 219.9 ; 11.2 ;5;28;32;0;5;1;4;1;4;0;3;2
764; 38.0 ; 76.1 ; 29.1 ;2;6;263;0;2;0;2;1;1;1;0;1
765; 47.7 ; 95.5 ; 1.5 ;2;20;192;0;2;2;0;0;2;0;2;0
766; 41.3 ; 82.6 ; 1.7 ;2;106;60;0;2;2;0;1;1;0;2;0
767; 53.9 ; 161.6 ; 9.8 ;3;53;8;3;0;3;0;1;2;0;2;1
768; 54.9 ; 438.9 ; 18.1 ;8;14;124;0;8;4;4;3;5;0;5;3
769; 45.2 ; 225.9 ; 22.1 ;5;62;38;0;5;1;4;2;3;2;1;2
770; 18.6 ; 37.2 ; -   ;2;50;233;0;2;2;0;2;0;2;0;0
771; 59.3 ; 118.6 ; 18.8 ;2;50;104;2;0;0;2;2;0;0;0;2
772; 26.9 ; 242.0 ; 5.5 ;9;37;4;0;9;4;5;7;2;6;3;0
773; 20.3 ; 142.1 ; 12.2 ;7;37;22;0;7;4;3;3;4;5;2;0
774; 49.6 ; 99.3 ; 4.3 ;2;4;265;0;2;1;1;2;0;0;2;0
775; 27.6 ; 55.3 ; 3.8 ;2;4;296;0;2;1;1;0;2;1;1;0
776; 16.8 ; 654.7 ; 3.9 ;39;8;1;0;39;18;21;23;16;39;0;0
777; 45.1 ; 225.5 ; 32.1 ;5;60;11;3;2;0;5;2;3;2;1;2
778; 29.4 ; 117.6 ; 18.7 ;4;41;176;0;4;2;2;4;0;3;1;0
779; 41.2 ; 288.3 ; 29.2 ;7;6;125;0;7;4;3;5;2;2;3;2
780; 23.5 ; 93.9 ; 5.5 ;4;23;142;3;1;0;4;4;0;4;0;0
781; 58.6 ; 175.8 ; 5.0 ;3;13;78;0;3;0;3;3;0;0;0;3
782; 56.6 ; 226.2 ; 23.1 ;4;11;158;0;4;1;3;1;3;0;0;4
783; 20.0 ; 40.1 ; 7.6 ;2;18;0;0;2;0;2;2;0;2;0;0
784; 43.4 ; 216.9 ; 0.5 ;5;26;15;0;5;0;5;5;0;0;5;0
785; 60.0 ; 120.0 ; 67.4 ;2;149;131;0;2;1;1;2;0;1;0;1
786; 21.3 ; 318.8 ; 7.9 ;15;9;8;0;15;9;6;4;11;15;0;0
787; 29.7 ; 89.1 ; 1.7 ;3;72;153;0;3;1;2;1;2;2;1;0
788; 20.3 ; 101.6 ; 4.5 ;5;28;236;0;5;3;2;0;5;5;0;0
789; 37.7 ; 527.8 ; 15.5 ;14;26;5;0;14;6;8;9;5;5;9;0
790; 73.1 ; 1,827.7 ; 37.0 ;25;15;22;0;25;4;21;19;6;0;0;25
791; 37.7 ; 113.2 ; 17.1 ;3;9;158;0;3;0;3;1;2;1;2;0
792; 17.2 ; 69.0 ; 2.0 ;4;17;252;0;4;0;4;4;0;4;0;0
793; 21.4 ; 448.6 ; 5.7 ;21;14;11;0;21;7;14;4;17;21;0;0
794; 73.6 ; 147.1 ; 11.5 ;2;103;131;0;2;1;1;1;1;0;0;2
795; 18.1 ; 90.4 ; 0.1 ;5;28;134;0;5;4;1;2;3;5;0;0
796; 28.1 ; 140.3 ; 14.1 ;5;41;113;0;5;0;5;1;4;3;2;0
797; 38.4 ; 115.3 ; 12.4 ;3;32;224;0;3;3;0;3;0;1;2;0
798; 36.6 ; 73.2 ; -   ;2;6;52;0;2;0;2;2;0;0;2;0
799; 36.7 ; 771.1 ; 9.9 ;21;12;5;0;21;0;21;21;0;7;14;0
800; 46.0 ; 92.1 ; 3.2 ;2;13;0;0;2;0;2;0;2;0;2;0
801; 61.6 ; 246.4 ; 3.0 ;4;16;238;0;4;2;2;3;1;0;0;4
802; 20.0 ; 40.1 ; 7.6 ;2;186;122;0;2;1;1;0;2;2;0;0
803; 40.1 ; 80.1 ; -   ;2;86;0;1;1;0;2;2;0;0;2;0
804; 15.3 ; 30.6 ; 0.5 ;2;10;208;0;2;1;1;0;2;2;0;0
805; 56.5 ; 169.5 ; 12.0 ;3;22;107;0;3;3;0;2;1;0;0;3
806; 48.1 ; 192.4 ; 1.5 ;4;113;5;0;4;0;4;3;1;0;4;0
807; 50.3 ; 302.0 ; 14.3 ;6;26;26;0;6;0;6;4;2;0;4;2
808; 58.1 ; 290.3 ; 17.7 ;5;38;99;0;5;3;2;4;1;0;0;5
809; 51.2 ; 204.6 ; 7.0 ;4;18;22;0;4;0;4;4;0;0;3;1
810; 33.4 ; 100.3 ; 12.9 ;3;41;40;0;3;1;2;3;0;1;2;0
811; 53.5 ; 641.9 ; 17.2 ;12;21;57;0;12;3;9;7;5;0;8;4
812; 28.1 ; 224.6 ; 10.4 ;8;43;5;0;8;6;2;3;5;5;3;0
813; 31.2 ; 93.7 ; 1.1 ;3;14;37;0;3;2;1;2;1;0;3;0
814; 44.8 ; 268.6 ; 26.1 ;6;52;22;0;6;1;5;3;3;2;2;2
815; 47.2 ; 141.7 ; 0.4 ;3;39;53;3;0;1;2;1;2;0;3;0
816; 42.8 ; 256.7 ; 6.8 ;6;43;62;0;6;0;6;3;3;0;6;0
817; 48.0 ; 144.0 ; 1.1 ;3;95;142;0;3;0;3;3;0;0;3;0
818; 53.9 ; 161.6 ; 23.4 ;3;70;65;1;2;2;1;1;2;0;2;1
819; 29.0 ; 86.9 ; 2.2 ;3;13;94;0;3;0;3;1;2;2;1;0
820; 21.6 ; 151.5 ; 5.1 ;7;36;3;0;7;5;2;1;6;7;0;0
821; 43.4 ; 130.1 ; 6.2 ;3;109;161;0;3;3;0;1;2;0;3;0
822; 18.3 ; 237.7 ; 5.4 ;13;16;10;0;13;2;11;3;10;13;0;0
823; 19.8 ; 99.1 ; 3.8 ;5;32;5;0;5;1;4;5;0;5;0;0
824; 54.5 ; 109.1 ; 47.4 ;2;120;15;0;2;0;2;2;0;1;0;1
825; 30.9 ; 61.7 ; 23.8 ;2;2;246;0;2;1;1;1;1;1;1;0
826; 25.6 ; 76.7 ; 19.4 ;3;129;105;0;3;0;3;2;1;2;1;0
827; 44.8 ; 89.6 ; 2.9 ;2;8;275;0;2;2;0;1;1;0;2;0
828; 30.9 ; 61.7 ; 23.8 ;2;155;99;0;2;1;1;1;1;1;1;0
829; 27.0 ; 134.8 ; 15.1 ;5;47;7;5;0;1;4;5;0;3;2;0
830; 25.9 ; 440.9 ; 11.2 ;17;16;26;0;17;4;13;10;7;11;6;0
831; 33.2 ; 232.3 ; 21.7 ;7;38;10;0;7;2;5;5;2;2;5;0
832; 22.6 ; 248.5 ; 14.1 ;11;4;238;0;11;6;5;5;6;7;4;0
833; 57.8 ; 115.5 ; 54.9 ;2;25;143;0;2;1;1;2;0;1;0;1
834; 19.3 ; 212.4 ; 0.0 ;11;32;5;0;11;3;8;8;3;11;0;0
835; 21.5 ; 150.7 ; 8.9 ;7;22;227;0;7;1;6;3;4;5;2;0
836; 39.3 ; 78.7 ; 19.7 ;2;13;262;0;2;0;2;1;1;1;0;1
837; 19.9 ; 139.6 ; 4.1 ;7;3;158;0;7;3;4;3;4;7;0;0
838; 37.8 ; 189.0 ; 21.0 ;5;10;62;0;5;0;5;5;0;2;1;2
839; 25.1 ; 100.3 ; -   ;4;26;93;0;4;1;3;1;3;4;0;0
840; 65.5 ; 327.7 ; 14.2 ;5;52;183;0;5;0;5;5;0;0;0;5
841; 19.7 ; 39.3 ; 0.5 ;2;29;185;0;2;1;1;0;2;2;0;0
842; 33.3 ; 166.3 ; 17.7 ;5;34;152;0;5;2;3;1;4;2;3;0
843; 15.0 ; 45.0 ; -   ;3;66;11;1;2;0;3;2;1;3;0;0
844; 20.0 ; 59.9 ; 9.2 ;3;50;35;0;3;2;1;1;2;3;0;0
845; 29.1 ; 87.2 ; 15.5 ;3;68;39;0;3;2;1;1;2;2;1;0
846; 20.5 ; 246.3 ; 7.3 ;12;14;4;0;12;8;4;7;5;12;0;0
847; 15.0 ; 30.0 ; -   ;2;59;2;0;2;2;0;0;2;2;0;0
848; 24.3 ; 48.6 ; 13.9 ;2;220;126;0;2;0;2;1;1;1;1;0
849; 16.6 ; 33.2 ; 2.4 ;2;314;5;0;2;0;2;1;1;2;0;0
850; 33.5 ; 67.1 ; 11.1 ;2;300;49;0;2;1;1;0;2;1;1;0
851; 18.0 ; 72.0 ; -   ;4;14;140;0;4;2;2;1;3;4;0;0
852; 58.7 ; 176.2 ; 24.5 ;3;67;7;0;3;2;1;2;1;0;0;3
853; 81.4 ; 162.9 ; 14.4 ;2;251;73;1;1;0;2;2;0;0;0;2
854; 45.7 ; 183.0 ; 19.4 ;4;35;153;0;4;2;2;1;3;1;2;1
855; 34.0 ; 170.2 ; 17.7 ;5;65;32;0;5;2;3;1;4;2;3;0
856; 16.9 ; 118.0 ; 5.6 ;7;50;69;0;7;1;6;2;5;7;0;0
857; 20.3 ; 81.1 ; 7.5 ;4;8;84;0;4;0;4;2;2;4;0;0
858; 48.9 ; 244.5 ; 32.1 ;5;63;20;0;5;1;4;3;2;2;1;2
859; 47.1 ; 188.5 ; 2.8 ;4;86;41;0;4;1;3;3;1;0;4;0
860; 35.1 ; 105.2 ; 16.3 ;3;54;113;0;3;1;2;2;1;1;2;0
861; 43.6 ; 523.3 ; 23.5 ;12;26;2;0;12;6;6;8;4;4;4;4
862; 48.3 ; 386.2 ; 2.6 ;8;32;42;0;8;0;8;2;6;0;8;0
863; 21.8 ; 43.7 ; -   ;2;7;231;0;2;1;1;2;0;2;0;0
864; 44.8 ; 89.6 ; 2.9 ;2;164;113;0;2;2;0;2;0;0;2;0
865; 15.0 ; 45.0 ; -   ;3;20;9;0;3;2;1;2;1;3;0;0
866; 36.0 ; 323.8 ; 10.6 ;9;49;33;0;9;5;4;4;5;3;6;0
867; 49.1 ; 196.6 ; 27.0 ;4;19;231;0;4;0;4;4;0;1;2;1
868; 84.2 ; 589.7 ; 48.2 ;7;21;41;0;7;0;7;6;1;0;0;7
869; 50.8 ; 101.6 ; 3.2 ;2;12;215;0;2;0;2;2;0;0;2;0
870; 46.8 ; 140.5 ; 9.4 ;3;1;185;0;3;2;1;2;1;0;2;1
871; 39.4 ; 197.2 ; 55.3 ;5;5;257;0;5;3;2;3;2;2;1;2
872; 53.9 ; 1,238.7 ; 15.2 ;23;12;5;0;23;13;10;19;4;0;15;8
873; 43.6 ; 348.6 ; 5.1 ;8;31;2;7;1;2;6;4;4;0;8;0
874; 30.0 ; 60.1 ; 7.4 ;2;27;272;0;2;1;1;2;0;1;1;0
875; 50.6 ; 404.5 ; 21.2 ;8;35;9;0;8;5;3;2;6;3;2;3
876; 27.6 ; 55.3 ; 3.8 ;2;98;220;0;2;1;1;2;0;1;1;0
877; 15.0 ; 45.0 ; -   ;3;13;325;0;3;1;2;1;2;3;0;0
878; 50.3 ; 151.0 ; 6.6 ;3;115;104;0;3;2;1;2;1;0;2;1
879; 27.4 ; 246.8 ; 14.0 ;9;23;102;0;9;8;1;9;0;6;3;0
880; 17.3 ; 207.5 ; 6.0 ;12;25;26;1;11;4;8;5;7;12;0;0
881; 31.5 ; 94.6 ; 2.9 ;3;8;179;0;3;1;2;2;1;1;2;0
882; 22.4 ; 89.5 ; 3.7 ;4;13;53;0;4;0;4;2;2;4;0;0
883; 40.2 ; 80.5 ; 10.8 ;2;1;89;0;2;0;2;1;1;1;1;0
884; 18.1 ; 126.9 ; 6.3 ;7;37;6;0;7;2;5;4;3;7;0;0
885; 60.8 ; 182.4 ; 37.2 ;3;116;5;0;3;0;3;2;1;1;0;2
886; 41.7 ; 166.8 ; 11.8 ;4;86;1;0;4;1;3;1;3;1;3;0
887; 42.1 ; 294.7 ; 14.6 ;7;8;71;0;7;4;3;2;5;2;3;2
888; 21.9 ; 109.7 ; 1.6 ;5;47;5;0;5;0;5;5;0;5;0;0
889; 30.6 ; 91.7 ; 16.8 ;3;155;110;0;3;1;2;1;2;1;2;0
890; 58.1 ; 523.1 ; 8.6 ;9;34;37;0;9;1;8;8;1;0;0;9
891; 23.3 ; 232.8 ; 4.5 ;10;5;236;0;10;2;8;6;4;10;0;0
892; 52.9 ; 740.8 ; 16.3 ;14;25;5;0;14;1;13;14;0;0;9;5
893; 35.3 ; 106.0 ; 11.0 ;3;23;59;0;3;2;1;3;0;1;2;0
894; 54.6 ; 218.4 ; 11.3 ;4;50;188;0;4;0;4;2;2;0;3;1
895; 89.2 ; 267.5 ; 51.4 ;3;2;45;3;0;1;2;1;2;0;0;3
896; 25.3 ; 101.2 ; 7.8 ;4;144;18;0;4;1;3;1;3;3;1;0
897; 60.6 ; 181.7 ; 31.2 ;3;125;11;0;3;0;3;3;0;1;0;2
898; 104.9 ; 524.3 ; 39.8 ;5;42;84;0;5;0;5;2;3;0;0;5
899; 63.5 ; 127.1 ; 43.6 ;2;12;67;0;2;2;0;0;2;1;0;1
900; 34.9 ; 209.7 ; 4.6 ;6;73;1;0;6;3;3;4;2;0;6;0
901; 28.2 ; 253.9 ; 2.3 ;9;21;45;0;9;7;2;1;8;6;3;0
902; 47.3 ; 141.9 ; 1.3 ;3;173;110;0;3;0;3;3;0;0;3;0
903; 51.5 ; 154.6 ; 38.5 ;3;142;0;0;3;1;2;2;1;1;1;1
904; 47.5 ; 142.4 ; 17.7 ;3;45;104;0;3;1;2;1;2;1;1;1
905; 32.9 ; 65.7 ; 21.9 ;2;24;5;0;2;0;2;2;0;1;1;0
906; 45.4 ; 136.3 ; 2.4 ;3;3;294;0;3;0;3;2;1;0;3;0
907; 18.0 ; 198.3 ; 3.0 ;11;19;2;11;0;8;3;11;0;11;0;0
908; 35.1 ; 140.4 ; 3.6 ;4;22;100;0;4;3;1;1;3;0;4;0
909; 36.9 ; 147.5 ; 14.4 ;4;106;2;0;4;3;1;0;4;1;3;0
910; 46.9 ; 93.9 ; 25.1 ;2;19;98;0;2;2;0;0;2;1;0;1
911; 51.0 ; 102.0 ; -   ;2;19;211;0;2;0;2;2;0;0;2;0
912; 34.2 ; 102.5 ; 11.9 ;3;155;112;0;3;3;0;1;2;1;2;0
913; 66.4 ; 199.2 ; 25.5 ;3;41;81;0;3;2;1;1;2;0;0;3
914; 44.2 ; 486.7 ; 21.0 ;11;32;7;0;11;3;8;3;8;4;3;4
915; 32.6 ; 325.7 ; 10.9 ;10;4;161;0;10;8;2;2;8;3;7;0
916; 39.8 ; 198.8 ; 11.2 ;5;44;89;0;5;1;4;1;4;2;3;0
917; 50.6 ; 101.3 ; 30.6 ;2;18;152;0;2;0;2;1;1;1;0;1
918; 22.5 ; 44.9 ; 11.2 ;2;10;2;0;2;1;1;2;0;1;1;0
919; 36.0 ; 144.1 ; 8.5 ;4;25;220;0;4;2;2;3;1;1;3;0
920; 53.8 ; 538.4 ; 21.0 ;10;14;44;0;10;7;3;5;5;0;7;3
921; 69.6 ; 139.2 ; 40.0 ;2;84;146;0;2;1;1;1;1;1;0;1
922; 37.2 ; 185.9 ; 13.9 ;5;17;73;5;0;0;5;5;0;2;3;0
923; 99.6 ; 697.3 ; 18.3 ;7;38;10;0;7;0;7;7;0;0;0;7
924; 76.9 ; 230.6 ; 53.9 ;3;64;76;0;3;1;2;2;1;1;0;2
925; 48.3 ; 193.3 ; 4.9 ;4;46;89;0;4;0;4;4;0;0;4;0
926; 58.2 ; 1,105.6 ; 12.6 ;19;13;85;0;19;5;14;2;17;0;0;19
927; 48.7 ; 97.4 ; -   ;2;14;248;0;2;1;1;0;2;0;2;0
928; 34.2 ; 102.7 ; 4.3 ;3;9;59;0;3;0;3;1;2;1;2;0
929; 26.5 ; 793.8 ; 3.3 ;30;4;292;0;30;26;4;30;0;30;0;0
930; 20.0 ; 40.1 ; 7.6 ;2;1;248;0;2;2;0;2;0;2;0;0
931; 38.9 ; 116.6 ; 17.7 ;3;94;137;0;3;0;3;2;1;1;1;1
932; 24.5 ; 2,154.2 ; 7.1 ;88;5;0;0;88;32;56;24;64;59;29;0
933; 46.6 ; 186.5 ; 24.2 ;4;35;138;0;4;2;2;0;4;1;2;1
934; 60.3 ; 180.9 ; 34.9 ;3;18;239;0;3;2;1;1;2;1;0;2
935; 37.5 ; 262.2 ; 36.1 ;7;33;104;0;7;2;5;1;6;2;3;2
936; 17.0 ; 85.0 ; 2.1 ;5;13;221;0;5;2;3;3;2;5;0;0
937; 78.9 ; 552.4 ; 30.7 ;7;49;15;0;7;0;7;7;0;0;0;7
938; 34.9 ; 349.1 ; 6.3 ;10;26;20;0;10;1;9;8;2;3;7;0
939; 42.3 ; 84.5 ; 3.3 ;2;9;75;0;2;2;0;1;1;0;2;0
940; 56.5 ; 112.9 ; 0.5 ;2;32;99;0;2;0;2;2;0;0;0;2
941; 38.5 ; 115.4 ; 6.8 ;3;3;91;0;3;3;0;3;0;0;3;0
942; 51.1 ; 102.2 ; 3.7 ;2;214;36;0;2;0;2;1;1;0;2;0
943; 62.4 ; 436.8 ; 22.8 ;7;59;16;0;7;0;7;7;0;0;0;7
944; 27.8 ; 249.8 ; 16.4 ;9;15;124;0;9;4;5;4;5;6;3;0
945; 16.5 ; 49.4 ; 2.7 ;3;23;213;0;3;2;1;1;2;3;0;0
946; 46.1 ; 230.4 ; 8.4 ;5;64;93;0;5;2;3;1;4;0;5;0
947; 39.6 ; 395.6 ; 27.1 ;10;43;20;0;10;3;7;4;6;3;4;3
948; 36.6 ; 183.2 ; 11.0 ;5;81;79;0;5;0;5;2;3;2;3;0
949; 61.4 ; 122.8 ; 5.9 ;2;5;51;2;0;2;0;2;0;0;0;2
950; 102.3 ; 409.1 ; 75.2 ;4;125;4;0;4;4;0;4;0;1;0;3
951; 35.0 ; 629.1 ; 10.8 ;18;14;46;18;0;9;9;7;11;6;12;0
952; 28.3 ; 226.7 ; 17.8 ;8;30;32;0;8;1;7;4;4;5;3;0
953; 29.3 ; 616.2 ; 12.8 ;21;9;70;0;21;12;9;11;10;14;7;0
954; 46.7 ; 140.1 ; 3.7 ;3;34;78;0;3;0;3;3;0;0;3;0
955; 49.4 ; 197.7 ; 2.5 ;4;59;58;0;4;0;4;1;3;0;4;0
956; 28.8 ; 57.7 ; 11.6 ;2;41;93;0;2;2;0;2;0;1;1;0
957; 30.2 ; 60.4 ; -   ;2;203;119;0;2;1;1;0;2;0;2;0
958; 16.2 ; 48.6 ; 2.2 ;3;18;181;0;3;2;1;1;2;3;0;0
959; 45.5 ; 136.4 ; 9.9 ;3;56;215;0;3;0;3;3;0;0;2;1
960; 36.6 ; 73.2 ; -   ;2;55;168;0;2;0;2;2;0;0;2;0
961; 43.6 ; 87.2 ; -   ;2;23;32;0;2;0;2;0;2;0;2;0
962; 21.5 ; 64.5 ; 2.7 ;3;49;1;0;3;0;3;1;2;3;0;0
963; 33.7 ; 236.2 ; 6.2 ;7;30;14;0;7;5;2;1;6;2;5;0
964; 42.1 ; 84.3 ; 11.5 ;2;158;31;1;1;0;2;2;0;0;2;0
965; 119.8 ; 598.8 ; 72.9 ;5;19;99;0;5;0;5;5;0;0;0;5
966; 51.5 ; 257.5 ; 21.6 ;5;31;251;0;5;2;3;2;3;2;1;2
967; 47.4 ; 236.8 ; 0.6 ;5;26;20;0;5;0;5;5;0;0;5;0
968; 52.8 ; 105.5 ; 6.2 ;2;26;246;0;2;0;2;1;1;0;1;1
969; 20.8 ; 187.4 ; 10.6 ;9;11;84;0;9;3;6;4;5;6;3;0
970; 55.7 ; 111.4 ; 13.4 ;2;14;131;0;2;0;2;2;0;0;0;2
971; 20.8 ; 207.9 ; 3.0 ;10;21;71;0;10;7;3;7;3;10;0;0
972; 28.1 ; 56.2 ; -   ;2;14;74;0;2;1;1;1;1;2;0;0
973; 20.0 ; 40.1 ; 7.6 ;2;98;131;0;2;1;1;1;1;2;0;0
974; 43.5 ; 217.3 ; 6.7 ;5;20;232;0;5;1;4;4;1;0;5;0
975; 63.6 ; 318.2 ; 23.9 ;5;84;52;0;5;1;4;4;1;0;0;5
976; 50.2 ; 100.4 ; 3.5 ;2;342;57;0;2;0;2;2;0;0;2;0
977; 84.6 ; 253.9 ; 13.0 ;3;99;2;0;3;1;2;1;2;0;0;3
978; 15.0 ; 74.9 ; -   ;5;68;17;0;5;3;2;5;0;5;0;0
979; 61.8 ; 123.7 ; 22.6 ;2;44;236;0;2;0;2;2;0;0;0;2
980; 24.8 ; 74.5 ; 10.3 ;3;67;179;0;3;0;3;2;1;2;1;0
981; 32.3 ; 161.5 ; 11.4 ;5;105;11;0;5;2;3;1;4;2;3;0
982; 37.2 ; 148.8 ; 11.9 ;4;49;62;1;3;0;4;3;1;1;3;0
983; 15.9 ; 301.2 ; 1.8 ;19;16;4;0;19;11;8;5;14;19;0;0
984; 62.0 ; 248.0 ; 14.3 ;4;59;84;0;4;0;4;4;0;0;0;4
985; 32.2 ; 96.7 ; 8.0 ;3;86;105;0;3;1;2;2;1;1;2;0
986; 25.5 ; 687.8 ; 16.1 ;27;13;53;0;27;13;14;16;11;18;9;0
987; 23.8 ; 118.8 ; 4.7 ;5;22;44;0;5;2;3;3;2;5;0;0
988; 26.9 ; 646.3 ; 12.9 ;24;9;47;0;24;5;19;11;13;16;8;0
989; 91.6 ; 366.6 ; 36.7 ;4;57;15;0;4;0;4;3;1;0;0;4
990; 25.3 ; 151.8 ; 8.4 ;6;41;23;0;6;2;4;2;4;4;2;0
991; 49.6 ; 148.7 ; 2.8 ;3;88;65;0;3;2;1;1;2;0;3;0
992; 29.7 ; 237.8 ; 9.2 ;8;42;78;0;8;0;8;8;0;5;3;0
993; 55.9 ; 223.7 ; 18.9 ;4;71;83;0;4;1;3;3;1;0;0;4
994; 30.2 ; 60.4 ; -   ;2;51;83;0;2;0;2;1;1;0;2;0
995; 40.8 ; 204.2 ; 15.3 ;5;42;32;0;5;0;5;2;3;2;1;2
996; 55.7 ; 222.9 ; 10.6 ;4;16;95;0;4;1;3;3;1;0;0;4
997; 22.5 ; 44.9 ; 11.2 ;2;19;104;0;2;0;2;2;0;1;1;0
998; 28.7 ; 287.0 ; 17.8 ;10;11;158;0;10;6;4;7;3;7;3;0
999; 17.1 ; 34.3 ; 3.2 ;2;20;329;0;2;2;0;2;0;2;0;0
1000; 35.9 ; 71.8 ; 16.2 ;2;168;3;0;2;2;0;0;2;1;1;0
1001; 52.5 ; 105.0 ; -   ;2;74;160;0;2;2;0;1;1;0;2;0
1002; 22.4 ; 44.7 ; 4.0 ;2;17;26;0;2;1;1;2;0;2;0;0
1003; 21.1 ; 42.2 ; -   ;2;37;132;0;2;0;2;0;2;2;0;0
1004; 53.7 ; 644.4 ; 25.7 ;12;25;5;0;12;1;11;12;0;4;4;4
1005; 56.4 ; 282.2 ; 6.7 ;5;55;11;0;5;1;4;1;4;0;0;5
1006; 51.4 ; 102.9 ; 7.0 ;2;44;314;0;2;0;2;1;1;0;1;1
1007; 47.1 ; 94.2 ; 0.5 ;2;214;99;0;2;0;2;2;0;0;2;0
1008; 27.8 ; 55.5 ; 19.1 ;2;5;242;0;2;0;2;0;2;1;1;0
1009; 36.6 ; 183.0 ; -   ;5;54;8;0;5;1;4;4;1;0;5;0
1010; 20.0 ; 300.4 ; -   ;15;21;28;0;15;4;11;1;14;15;0;0
1011; 18.8 ; 93.9 ; 4.4 ;5;23;35;0;5;3;2;3;2;5;0;0
1012; 27.6 ; 55.3 ; 3.8 ;2;246;57;0;2;0;2;1;1;1;1;0
1013; 53.2 ; 212.8 ; 16.6 ;4;68;120;0;4;1;3;3;1;0;3;1
1014; 18.0 ; 72.1 ; 4.6 ;4;64;52;0;4;1;3;2;2;4;0;0
1015; 77.3 ; 463.9 ; 97.4 ;6;40;37;0;6;0;6;6;0;2;0;4
1016; 52.5 ; 105.0 ; -   ;2;62;120;0;2;0;2;2;0;0;2;0
1017; 60.1 ; 300.3 ; 31.3 ;5;38;14;1;4;2;3;4;1;2;0;3
1018; 50.5 ; 201.9 ; 21.6 ;4;23;74;0;4;1;3;2;2;1;2;1
1019; 38.3 ; 76.7 ; 34.9 ;2;175;69;0;2;0;2;1;1;1;0;1
1020; 45.8 ; 91.7 ; 23.5 ;2;64;241;0;2;0;2;0;2;1;0;1
1021; 63.6 ; 190.7 ; 44.9 ;3;80;112;0;3;3;0;3;0;1;0;2
1022; 43.3 ; 130.0 ; 0.4 ;3;40;44;0;3;1;2;3;0;0;3;0
1023; 57.1 ; 285.5 ; 45.2 ;5;50;14;0;5;4;1;3;2;2;0;3
1024; 34.2 ; 102.5 ; 7.5 ;3;9;36;3;0;1;2;2;1;1;2;0
1025; 46.8 ; 93.5 ; -   ;2;5;231;0;2;0;2;2;0;0;2;0
1026; 53.9 ; 107.8 ; 35.5 ;2;87;137;1;1;0;2;1;1;1;0;1
1027; 34.0 ; 203.9 ; 13.7 ;6;21;84;0;6;0;6;3;3;2;4;0
1028; 36.1 ; 252.9 ; 31.3 ;7;40;103;0;7;4;3;7;0;2;3;2
1029; 74.6 ; 149.3 ; 33.1 ;2;259;151;0;2;1;1;1;1;0;0;2
1030; 26.8 ; 53.6 ; 11.2 ;2;52;112;2;0;2;0;0;2;1;1;0
1031; 49.9 ; 449.5 ; 8.7 ;9;20;231;0;9;0;9;8;1;0;6;3
1032; 38.3 ; 76.7 ; 12.2 ;2;18;377;0;2;0;2;2;0;1;1;0
1033; 40.3 ; 362.5 ; 15.2 ;9;19;78;9;0;5;4;2;7;3;3;3
1034; 15.0 ; 30.0 ; -   ;2;5;105;0;2;0;2;0;2;2;0;0
1035; 33.0 ; 132.0 ; 21.4 ;4;111;22;0;4;1;3;1;3;1;3;0
1036; 48.4 ; 145.1 ; 33.9 ;3;20;220;0;3;1;2;1;2;1;1;1
1037; 48.1 ; 96.2 ; 0.9 ;2;131;63;0;2;0;2;1;1;0;2;0
1038; 56.3 ; 225.0 ; 12.3 ;4;134;22;0;4;0;4;1;3;0;0;4
1039; 45.5 ; 500.6 ; 17.9 ;11;41;24;0;11;5;6;6;5;4;3;4
1040; 31.9 ; 63.8 ; -   ;2;56;258;0;2;0;2;1;1;0;2;0
1041; 31.2 ; 436.8 ; 16.4 ;14;22;26;0;14;4;10;8;6;5;9;0
1042; 42.2 ; 84.4 ; 18.8 ;2;31;146;0;2;1;1;2;0;1;0;1
1043; 35.1 ; 70.2 ; 25.8 ;2;60;153;0;2;0;2;2;0;1;0;1
1044; 37.2 ; 74.5 ; 26.2 ;2;27;269;0;2;1;1;0;2;1;0;1
1045; 15.0 ; 89.9 ; -   ;6;50;21;0;6;0;6;6;0;6;0;0
1046; 20.0 ; 40.1 ; 7.6 ;2;239;79;0;2;0;2;1;1;2;0;0
1047; 41.6 ; 208.0 ; 6.6 ;5;53;2;0;5;4;1;2;3;0;5;0
1048; 37.4 ; 149.8 ; 7.2 ;4;19;236;0;4;2;2;2;2;0;4;0
1049; 29.7 ; 118.8 ; 1.5 ;4;32;131;0;4;1;3;2;2;3;1;0
1050; 31.0 ; 92.9 ; 16.8 ;3;97;87;1;2;2;1;0;3;1;2;0
1051; 53.6 ; 107.1 ; 10.2 ;2;12;158;0;2;0;2;1;1;0;1;1
1052; 16.6 ; 49.7 ; 2.9 ;3;157;5;0;3;2;1;1;2;3;0;0
1053; 31.6 ; 126.5 ; 9.8 ;4;18;208;0;4;3;1;2;2;1;3;0
1054; 42.2 ; 210.8 ; 17.8 ;5;46;85;0;5;2;3;2;3;2;1;2
1055; 53.1 ; 106.2 ; 6.6 ;2;102;77;0;2;1;1;1;1;0;1;1
1056; 17.1 ; 136.6 ; 5.4 ;8;29;3;0;8;5;3;3;5;8;0;0
1057; 36.7 ; 146.9 ; 31.0 ;4;11;161;0;4;2;2;4;0;1;2;1
1058; 45.8 ; 91.6 ; 23.7 ;2;278;34;0;2;2;0;0;2;1;0;1
1059; 47.3 ; 189.2 ; 0.4 ;4;36;26;0;4;0;4;3;1;0;4;0
1060; 40.5 ; 162.1 ; 8.1 ;4;27;128;4;0;4;0;1;3;0;4;0
1061; 73.0 ; 146.0 ; 30.7 ;2;5;186;0;2;2;0;0;2;0;0;2
1062; 19.5 ; 156.2 ; 7.2 ;8;14;278;0;8;0;8;6;2;8;0;0
1063; 30.5 ; 91.6 ; 20.7 ;3;140;30;0;3;2;1;2;1;1;2;0
1064; 17.5 ; 122.6 ; 4.9 ;7;37;3;0;7;2;5;5;2;7;0;0
1065; 28.9 ; 86.8 ; 17.2 ;3;56;255;0;3;2;1;1;2;2;1;0
1066; 22.6 ; 90.2 ; 5.3 ;4;44;2;0;4;4;0;3;1;4;0;0
1067; 36.0 ; 216.2 ; 24.5 ;6;14;58;0;6;0;6;6;0;2;2;2
1068; 33.6 ; 134.3 ; 17.4 ;4;29;11;0;4;1;3;2;2;1;3;0
1069; 42.5 ; 254.9 ; 10.9 ;6;7;6;0;6;1;5;3;3;0;6;0
1070; 47.7 ; 95.4 ; 1.4 ;2;23;216;0;2;1;1;1;1;0;2;0
1071; 25.3 ; 126.5 ; 0.6 ;5;35;54;0;5;1;4;3;2;5;0;0
1072; 25.7 ; 103.0 ; 5.9 ;4;41;10;0;4;2;2;3;1;3;1;0
1073; 40.1 ; 160.6 ; 16.8 ;4;113;22;0;4;0;4;2;2;1;2;1
1074; 30.1 ; 60.1 ; 0.2 ;2;37;257;0;2;0;2;1;1;1;1;0
1075; 56.1 ; 112.2 ; 2.6 ;2;95;188;0;2;0;2;1;1;0;0;2
1076; 28.7 ; 86.2 ; 18.3 ;3;63;167;0;3;2;1;2;1;2;1;0
1077; 32.6 ; 65.3 ; 17.8 ;2;174;148;0;2;1;1;2;0;1;1;0
1078; 17.9 ; 35.7 ; 4.3 ;2;111;152;0;2;1;1;2;0;2;0;0
1079; 48.3 ; 1,013.7 ; 9.1 ;21;22;3;0;21;8;13;11;10;0;14;7
1080; 41.1 ; 492.8 ; 21.7 ;12;16;109;0;12;10;2;10;2;4;4;4
1081; 52.1 ; 677.3 ; 8.7 ;13;23;0;0;13;3;10;11;2;0;9;4
1082; 38.9 ; 272.5 ; 17.0 ;7;13;128;1;6;2;5;5;2;2;3;2
1083; 27.3 ; 54.6 ; 3.3 ;2;9;249;0;2;1;1;0;2;1;1;0
1084; 43.4 ; 130.1 ; 6.2 ;3;149;135;0;3;1;2;1;2;0;3;0
1085; 27.5 ; 55.0 ; 3.7 ;2;26;4;0;2;1;1;1;1;1;1;0
1086; 33.6 ; 168.2 ; 23.1 ;5;3;65;0;5;1;4;3;2;2;1;2
1087; 25.1 ; 100.3 ; -   ;4;71;5;1;3;0;4;2;2;4;0;0
1088; 38.2 ; 1,032.5 ; 15.3 ;27;13;34;1;26;21;6;20;7;9;18;0
1089; 19.6 ; 98.1 ; 2.6 ;5;49;21;0;5;0;5;5;0;5;0;0
1090; 29.6 ; 88.7 ; 13.4 ;3;4;17;0;3;3;0;1;2;2;1;0
1091; 15.0 ; 45.0 ; -   ;3;88;5;0;3;1;2;1;2;3;0;0
1092; 58.2 ; 174.6 ; 8.9 ;3;44;163;0;3;0;3;2;1;0;0;3
1093; 38.0 ; 76.1 ; 19.4 ;2;70;131;0;2;0;2;2;0;1;0;1
1094; 102.4 ; 204.8 ; 78.4 ;2;43;5;0;2;1;1;2;0;1;0;1
1095; 42.0 ; 168.1 ; 17.8 ;4;96;31;0;4;1;3;3;1;1;2;1
1096; 55.0 ; 220.2 ; 16.8 ;4;90;74;0;4;0;4;1;3;0;0;4
1097; 60.9 ; 121.9 ; 20.2 ;2;3;57;2;0;1;1;0;2;0;0;2
1098; 47.9 ; 574.6 ; 26.9 ;12;23;92;0;12;8;4;2;10;4;4;4
1099; 29.7 ; 148.5 ; 18.5 ;5;94;38;0;5;2;3;4;1;3;2;0
1100; 36.6 ; 73.2 ; -   ;2;26;104;0;2;0;2;1;1;0;2;0
1101; 31.9 ; 191.1 ; 13.5 ;6;22;10;0;6;1;5;4;2;2;4;0
1102; 33.8 ; 778.5 ; 7.1 ;23;8;10;0;23;0;23;17;6;8;15;0
1103; 28.1 ; 84.4 ; 2.8 ;3;38;200;0;3;0;3;3;0;2;1;0
1104; 35.0 ; 70.0 ; 14.9 ;2;14;245;0;2;1;1;0;2;1;1;0
1105; 49.3 ; 147.9 ; 3.1 ;3;38;212;0;3;2;1;2;1;0;3;0
1106; 61.3 ; 122.7 ; 20.8 ;2;131;94;0;2;0;2;1;1;0;0;2
1107; 36.6 ; 73.2 ; -   ;2;282;37;0;2;0;2;0;2;0;2;0
1108; 57.3 ; 859.2 ; 26.1 ;15;27;22;1;14;1;14;13;2;0;0;15
1109; 34.3 ; 479.6 ; 7.0 ;14;4;303;0;14;7;7;3;11;5;9;0
1110; 59.8 ; 658.2 ; 33.6 ;11;30;0;0;11;3;8;7;4;4;0;7
1111; 28.3 ; 113.3 ; 11.0 ;4;46;167;0;4;1;3;3;1;3;1;0
1112; 57.2 ; 171.5 ; 10.7 ;3;9;83;0;3;2;1;2;1;0;0;3
1113; 22.3 ; 156.1 ; 6.4 ;7;11;95;0;7;1;6;3;4;7;0;0
1114; 45.0 ; 90.0 ; 37.4 ;2;110;250;0;2;1;1;0;2;1;0;1
1115; 31.8 ; 63.6 ; 25.2 ;2;341;98;0;2;1;1;0;2;1;0;1
1116; 24.9 ; 149.2 ; 12.5 ;6;16;35;0;6;1;5;3;3;4;2;0
1117; 48.0 ; 336.3 ; 7.1 ;7;5;351;0;7;3;4;4;3;0;5;2
1118; 56.1 ; 280.7 ; 13.1 ;5;16;64;0;5;1;4;3;2;0;0;5
1119; 39.3 ; 549.9 ; 10.7 ;14;15;13;0;14;7;7;12;2;5;9;0
1120; 79.9 ; 239.6 ; 7.3 ;3;18;230;0;3;0;3;1;2;0;0;3
1121; 21.1 ; 359.4 ; 8.5 ;17;12;3;0;17;9;8;6;11;17;0;0
1122; 30.0 ; 59.9 ; -   ;2;13;243;0;2;2;0;0;2;2;0;0
1123; 30.9 ; 61.7 ; 23.8 ;2;2;145;0;2;1;1;2;0;1;1;0
1124; 54.6 ; 109.3 ; 3.3 ;2;25;78;0;2;0;2;2;0;0;1;1
1125; 50.8 ; 152.4 ; 5.1 ;3;61;108;0;3;2;1;1;2;0;2;1
1126; 55.1 ; 275.7 ; 9.8 ;5;13;160;0;5;1;4;5;0;0;0;5
1127; 69.3 ; 138.6 ; 40.7 ;2;32;110;0;2;0;2;1;1;1;0;1
1128; 27.2 ; 81.5 ; 11.7 ;3;77;138;0;3;1;2;1;2;2;1;0
1129; 33.5 ; 1,341.6 ; 9.1 ;40;8;20;0;40;18;22;18;22;13;27;0
1130; 48.1 ; 144.4 ; 4.1 ;3;29;215;0;3;1;2;1;2;0;3;0
1131; 38.7 ; 77.4 ; 35.5 ;2;37;48;0;2;0;2;0;2;1;0;1
1132; 26.8 ; 134.1 ; 14.8 ;5;13;228;0;5;4;1;2;3;3;2;0
1133; 61.3 ; 184.0 ; 13.7 ;3;67;157;0;3;0;3;3;0;0;0;3
1134; 27.6 ; 193.4 ; 30.0 ;7;66;5;0;7;2;5;5;2;5;0;2
1135; 21.1 ; 84.6 ; 11.0 ;4;86;57;0;4;1;3;2;2;3;1;0
1136; 53.7 ; 322.4 ; 29.6 ;6;46;5;0;6;0;6;4;2;2;2;2
1137; 73.9 ; 147.7 ; 12.6 ;2;19;183;0;2;0;2;1;1;0;0;2
1138; 48.6 ; 145.9 ; 2.2 ;3;29;74;0;3;1;2;1;2;0;3;0
1139; 61.3 ; 184.0 ; 41.5 ;3;40;168;0;3;2;1;1;2;1;0;2
1140; 34.8 ; 243.5 ; 31.0 ;7;31;99;0;7;1;6;4;3;2;3;2
1141; 25.8 ; 103.3 ; 1.6 ;4;16;11;0;4;0;4;2;2;4;0;0
1142; 42.9 ; 128.6 ; -   ;3;12;152;0;3;0;3;2;1;0;3;0
1143; 40.3 ; 281.9 ; 28.9 ;7;32;0;0;7;0;7;6;1;2;3;2
1144; 36.6 ; 109.8 ; -   ;3;26;43;0;3;1;2;1;2;0;3;0
1145; 36.2 ; 108.5 ; 19.4 ;3;49;238;0;3;1;2;3;0;1;1;1
1146; 32.2 ; 160.8 ; 15.8 ;5;20;5;0;5;2;3;1;4;2;3;0
1147; 32.3 ; 161.6 ; 12.0 ;5;57;38;0;5;2;3;2;3;2;3;0
1148; 22.9 ; 320.7 ; 9.0 ;14;32;5;0;14;3;11;6;8;9;5;0
1149; 23.9 ; 357.9 ; 13.5 ;15;27;10;0;15;0;15;7;8;10;5;0
1150; 58.6 ; 234.5 ; 8.6 ;4;50;184;0;4;0;4;3;1;0;0;4
1151; 134.5 ; 403.4 ; 49.7 ;3;79;129;0;3;2;1;1;2;0;0;3
1152; 24.0 ; 48.1 ; 0.2 ;2;94;112;0;2;1;1;2;0;2;0;0
1153; 43.5 ; 87.0 ; 18.9 ;2;246;14;0;2;1;1;2;0;1;0;1
1154; 30.9 ; 61.7 ; 23.8 ;2;148;124;0;2;1;1;0;2;1;1;0
1155; 54.1 ; 108.1 ; 35.0 ;2;27;11;0;2;1;1;0;2;1;0;1
1156; 16.8 ; 33.6 ; 2.7 ;2;104;263;0;2;1;1;2;0;2;0;0
1157; 51.5 ; 257.3 ; 8.5 ;5;41;22;0;5;2;3;2;3;0;3;2
1158; 36.6 ; 109.8 ; -   ;3;23;116;3;0;2;1;1;2;0;3;0
1159; 40.0 ; 120.1 ; 11.1 ;3;88;102;0;3;2;1;1;2;1;2;0
1160; 48.2 ; 96.4 ; -   ;2;9;5;0;2;1;1;2;0;0;2;0
1161; 47.8 ; 95.7 ; 0.5 ;2;23;20;0;2;2;0;1;1;0;2;0
1162; 37.0 ; 147.9 ; 26.2 ;4;10;53;0;4;2;2;2;2;1;2;1
1163; 26.9 ; 107.6 ; 16.4 ;4;136;36;0;4;0;4;1;3;3;1;0
1164; 63.6 ; 318.0 ; 24.4 ;5;52;94;0;5;1;4;3;2;0;0;5
1165; 65.2 ; 130.5 ; 27.7 ;2;50;230;0;2;0;2;2;0;0;0;2
1166; 16.5 ; 66.0 ; 1.9 ;4;28;63;0;4;0;4;4;0;4;0;0
1167; 30.2 ; 60.4 ; -   ;2;85;134;1;1;1;1;1;1;0;2;0
1168; 26.7 ; 106.8 ; 15.2 ;4;73;2;2;2;4;0;3;1;3;1;0
1169; 22.5 ; 44.9 ; 11.2 ;2;38;131;0;2;0;2;0;2;1;1;0
1170; 24.7 ; 172.8 ; 9.4 ;7;30;89;0;7;2;5;0;7;5;2;0
1171; 37.7 ; 75.4 ; 8.0 ;2;15;144;0;2;1;1;2;0;1;1;0
1172; 42.7 ; 940.4 ; 26.9 ;22;12;2;0;22;3;19;14;8;7;8;7
1173; 38.8 ; 155.4 ; 31.6 ;4;60;106;0;4;0;4;3;1;1;2;1
1174; 29.8 ; 208.6 ; 7.8 ;7;41;7;0;7;4;3;3;4;5;2;0
1175; 32.4 ; 129.5 ; 10.0 ;4;34;185;0;4;1;3;2;2;1;3;0
1176; 47.7 ; 143.1 ; 1.7 ;3;66;157;0;3;0;3;3;0;0;3;0
1177; 15.0 ; 74.9 ; -   ;5;40;32;0;5;0;5;1;4;5;0;0
1178; 59.8 ; 298.9 ; 58.4 ;5;23;22;0;5;2;3;1;4;2;0;3
1179; 79.1 ; 237.4 ; 29.0 ;3;9;74;3;0;0;3;3;0;0;0;3
1180; 37.1 ; 111.3 ; 12.2 ;3;6;176;0;3;3;0;1;2;1;2;0
1181; 23.6 ; 47.3 ; 6.5 ;2;30;262;0;2;1;1;1;1;1;1;0
1182; 39.1 ; 195.4 ; 28.5 ;5;5;230;0;5;1;4;4;1;2;1;2
1183; 31.0 ; 93.0 ; 10.9 ;3;122;93;0;3;2;1;2;1;1;2;0
1184; 16.1 ; 32.1 ; 1.6 ;2;3;272;0;2;1;1;1;1;2;0;0
1185; 15.0 ; 74.9 ; -   ;5;49;63;0;5;0;5;3;2;5;0;0
1186; 115.9 ; 579.4 ; 93.3 ;5;58;3;0;5;2;3;5;0;2;0;3
1187; 61.8 ; 247.1 ; 96.6 ;4;5;299;0;4;2;2;3;1;1;0;3
1188; 51.3 ; 410.1 ; 7.6 ;8;32;136;1;7;1;7;5;3;0;5;3
1189; 40.4 ; 485.1 ; 22.1 ;12;14;249;0;12;5;7;7;5;4;4;4
1190; 48.7 ; 243.7 ; 20.7 ;5;97;23;0;5;1;4;3;2;2;1;2
1191; 25.1 ; 75.2 ; -   ;3;94;83;0;3;2;1;1;2;3;0;0
1192; 26.5 ; 185.8 ; 12.4 ;7;36;56;0;7;6;1;2;5;5;2;0
1193; 42.6 ; 85.3 ; 9.1 ;2;38;236;0;2;0;2;1;1;0;2;0
1194; 96.8 ; 774.8 ; 53.4 ;8;52;7;0;8;1;7;8;0;0;0;8
1195; 44.5 ; 133.4 ; 11.1 ;3;14;1;0;3;0;3;2;1;0;2;1
1196; 27.9 ; 363.0 ; 13.6 ;13;14;4;0;13;7;6;9;4;9;4;0
1197; 46.8 ; 140.3 ; 24.9 ;3;50;287;0;3;1;2;1;2;1;1;1
1198; 31.4 ; 125.7 ; 21.9 ;4;58;26;4;0;2;2;2;2;1;3;0
1199; 25.7 ; 231.3 ; 10.6 ;9;32;21;0;9;0;9;1;8;6;3;0
1200; 45.7 ; 91.5 ; 4.3 ;2;138;168;0;2;0;2;0;2;0;2;0
1201; 34.8 ; 487.8 ; 10.1 ;14;17;11;0;14;8;6;1;13;5;9;0
1202; 26.2 ; 52.4 ; 6.9 ;2;1;276;0;2;1;1;0;2;1;1;0
1203; 69.2 ; 345.9 ; 22.0 ;5;47;105;0;5;0;5;3;2;0;0;5
1204; 84.0 ; 168.0 ; 47.1 ;2;11;105;2;0;1;1;0;2;0;0;2
1205; 46.1 ; 92.2 ; 40.1 ;2;12;20;0;2;0;2;2;0;1;0;1
1206; 46.8 ; 93.5 ; -   ;2;23;263;0;2;1;1;1;1;0;2;0
1207; 106.9 ; 641.6 ; 82.4 ;6;36;22;0;6;0;6;5;1;2;0;4
1208; 15.0 ; 45.0 ; -   ;3;40;11;0;3;2;1;1;2;3;0;0
1209; 42.9 ; 128.8 ; 22.6 ;3;145;58;0;3;0;3;2;1;1;1;1
1210; 61.7 ; 123.3 ; 8.3 ;2;135;249;0;2;1;1;1;1;0;0;2
1211; 41.7 ; 83.4 ; 7.6 ;2;69;220;0;2;0;2;1;1;0;2;0
1212; 24.7 ; 74.0 ; 6.8 ;3;37;17;3;0;0;3;1;2;2;1;0
1213; 43.7 ; 174.6 ; 21.3 ;4;27;62;0;4;1;3;4;0;1;2;1
1214; 32.0 ; 159.9 ; 10.7 ;5;49;47;0;5;2;3;4;1;2;3;0
1215; 25.1 ; 50.1 ; -   ;2;56;134;0;2;2;0;0;2;2;0;0
1216; 24.2 ; 72.6 ; 4.8 ;3;14;17;0;3;1;2;2;1;3;0;0
1217; 47.3 ; 94.5 ; 4.5 ;2;49;9;0;2;2;0;2;0;0;2;0
1218; 62.1 ; 124.2 ; 13.3 ;2;2;40;0;2;1;1;0;2;0;0;2
1219; 22.0 ; 110.0 ; 10.5 ;5;32;150;0;5;4;1;1;4;3;2;0
1220; 51.0 ; 306.2 ; 15.6 ;6;56;33;0;6;2;4;2;4;0;4;2
1221; 24.6 ; 123.2 ; 8.2 ;5;62;17;0;5;3;2;1;4;3;2;0
1222; 17.3 ; 293.8 ; 4.1 ;17;11;8;0;17;2;15;2;15;17;0;0
1223; 45.5 ; 227.6 ; 13.1 ;5;30;83;0;5;1;4;3;2;0;3;2
1224; 41.2 ; 82.4 ; 34.9 ;2;221;127;0;2;0;2;0;2;1;0;1
1225; 92.0 ; 184.0 ; 72.5 ;2;5;95;0;2;0;2;1;1;1;0;1
1226; 54.9 ; 109.8 ; 9.9 ;2;24;241;0;2;0;2;2;0;0;1;1
1227; 42.4 ; 127.2 ; 11.3 ;3;52;47;0;3;1;2;3;0;0;3;0
1228; 30.9 ; 61.7 ; 23.8 ;2;12;146;0;2;0;2;2;0;1;1;0
1229; 49.3 ; 147.8 ; 0.5 ;3;4;116;0;3;2;1;2;1;0;3;0
1230; 15.0 ; 59.9 ; -   ;4;28;42;0;4;2;2;2;2;4;0;0
1231; 65.0 ; 520.3 ; 12.5 ;8;47;1;0;8;6;2;1;7;0;0;8
1232; 40.2 ; 200.9 ; 49.4 ;5;74;5;0;5;2;3;3;2;2;1;2
1233; 46.8 ; 1,264.1 ; 13.3 ;27;15;15;0;27;13;14;18;9;0;18;9
1234; 93.6 ; 749.1 ; 25.9 ;8;36;35;0;8;3;5;7;1;0;0;8
1235; 31.7 ; 63.3 ; 9.9 ;2;32;246;0;2;0;2;1;1;1;1;0
1236; 45.4 ; 454.3 ; 28.0 ;10;18;2;0;10;3;7;6;4;3;4;3
1237; 39.2 ; 196.0 ; 20.0 ;5;30;69;0;5;1;4;2;3;2;1;2
1238; 20.5 ; 328.7 ; 7.1 ;16;13;27;0;16;11;5;14;2;16;0;0
1239; 82.4 ; 164.9 ; 6.2 ;2;263;53;0;2;0;2;2;0;0;0;2
1240; 21.9 ; 175.4 ; 8.9 ;8;15;10;0;8;2;6;6;2;5;3;0
1241; 44.1 ; 88.2 ; 39.3 ;2;11;335;0;2;1;1;1;1;1;0;1
1242; 48.6 ; 97.2 ; 12.8 ;2;14;292;0;2;1;1;0;2;0;1;1
1243; 53.2 ; 106.5 ; -   ;2;16;40;0;2;2;0;1;1;0;2;0
1244; 85.3 ; 255.9 ; 69.7 ;3;107;133;0;3;3;0;3;0;1;0;2
1245; 46.2 ; 369.2 ; 9.4 ;8;21;6;0;8;2;6;3;5;0;5;3
1246; 18.3 ; 55.0 ; 6.2 ;3;5;158;0;3;1;2;1;2;3;0;0
1247; 49.7 ; 149.2 ; 54.7 ;3;176;3;0;3;3;0;1;2;1;1;1
1248; 16.4 ; 49.3 ; 2.6 ;3;68;26;0;3;1;2;2;1;3;0;0
1249; 42.0 ; 84.1 ; 8.1 ;2;5;95;0;2;0;2;1;1;0;2;0
1250; 78.9 ; 236.6 ; 45.3 ;3;38;251;0;3;0;3;2;1;0;0;3
1251; 34.5 ; 413.5 ; 11.2 ;12;20;131;0;12;6;6;3;9;4;8;0
1252; 36.7 ; 513.6 ; 22.4 ;14;19;53;0;14;5;9;5;9;5;4;5
1253; 23.6 ; 212.4 ; 8.6 ;9;10;64;0;9;2;7;3;6;6;3;0
1254; 42.0 ; 84.1 ; 8.1 ;2;36;69;0;2;0;2;2;0;0;2;0
1255; 15.5 ; 139.9 ; 1.3 ;9;29;1;0;9;3;6;5;4;9;0;0
1256; 22.4 ; 514.8 ; 11.0 ;23;17;2;0;23;19;4;15;8;15;8;0
1257; 70.1 ; 140.3 ; 35.0 ;2;8;314;0;2;1;1;2;0;0;0;2
1258; 63.5 ; 127.0 ; 24.0 ;2;42;35;2;0;2;0;0;2;0;0;2
1259; 31.2 ; 62.5 ; 24.3 ;2;63;58;0;2;0;2;0;2;1;0;1
1260; 22.8 ; 227.8 ; 5.5 ;10;22;8;0;10;6;4;3;7;10;0;0
1261; 31.8 ; 63.7 ; 25.2 ;2;5;137;0;2;0;2;0;2;1;0;1
1262; 25.1 ; 50.1 ; -   ;2;90;188;0;2;1;1;1;1;2;0;0
1263; 37.9 ; 151.8 ; 16.7 ;4;70;120;0;4;1;3;1;3;1;3;0
1264; 51.4 ; 102.7 ; 0.5 ;2;40;93;2;0;1;1;0;2;0;2;0
1265; 40.4 ; 121.2 ; 14.1 ;3;13;26;0;3;1;2;2;1;1;2;0
1266; 18.2 ; 163.4 ; 7.6 ;9;23;68;0;9;1;8;5;4;9;0;0
1267; 39.8 ; 199.1 ; 13.8 ;5;32;26;0;5;1;4;1;4;2;3;0
1268; 27.8 ; 111.0 ; 4.9 ;4;32;197;0;4;3;1;4;0;3;1;0
1269; 49.9 ; 449.1 ; 8.7 ;9;25;15;0;9;0;9;8;1;0;6;3
1270; 55.2 ; 110.4 ; 9.8 ;2;176;47;0;2;0;2;0;2;0;0;2
1271; 25.1 ; 50.1 ; -   ;2;77;203;0;2;1;1;0;2;2;0;0
1272; 22.3 ; 111.5 ; 7.1 ;5;77;7;0;5;4;1;3;2;5;0;0
1273; 46.8 ; 93.5 ; -   ;2;29;246;0;2;1;1;0;2;0;2;0
1274; 28.5 ; 85.4 ; 3.1 ;3;86;74;0;3;1;2;1;2;2;1;0
1275; 27.6 ; 110.5 ; 3.1 ;4;59;138;0;4;3;1;2;2;3;1;0
1276; 38.6 ; 192.9 ; 8.3 ;5;88;26;0;5;1;4;1;4;0;5;0
1277; 20.0 ; 40.1 ; 7.6 ;2;311;23;0;2;1;1;1;1;2;0;0
1278; 28.1 ; 337.6 ; 15.2 ;12;27;7;0;12;5;7;2;10;8;4;0
1279; 40.1 ; 400.5 ; 22.0 ;10;12;10;8;2;1;9;7;3;3;4;3
1280; 15.0 ; 30.0 ; -   ;2;85;170;0;2;1;1;1;1;2;0;0
1281; 16.4 ; 32.8 ; 2.1 ;2;6;210;0;2;0;2;0;2;2;0;0
1282; 20.0 ; 40.1 ; 7.6 ;2;37;143;0;2;0;2;1;1;2;0;0
1283; 29.0 ; 58.1 ; 17.8 ;2;104;226;0;2;1;1;0;2;1;1;0
1284; 36.8 ; 73.6 ; 17.7 ;2;270;137;0;2;0;2;2;0;1;1;0
1285; 18.9 ; 132.2 ; 1.7 ;7;54;53;0;7;0;7;1;6;7;0;0
1286; 25.1 ; 50.1 ; -   ;2;45;146;0;2;0;2;2;0;2;0;0
1287; 51.3 ; 359.4 ; 18.5 ;7;64;20;0;7;3;4;2;5;0;5;2
1288; 108.9 ; 326.6 ; 157.4 ;3;10;257;0;3;0;3;1;2;1;0;2
1289; 41.0 ; 369.2 ; 13.8 ;9;36;16;4;5;4;5;6;3;3;6;0
1290; 17.5 ; 70.0 ; 5.3 ;4;65;5;0;4;2;2;1;3;4;0;0
1291; 38.9 ; 77.8 ; -   ;2;6;393;0;2;0;2;2;0;0;2;0
1292; 49.7 ; 99.5 ; 4.2 ;2;234;78;0;2;0;2;1;1;0;2;0
1293; 27.6 ; 220.5 ; 18.1 ;8;41;41;0;8;5;3;2;6;5;3;0
1294; 23.4 ; 46.8 ; 3.4 ;2;16;295;0;2;1;1;2;0;2;0;0
1295; 20.9 ; 62.8 ; 2.7 ;3;34;194;0;3;0;3;2;1;3;0;0
1296; 53.9 ; 107.9 ; -   ;2;8;7;0;2;2;0;2;0;0;2;0
1297; 50.1 ; 100.3 ; 2.2 ;2;32;127;0;2;0;2;0;2;0;2;0
1298; 30.9 ; 92.6 ; 10.5 ;3;23;41;0;3;1;2;1;2;1;2;0
1299; 41.4 ; 82.7 ; 16.7 ;2;94;171;0;2;2;0;1;1;1;0;1
1300; 54.5 ; 217.8 ; 7.5 ;4;59;15;0;4;0;4;4;0;0;3;1
1301; 73.3 ; 146.7 ; 82.8 ;2;7;110;0;2;0;2;2;0;1;0;1
1302; 37.7 ; 113.2 ; 17.9 ;3;37;6;3;0;1;2;1;2;1;1;1
1303; 15.0 ; 30.0 ; -   ;2;59;70;0;2;2;0;1;1;2;0;0
1304; 48.1 ; 96.1 ; 0.9 ;2;181;99;0;2;1;1;1;1;0;2;0
1305; 50.6 ; 506.4 ; 18.4 ;10;12;31;0;10;2;8;7;3;0;7;3
1306; 25.8 ; 1,162.8 ; 13.0 ;45;10;3;0;45;23;22;28;17;30;15;0
1307; 47.6 ; 190.4 ; 34.2 ;4;8;260;0;4;4;0;1;3;1;2;1
1308; 24.1 ; 96.3 ; 5.4 ;4;11;170;0;4;4;0;4;0;4;0;0
1309; 64.0 ; 1,793.3 ; 12.3 ;28;9;47;0;28;15;13;17;11;0;0;28
1310; 47.0 ; 893.4 ; 0.5 ;19;18;1;0;19;7;12;8;11;0;19;0
1311; 48.8 ; 243.8 ; 4.4 ;5;45;63;3;2;0;5;2;3;0;5;0
1312; 16.4 ; 114.6 ; 2.5 ;7;41;32;0;7;3;4;0;7;7;0;0
1313; 48.0 ; 239.9 ; 41.5 ;5;39;80;0;5;0;5;5;0;2;1;2
1314; 34.7 ; 312.7 ; 16.3 ;9;35;5;0;9;0;9;4;5;3;6;0
1315; 59.8 ; 119.5 ; 2.9 ;2;68;183;0;2;0;2;2;0;0;0;2
1316; 29.5 ; 147.7 ; 10.6 ;5;57;58;0;5;2;3;2;3;3;2;0
1317; 23.3 ; 116.6 ; 13.7 ;5;35;118;0;5;4;1;2;3;3;2;0
1318; 16.3 ; 146.7 ; 1.0 ;9;18;43;2;7;3;6;7;2;9;0;0
1319; 50.0 ; 99.9 ; 37.3 ;2;16;20;0;2;1;1;1;1;1;0;1
1320; 48.7 ; 243.5 ; 38.7 ;5;22;130;0;5;3;2;2;3;2;1;2
1321; 21.7 ; 368.3 ; 8.6 ;17;13;87;0;17;10;7;9;8;11;6;0
1322; 32.9 ; 427.3 ; 12.7 ;13;24;5;0;13;6;7;12;1;4;9;0
1323; 35.8 ; 466.0 ; 21.0 ;13;14;14;0;13;3;10;7;6;4;5;4
1324; 41.1 ; 534.7 ; 17.3 ;13;11;28;0;13;4;9;10;3;4;5;4
1325; 29.6 ; 266.8 ; 14.0 ;9;18;67;0;9;4;5;3;6;6;3;0
1326; 52.9 ; 211.7 ; 26.2 ;4;43;151;0;4;4;0;3;1;1;2;1
1327; 36.6 ; 183.0 ; -   ;5;59;93;0;5;1;4;5;0;0;5;0
1328; 41.5 ; 207.4 ; 13.3 ;5;9;230;0;5;0;5;1;4;2;3;0
1329; 31.5 ; 441.4 ; 12.2 ;14;14;10;0;14;2;12;8;6;5;9;0
1330; 39.2 ; 78.4 ; 13.5 ;2;5;22;0;2;0;2;1;1;1;1;0
1331; 79.7 ; 398.6 ; 24.7 ;5;76;16;0;5;0;5;2;3;0;0;5
1332; 38.5 ; 76.9 ; 12.4 ;2;32;147;2;0;0;2;1;1;1;1;0
1333; 46.6 ; 186.4 ; 25.0 ;4;17;214;0;4;1;3;3;1;1;2;1
1334; 38.2 ; 420.2 ; 9.3 ;11;31;22;0;11;1;10;4;7;4;7;0
1335; 47.8 ; 525.9 ; 18.6 ;11;23;22;0;11;2;9;6;5;4;3;4
1336; 34.1 ; 68.2 ; 28.6 ;2;37;47;0;2;0;2;1;1;1;0;1
1337; 73.3 ; 219.8 ; 29.6 ;3;142;53;0;3;1;2;1;2;0;0;3
1338; 15.0 ; 74.9 ; -   ;5;11;163;0;5;0;5;5;0;5;0;0
1339; 45.2 ; 361.9 ; 34.8 ;8;38;25;0;8;2;6;6;2;3;2;3
1340; 59.1 ; 177.4 ; 6.1 ;3;11;196;0;3;1;2;1;2;0;0;3
1341; 46.4 ; 92.9 ; 14.7 ;2;79;176;0;2;1;1;2;0;0;1;1
1342; 31.9 ; 63.8 ; 3.8 ;2;24;215;0;2;0;2;2;0;1;1;0
1343; 79.0 ; 236.9 ; 15.6 ;3;30;120;0;3;2;1;3;0;0;0;3
1344; 31.3 ; 939.9 ; 17.2 ;30;10;1;0;30;17;13;10;20;10;20;0
1345; 91.7 ; 183.4 ; 11.1 ;2;2;183;2;0;1;1;2;0;0;0;2
1346; 33.3 ; 532.3 ; 14.9 ;16;19;0;0;16;3;13;10;6;5;11;0
1347; 41.6 ; 166.3 ; 8.2 ;4;104;152;0;4;2;2;3;1;0;4;0
1348; 25.4 ; 635.2 ; 12.0 ;25;15;14;0;25;8;17;11;14;17;8;0
1349; 46.4 ; 464.2 ; 18.9 ;10;31;11;0;10;1;9;6;4;3;4;3
1350; 31.0 ; 1,053.4 ; 15.7 ;34;8;9;0;34;18;16;11;23;11;23;0
1351; 38.5 ; 76.9 ; 12.4 ;2;1;194;0;2;0;2;2;0;1;1;0
1352; 47.3 ; 236.6 ; 0.3 ;5;27;26;0;5;1;4;4;1;0;5;0
1353; 36.7 ; 220.0 ; 6.5 ;6;22;41;0;6;1;5;0;6;0;6;0
1354; 63.9 ; 447.6 ; 18.6 ;7;29;5;0;7;1;6;6;1;0;0;7
1355; 15.0 ; 30.0 ; -   ;2;146;186;0;2;2;0;2;0;2;0;0
1356; 20.5 ; 328.4 ; 7.1 ;16;16;38;0;16;4;12;7;9;16;0;0
1357; 65.1 ; 260.3 ; 16.3 ;4;41;78;0;4;1;3;3;1;0;0;4
1358; 35.1 ; 70.2 ; 9.5 ;2;26;246;0;2;0;2;1;1;1;1;0
1359; 28.6 ; 85.7 ; 24.5 ;3;14;87;0;3;2;1;2;1;2;1;0
1360; 54.1 ; 270.3 ; 23.3 ;5;60;22;0;5;0;5;4;1;0;3;2
1361; 26.1 ; 52.3 ; -   ;2;49;106;0;2;0;2;0;2;2;0;0
1362; 34.2 ; 205.1 ; 19.3 ;6;28;56;0;6;1;5;2;4;2;4;0
1363; 26.1 ; 104.5 ; 12.4 ;4;5;2;0;4;4;0;3;1;3;1;0
1364; 36.8 ; 73.6 ; 23.5 ;2;50;126;0;2;0;2;2;0;1;0;1
1365; 45.9 ; 137.8 ; 2.8 ;3;67;99;0;3;0;3;3;0;0;3;0
1366; 59.3 ; 118.5 ; 18.7 ;2;409;43;0;2;0;2;0;2;0;0;2
1367; 20.0 ; 40.1 ; 7.6 ;2;6;241;0;2;0;2;1;1;2;0;0
1368; 33.5 ; 167.5 ; 11.2 ;5;79;116;0;5;3;2;1;4;2;3;0
1369; 18.7 ; 74.9 ; 7.9 ;4;36;44;0;4;3;1;2;2;4;0;0
1370; 83.8 ; 335.0 ; 30.7 ;4;56;0;0;4;0;4;4;0;0;0;4
1371; 29.0 ; 58.1 ; 1.7 ;2;18;204;0;2;0;2;1;1;1;1;0
1372; 44.4 ; 88.9 ; 11.8 ;2;19;252;0;2;0;2;2;0;0;1;1
1373; 47.9 ; 143.8 ; 0.4 ;3;16;1;3;0;2;1;1;2;0;3;0
1374; 52.0 ; 207.9 ; 22.2 ;4;76;5;0;4;0;4;4;0;1;2;1
1375; 38.8 ; 77.6 ; 20.5 ;2;8;386;0;2;2;0;1;1;1;0;1
1376; 55.6 ; 111.3 ; 21.7 ;2;20;120;0;2;0;2;0;2;0;0;2
1377; 44.2 ; 132.5 ; 2.4 ;3;91;184;0;3;0;3;3;0;0;3;0
1378; 63.2 ; 632.2 ; 35.8 ;10;30;53;0;10;3;7;4;6;3;0;7
1379; 26.7 ; 133.6 ; 8.0 ;5;68;63;0;5;0;5;5;0;3;2;0
1380; 56.5 ; 395.7 ; 17.3 ;7;42;21;0;7;1;6;7;0;0;0;7
1381; 49.1 ; 98.3 ; 18.4 ;2;153;5;0;2;1;1;1;1;0;1;1
1382; 21.7 ; 108.7 ; 4.5 ;5;12;68;0;5;2;3;3;2;5;0;0
1383; 34.4 ; 137.7 ; 18.4 ;4;13;272;0;4;0;4;0;4;1;3;0
1384; 95.7 ; 478.7 ; 31.4 ;5;7;200;0;5;2;3;5;0;0;0;5
1385; 29.7 ; 148.4 ; 0.7 ;5;24;81;0;5;2;3;1;4;3;2;0
1386; 63.8 ; 127.5 ; 45.0 ;2;94;173;0;2;0;2;1;1;1;0;1
1387; 28.0 ; 112.0 ; 9.4 ;4;50;244;0;4;3;1;3;1;3;1;0
1388; 18.1 ; 36.2 ; 0.2 ;2;55;6;1;1;0;2;1;1;2;0;0
1389; 92.6 ; 370.5 ; 10.6 ;4;104;11;0;4;0;4;2;2;0;0;4
1390; 54.8 ; 109.6 ; 22.1 ;2;11;252;0;2;0;2;0;2;0;1;1
1391; 16.8 ; 33.6 ; 2.7 ;2;6;262;0;2;0;2;1;1;2;0;0
1392; 38.8 ; 77.7 ; 11.9 ;2;305;20;0;2;2;0;2;0;1;1;0
1393; 30.5 ; 122.0 ; 1.2 ;4;60;5;1;3;1;3;2;2;1;3;0
1394; 39.5 ; 592.2 ; 23.6 ;15;23;28;0;15;7;8;13;2;5;5;5
1395; 49.2 ; 98.5 ; 2.6 ;2;170;41;2;0;0;2;2;0;0;2;0
1396; 44.6 ; 89.1 ; 11.9 ;2;171;63;2;0;0;2;0;2;0;1;1
1397; 40.4 ; 80.8 ; 38.1 ;2;5;162;2;0;1;1;2;0;1;0;1
1398; 31.1 ; 62.2 ; 12.3 ;2;5;388;0;2;0;2;1;1;1;1;0
1399; 43.8 ; 306.8 ; 24.9 ;7;44;30;0;7;5;2;5;2;2;3;2
1400; 94.2 ; 471.2 ; 84.1 ;5;48;67;0;5;2;3;2;3;2;0;3
1401; 62.9 ; 188.7 ; 31.6 ;3;38;205;0;3;0;3;1;2;0;0;3
1402; 54.2 ; 3,140.9 ; 13.1 ;58;6;33;0;58;27;31;17;41;0;39;19
1403; 44.1 ; 176.6 ; 15.7 ;4;65;21;0;4;0;4;3;1;1;2;1
1404; 26.1 ; 52.3 ; 7.6 ;2;179;81;0;2;1;1;2;0;1;1;0
1405; 15.0 ; 30.0 ; -   ;2;6;263;0;2;1;1;0;2;2;0;0
1406; 22.5 ; 44.9 ; 11.2 ;2;69;185;0;2;2;0;1;1;1;1;0
1407; 26.8 ; 134.2 ; 9.8 ;5;54;67;0;5;1;4;5;0;3;2;0
1408; 26.7 ; 53.3 ; 1.4 ;2;11;209;2;0;2;0;2;0;2;0;0
1409; 17.2 ; 137.5 ; 1.8 ;8;18;12;0;8;5;3;5;3;8;0;0
1410; 62.3 ; 249.2 ; 23.7 ;4;6;20;4;0;2;2;4;0;0;0;4
1411; 46.8 ; 93.5 ; -   ;2;5;116;0;2;0;2;2;0;0;2;0
1412; 27.0 ; 270.1 ; 14.7 ;10;40;7;0;10;7;3;10;0;7;3;0
1413; 17.7 ; 35.4 ; 4.0 ;2;47;343;0;2;1;1;2;0;2;0;0
1414; 37.9 ; 75.8 ; 16.2 ;2;105;99;1;1;1;1;1;1;1;1;0
1415; 39.2 ; 391.9 ; 13.2 ;10;25;59;0;10;3;7;7;3;3;7;0
1416; 59.8 ; 119.6 ; 0.9 ;2;75;173;0;2;0;2;2;0;0;0;2
1417; 45.0 ; 270.0 ; 6.9 ;6;32;2;6;0;3;3;4;2;0;6;0
1418; 49.2 ; 245.8 ; 24.3 ;5;16;10;2;3;1;4;5;0;2;1;2
1419; 19.3 ; 77.2 ; 3.1 ;4;67;5;0;4;1;3;2;2;4;0;0
1420; 113.6 ; 340.9 ; 59.5 ;3;61;68;0;3;2;1;1;2;0;0;3
1421; 18.3 ; 219.3 ; 4.9 ;12;14;9;0;12;4;8;4;8;12;0;0
1422; 31.2 ; 62.5 ; 24.3 ;2;207;26;0;2;0;2;2;0;1;0;1
1423; 28.3 ; 226.1 ; 5.7 ;8;28;52;0;8;7;1;4;4;5;3;0
1424; 64.5 ; 128.9 ; 20.2 ;2;70;170;0;2;2;0;2;0;0;0;2
1425; 28.6 ; 828.5 ; 30.7 ;29;14;1;0;29;5;24;15;14;19;0;10
1426; 35.5 ; 355.1 ; 6.5 ;10;34;20;0;10;3;7;7;3;3;7;0
1427; 35.0 ; 70.1 ; 4.3 ;2;198;222;0;2;2;0;2;0;0;2;0
1428; 17.0 ; 679.0 ; 3.0 ;40;8;4;0;40;19;21;23;17;40;0;0
1429; 58.6 ; 117.1 ; 36.1 ;2;73;94;0;2;1;1;2;0;1;0;1
1430; 18.2 ; 91.2 ; 6.5 ;5;20;35;0;5;3;2;2;3;5;0;0
1431; 21.4 ; 641.8 ; 8.1 ;30;13;1;0;30;8;22;18;12;30;0;0
1432; 19.4 ; 58.1 ; 8.0 ;3;9;157;0;3;0;3;2;1;3;0;0
1433; 50.7 ; 101.4 ; 3.7 ;2;5;15;0;2;0;2;2;0;0;2;0
1434; 55.1 ; 165.4 ; 10.5 ;3;104;179;0;3;0;3;3;0;0;0;3
1435; 39.3 ; 157.0 ; 20.3 ;4;45;110;0;4;2;2;2;2;1;2;1
1436; 53.9 ; 107.8 ; 2.1 ;2;7;256;0;2;1;1;1;1;0;1;1
1437; 95.7 ; 191.3 ; 1.1 ;2;75;10;1;1;0;2;2;0;0;0;2
1438; 45.2 ; 90.3 ; 2.4 ;2;14;99;2;0;0;2;2;0;0;2;0
1439; 20.2 ; 60.6 ; 4.4 ;3;6;194;0;3;0;3;3;0;3;0;0
1440; 15.0 ; 45.0 ; -   ;3;5;219;0;3;2;1;2;1;3;0;0
1441; 53.6 ; 697.0 ; 23.1 ;13;30;47;0;13;3;10;10;3;0;9;4
1442; 46.9 ; 93.8 ; 4.9 ;2;80;163;0;2;0;2;1;1;0;2;0
1443; 30.6 ; 122.4 ; 17.0 ;4;96;17;0;4;0;4;3;1;1;3;0
1444; 31.6 ; 63.2 ; 2.1 ;2;176;121;0;2;0;2;2;0;1;1;0
1445; 58.7 ; 117.5 ; 9.3 ;2;293;179;0;2;1;1;1;1;0;0;2
1446; 43.7 ; 131.0 ; 0.2 ;3;40;20;0;3;3;0;1;2;0;3;0
1447; 24.1 ; 265.1 ; 13.5 ;11;15;27;11;0;1;10;5;6;7;4;0
1448; 19.1 ; 152.5 ; 7.9 ;8;18;258;0;8;3;5;6;2;8;0;0
1449; 25.9 ; 129.7 ; 16.4 ;5;44;41;0;5;2;3;4;1;3;2;0
1450; 24.1 ; 192.5 ; 9.5 ;8;41;53;0;8;2;6;3;5;5;3;0
1451; 16.5 ; 82.6 ; 2.3 ;5;35;8;0;5;1;4;1;4;5;0;0
1452; 47.1 ; 282.6 ; 1.8 ;6;63;8;0;6;3;3;0;6;0;6;0
1453; 31.2 ; 124.6 ; 12.4 ;4;10;38;0;4;1;3;2;2;1;3;0
1454; 67.3 ; 269.1 ; 36.0 ;4;13;65;4;0;4;0;1;3;0;0;4
1455; 48.1 ; 240.6 ; 11.3 ;5;88;47;0;5;3;2;2;3;0;3;2
1456; 25.8 ; 51.6 ; 16.2 ;2;53;59;0;2;1;1;1;1;1;1;0
1457; 61.0 ; 1,097.8 ; 17.8 ;18;18;16;0;18;3;15;9;9;0;0;18
1458; 19.3 ; 38.6 ; -   ;2;52;255;0;2;1;1;1;1;2;0;0
1459; 25.8 ; 51.6 ; 16.2 ;2;116;69;0;2;1;1;0;2;1;1;0
1460; 39.5 ; 158.0 ; 16.0 ;4;25;121;0;4;0;4;4;0;1;2;1
1461; 37.3 ; 74.7 ; 18.4 ;2;11;95;0;2;0;2;0;2;1;0;1
1462; 26.6 ; 771.3 ; 11.0 ;29;10;10;0;29;19;10;18;11;19;10;0
1463; 36.9 ; 221.2 ; 10.5 ;6;31;3;0;6;2;4;4;2;2;4;0
1464; 52.0 ; 104.1 ; 23.1 ;2;5;230;0;2;0;2;1;1;1;0;1
1465; 25.9 ; 595.1 ; 9.2 ;23;18;36;0;23;7;16;8;15;15;8;0
1466; 30.8 ; 123.4 ; 14.6 ;4;52;158;0;4;2;2;2;2;1;3;0
1467; 17.8 ; 89.0 ; 4.8 ;5;42;20;0;5;0;5;2;3;5;0;0
1468; 41.1 ; 164.4 ; 18.7 ;4;84;53;0;4;0;4;4;0;1;2;1
1469; 32.8 ; 98.4 ; 24.9 ;3;20;263;0;3;2;1;2;1;1;1;1
1470; 45.2 ; 90.3 ; 3.5 ;2;37;90;0;2;0;2;0;2;0;2;0
1471; 17.6 ; 176.3 ; 3.1 ;10;22;8;0;10;8;2;9;1;10;0;0
1472; 26.1 ; 104.5 ; 9.7 ;4;49;5;0;4;1;3;3;1;3;1;0
1473; 45.2 ; 180.8 ; 11.7 ;4;57;121;0;4;0;4;4;0;0;3;1
1474; 25.1 ; 100.3 ; -   ;4;11;245;0;4;2;2;1;3;4;0;0
1475; 79.3 ; 237.8 ; 40.0 ;3;113;110;0;3;2;1;1;2;0;0;3
1476; 41.2 ; 288.5 ; 12.9 ;7;17;0;0;7;0;7;7;0;2;5;0
1477; 41.8 ; 167.3 ; 11.1 ;4;95;69;0;4;0;4;2;2;0;4;0
1478; 30.6 ; 91.8 ; 20.1 ;3;122;86;0;3;2;1;2;1;1;2;0
1479; 30.7 ; 153.4 ; 32.2 ;5;25;42;0;5;0;5;3;2;2;1;2
1480; 67.7 ; 135.4 ; 5.0 ;2;72;33;0;2;2;0;1;1;0;0;2
1481; 57.9 ; 347.4 ; 18.4 ;6;52;17;0;6;2;4;6;0;0;0;6
1482; 56.1 ; 168.3 ; 6.6 ;3;13;236;0;3;0;3;3;0;0;0;3
1483; 21.3 ; 85.0 ; 7.9 ;4;1;47;0;4;3;1;1;3;4;0;0
1484; 40.7 ; 122.0 ; 28.6 ;3;41;5;1;2;0;3;2;1;1;1;1
1485; 16.8 ; 184.6 ; 2.9 ;11;28;28;0;11;5;6;8;3;11;0;0
1486; 60.1 ; 240.2 ; 7.4 ;4;29;185;0;4;2;2;0;4;0;0;4
1487; 76.5 ; 1,301.2 ; 13.8 ;17;22;20;0;17;0;17;17;0;0;0;17
1488; 32.3 ; 96.9 ; 13.3 ;3;61;173;0;3;1;2;3;0;1;2;0
1489; 55.7 ; 445.5 ; 8.1 ;8;32;5;0;8;0;8;6;2;0;0;8
1490; 15.0 ; 30.0 ; -   ;2;23;288;0;2;1;1;0;2;2;0;0
1491; 45.7 ; 137.1 ; 12.2 ;3;106;134;0;3;1;2;1;2;0;2;1
1492; 42.5 ; 255.2 ; 12.2 ;6;38;82;0;6;4;2;3;3;0;6;0
1493; 35.9 ; 251.6 ; 18.2 ;7;44;20;0;7;1;6;4;3;2;5;0
1494; 27.4 ; 136.8 ; 3.8 ;5;55;74;0;5;0;5;1;4;3;2;0
1495; 17.6 ; 88.2 ; 6.9 ;5;68;6;0;5;3;2;4;1;5;0;0
1496; 18.0 ; 252.0 ; 3.8 ;14;10;11;0;14;6;8;4;10;14;0;0
1497; 45.0 ; 225.1 ; 10.9 ;5;36;161;0;5;5;0;5;0;0;3;2
1498; 48.6 ; 291.7 ; 2.8 ;6;56;89;0;6;2;4;4;2;0;6;0
1499; 54.1 ; 162.2 ; 10.8 ;3;5;11;0;3;1;2;0;3;0;2;1
1500; 21.1 ; 42.2 ; -   ;2;15;293;0;2;1;1;1;1;2;0;0
1501; 26.9 ; 134.3 ; 13.9 ;5;75;10;0;5;2;3;2;3;3;2;0
1502; 84.5 ; 1,268.2 ; 44.8 ;15;13;50;0;15;9;6;4;11;0;0;15
1503; 19.5 ; 273.3 ; 13.1 ;14;20;82;0;14;7;7;6;8;9;5;0
1504; 47.6 ; 332.9 ; 2.1 ;7;50;57;0;7;1;6;5;2;0;7;0
1505; 32.0 ; 127.9 ; 5.8 ;4;1;245;0;4;2;2;4;0;1;3;0
1506; 41.2 ; 123.7 ; 10.1 ;3;29;164;0;3;2;1;1;2;0;3;0
1507; 25.0 ; 250.2 ; 13.6 ;10;30;0;0;10;2;8;5;5;7;3;0
1508; 18.7 ; 186.8 ; 0.4 ;10;4;41;0;10;5;5;10;0;10;0;0
1509; 75.9 ; 151.8 ; 35.0 ;2;16;263;0;2;1;1;2;0;0;0;2
1510; 28.5 ; 228.3 ; 12.6 ;8;30;74;0;8;3;5;2;6;5;3;0
1511; 70.2 ; 140.4 ; 39.9 ;2;7;52;2;0;0;2;2;0;0;0;2
1512; 25.3 ; 151.8 ; 12.4 ;6;56;106;0;6;0;6;5;1;4;2;0
1513; 76.8 ; 307.2 ; 83.8 ;4;11;200;0;4;1;3;1;3;1;0;3
1514; 32.8 ; 98.3 ; 17.2 ;3;9;163;0;3;1;2;0;3;1;2;0
1515; 35.7 ; 178.6 ; 15.6 ;5;32;110;0;5;1;4;2;3;2;3;0
1516; 29.5 ; 206.2 ; 8.7 ;7;20;16;7;0;0;7;5;2;5;2;0
1517; 84.3 ; 927.2 ; 57.7 ;11;26;11;0;11;4;7;5;6;4;0;7
1518; 55.2 ; 331.4 ; 8.3 ;6;71;36;0;6;0;6;2;4;0;0;6
1519; 49.1 ; 98.3 ; 0.6 ;2;132;104;0;2;0;2;2;0;0;2;0
1520; 35.9 ; 467.0 ; 9.3 ;13;13;168;0;13;2;11;6;7;4;9;0
1521; 52.1 ; 104.2 ; 8.0 ;2;71;88;0;2;1;1;0;2;0;1;1
1522; 37.0 ; 222.2 ; 9.5 ;6;18;29;0;6;5;1;1;5;2;4;0
1523; 25.1 ; 50.1 ; -   ;2;50;5;0;2;0;2;2;0;2;0;0
1524; 16.7 ; 133.2 ; 5.3 ;8;16;45;0;8;4;4;2;6;8;0;0
1525; 21.2 ; 169.9 ; 7.6 ;8;38;26;0;8;3;5;3;5;8;0;0
1526; 26.6 ; 398.9 ; 24.0 ;15;28;5;0;15;2;13;6;9;10;5;0
1527; 15.0 ; 30.0 ; -   ;2;2;34;0;2;1;1;0;2;2;0;0
1528; 51.0 ; 102.0 ; -   ;2;70;213;0;2;1;1;2;0;0;2;0
1529; 32.4 ; 162.1 ; 9.2 ;5;29;105;0;5;0;5;3;2;2;3;0
1530; 45.9 ; 367.4 ; 9.4 ;8;45;41;0;8;1;7;6;2;0;5;3
1531; 30.2 ; 60.4 ; -   ;2;212;41;2;0;1;1;0;2;0;2;0
1532; 58.0 ; 116.0 ; 1.4 ;2;176;10;2;0;0;2;2;0;0;0;2
1533; 36.6 ; 73.2 ; -   ;2;5;321;0;2;0;2;2;0;0;2;0
1534; 29.7 ; 148.6 ; 13.6 ;5;31;160;0;5;3;2;5;0;3;2;0
1535; 18.6 ; 55.7 ; 2.5 ;3;11;5;3;0;1;2;3;0;3;0;0
1536; 15.4 ; 61.5 ; 0.8 ;4;32;44;0;4;3;1;4;0;4;0;0
1537; 26.4 ; 52.9 ; 17.2 ;2;355;105;1;1;1;1;0;2;1;1;0
1538; 89.8 ; 359.1 ; 59.5 ;4;84;162;0;4;0;4;4;0;0;0;4
1539; 82.6 ; 165.2 ; 23.0 ;2;31;215;0;2;0;2;2;0;0;0;2
1540; 41.7 ; 208.5 ; 14.7 ;5;49;220;0;5;2;3;3;2;2;1;2
1541; 24.9 ; 49.9 ; 7.9 ;2;9;33;0;2;1;1;2;0;1;1;0
1542; 36.5 ; 73.0 ; 9.5 ;2;264;37;1;1;0;2;1;1;1;1;0
1543; 31.1 ; 529.0 ; 28.7 ;17;25;26;0;17;3;14;9;8;6;5;6
1544; 31.5 ; 220.6 ; 8.9 ;7;39;12;0;7;5;2;7;0;2;5;0
1545; 17.6 ; 668.9 ; 5.9 ;38;12;0;0;38;11;27;19;19;38;0;0
1546; 31.2 ; 281.1 ; 11.2 ;9;20;122;0;9;3;6;5;4;3;6;0
1547; 24.2 ; 72.6 ; 8.5 ;3;41;165;0;3;2;1;1;2;2;1;0
1548; 43.2 ; 172.8 ; 5.9 ;4;73;64;0;4;1;3;2;2;0;4;0
1549; 39.4 ; 78.9 ; 13.9 ;2;77;110;1;1;1;1;1;1;1;1;0
1550; 53.7 ; 107.4 ; 9.3 ;2;238;74;0;2;0;2;1;1;0;1;1
1551; 74.9 ; 299.6 ; 44.7 ;4;77;63;0;4;2;2;1;3;0;0;4
1552; 50.0 ; 300.0 ; 3.2 ;6;50;26;0;6;0;6;6;0;0;6;0
1553; 36.6 ; 73.2 ; -   ;2;1;278;0;2;0;2;1;1;0;2;0
1554; 41.3 ; 619.5 ; 18.2 ;15;23;10;0;15;4;11;5;10;5;5;5
1555; 32.7 ; 228.7 ; 12.8 ;7;15;68;0;7;4;3;1;6;2;5;0
1556; 45.6 ; 136.9 ; 13.7 ;3;4;253;0;3;1;2;1;2;0;2;1
1557; 38.4 ; 192.0 ; 8.0 ;5;17;15;0;5;3;2;2;3;0;5;0
1558; 26.5 ; 53.0 ; 2.1 ;2;6;194;0;2;0;2;2;0;2;0;0
1559; 36.3 ; 72.5 ; 16.8 ;2;94;36;0;2;0;2;0;2;1;1;0
1560; 47.1 ; 94.2 ; 0.5 ;2;207;99;0;2;0;2;2;0;0;2;0
1561; 21.1 ; 337.6 ; 7.4 ;16;13;17;0;16;0;16;5;11;16;0;0
1562; 37.4 ; 112.3 ; 15.2 ;3;51;93;0;3;1;2;1;2;1;2;0
1563; 182.4 ; 547.1 ; 133.1 ;3;174;110;0;3;0;3;1;2;0;0;3
1564; 35.7 ; 142.9 ; 14.3 ;4;69;121;0;4;2;2;2;2;1;3;0
1565; 98.9 ; 494.3 ; 39.6 ;5;70;15;0;5;0;5;3;2;0;0;5
1566; 38.5 ; 154.0 ; 13.3 ;4;100;32;0;4;2;2;3;1;1;3;0
1567; 46.9 ; 375.5 ; 33.2 ;8;19;131;0;8;0;8;4;4;3;2;3
1568; 49.5 ; 494.5 ; 23.6 ;10;14;20;0;10;2;8;7;3;3;4;3
1569; 50.7 ; 557.8 ; 8.6 ;11;23;5;0;11;0;11;6;5;0;7;4
1570; 65.1 ; 195.4 ; 26.4 ;3;4;167;3;0;0;3;3;0;0;0;3
1571; 15.9 ; 63.5 ; 1.9 ;4;33;120;0;4;0;4;2;2;4;0;0
1572; 25.1 ; 50.1 ; -   ;2;2;146;2;0;0;2;1;1;2;0;0
1573; 80.3 ; 160.7 ; 11.0 ;2;94;94;0;2;0;2;2;0;0;0;2
1574; 59.3 ; 118.6 ; 1.6 ;2;57;83;0;2;0;2;2;0;0;0;2
1575; 61.1 ; 183.4 ; 20.0 ;3;21;160;0;3;1;2;2;1;0;0;3
1576; 56.0 ; 224.0 ; 4.0 ;4;48;11;0;4;0;4;2;2;0;0;4
1577; 18.3 ; 328.8 ; 5.6 ;18;17;3;0;18;7;11;18;0;18;0;0
1578; 28.7 ; 287.4 ; 15.6 ;10;28;36;0;10;3;7;8;2;7;3;0
1579; 61.1 ; 183.2 ; 47.6 ;3;113;68;0;3;2;1;3;0;1;0;2
1580; 30.1 ; 60.1 ; 0.2 ;2;26;146;2;0;0;2;1;1;1;1;0
1581; 47.8 ; 95.7 ; 0.5 ;2;21;9;2;0;1;1;1;1;0;2;0
1582; 60.4 ; 120.7 ; 45.2 ;2;54;336;0;2;1;1;1;1;1;0;1
1583; 38.1 ; 114.2 ; 30.0 ;3;29;18;1;2;3;0;1;2;1;1;1
1584; 56.4 ; 169.3 ; 11.8 ;3;74;125;0;3;1;2;2;1;0;0;3
1585; 63.6 ; 127.2 ; 16.6 ;2;93;268;0;2;1;1;1;1;0;0;2
1586; 38.5 ; 76.9 ; 12.4 ;2;101;272;0;2;2;0;0;2;1;1;0
1587; 34.2 ; 137.0 ; 16.8 ;4;112;93;0;4;1;3;3;1;1;3;0
1588; 31.7 ; 158.5 ; 10.4 ;5;63;98;1;4;2;3;3;2;2;3;0
1589; 21.0 ; 63.0 ; 5.6 ;3;97;0;0;3;0;3;1;2;3;0;0
1590; 26.6 ; 159.8 ; 11.6 ;6;26;1;0;6;0;6;4;2;4;2;0
1591; 28.1 ; 56.2 ; -   ;2;25;131;0;2;0;2;2;0;2;0;0
1592; 56.8 ; 794.7 ; 23.7 ;14;31;28;0;14;4;10;12;2;0;0;14
1593; 46.8 ; 140.3 ; -   ;3;15;236;0;3;0;3;2;1;0;3;0
1594; 42.9 ; 85.9 ; 26.8 ;2;54;22;0;2;0;2;1;1;1;0;1
1595; 36.9 ; 73.8 ; 17.7 ;2;183;33;0;2;2;0;0;2;1;1;0
1596; 81.7 ; 245.0 ; 14.8 ;3;117;125;0;3;2;1;1;2;0;0;3
1597; 31.7 ; 158.7 ; 10.4 ;5;32;6;0;5;4;1;1;4;2;3;0
1598; 34.4 ; 172.1 ; 13.5 ;5;81;23;0;5;3;2;2;3;2;3;0
1599; 46.1 ; 138.4 ; 24.3 ;3;130;93;0;3;1;2;1;2;1;1;1
1600; 70.5 ; 141.0 ; 12.5 ;2;6;262;0;2;0;2;2;0;0;0;2
1601; 54.2 ; 921.9 ; 19.1 ;17;16;15;0;17;0;17;16;1;0;11;6
1602; 23.2 ; 92.9 ; 5.3 ;4;21;122;0;4;1;3;1;3;4;0;0
1603; 60.4 ; 845.4 ; 44.4 ;14;30;36;0;14;4;10;8;6;5;0;9
1604; 27.1 ; 135.7 ; 7.2 ;5;2;200;0;5;1;4;4;1;3;2;0
1605; 69.3 ; 208.0 ; 47.7 ;3;23;206;0;3;2;1;3;0;1;0;2
1606; 74.4 ; 520.6 ; 22.2 ;7;41;116;0;7;0;7;4;3;0;0;7
1607; 17.4 ; 174.4 ; 2.5 ;10;20;1;0;10;7;3;8;2;10;0;0
1608; 97.9 ; 391.5 ; 98.0 ;4;13;59;0;4;4;0;2;2;1;0;3
1609; 33.0 ; 66.0 ; 27.0 ;2;1;193;0;2;1;1;1;1;1;0;1
1610; 53.2 ; 106.4 ; 7.5 ;2;72;18;1;1;1;1;1;1;0;1;1
1611; 77.3 ; 231.9 ; 23.2 ;3;131;38;0;3;1;2;3;0;0;0;3
1612; 21.0 ; 294.5 ; 5.4 ;14;32;52;0;14;2;12;8;6;14;0;0
1613; 28.9 ; 57.9 ; 20.9 ;2;1;362;0;2;0;2;1;1;1;1;0
1614; 26.9 ; 161.1 ; 19.4 ;6;19;5;0;6;2;4;3;3;4;2;0
1615; 43.9 ; 87.8 ; 10.1 ;2;19;247;0;2;0;2;0;2;0;2;0
1616; 37.2 ; 74.3 ; 6.5 ;2;278;125;0;2;0;2;1;1;0;2;0
1617; 41.8 ; 209.1 ; 13.0 ;5;11;290;0;5;1;4;2;3;2;3;0
1618; 27.1 ; 622.7 ; 7.4 ;23;16;5;0;23;6;17;10;13;15;8;0
1619; 35.7 ; 71.5 ; 8.3 ;2;68;89;0;2;0;2;0;2;1;1;0
1620; 24.0 ; 215.7 ; 9.7 ;9;13;0;0;9;2;7;3;6;6;3;0
1621; 38.8 ; 931.1 ; 15.1 ;24;12;5;0;24;7;17;5;19;8;16;0
1622; 45.9 ; 91.8 ; 3.4 ;2;76;1;2;0;0;2;0;2;0;2;0
1623; 19.8 ; 59.5 ; 5.3 ;3;128;53;0;3;2;1;0;3;3;0;0
1624; 35.3 ; 1,411.3 ; 21.6 ;40;5;37;0;40;15;25;19;21;13;14;13
1625; 60.0 ; 180.0 ; 22.5 ;3;155;135;0;3;1;2;3;0;0;0;3
1626; 36.1 ; 72.3 ; 18.8 ;2;63;274;0;2;0;2;0;2;1;1;0
1627; 35.0 ; 105.1 ; 13.9 ;3;65;70;0;3;2;1;1;2;1;2;0
1628; 31.5 ; 125.8 ; 17.4 ;4;127;11;0;4;2;2;3;1;1;3;0
1629; 47.6 ; 142.9 ; 1.0 ;3;41;40;0;3;1;2;3;0;0;3;0
1630; 51.8 ; 155.3 ; 39.6 ;3;81;26;1;2;1;2;2;1;1;1;1
1631; 64.0 ; 128.1 ; 25.7 ;2;4;122;0;2;0;2;0;2;0;0;2
1632; 31.4 ; 156.8 ; 2.0 ;5;41;10;0;5;0;5;5;0;2;3;0
1633; 16.8 ; 33.6 ; 2.7 ;2;18;267;0;2;0;2;0;2;2;0;0
1634; 36.6 ; 73.2 ; -   ;2;81;209;0;2;0;2;2;0;0;2;0
1635; 20.0 ; 100.2 ; 4.6 ;5;82;47;0;5;0;5;1;4;5;0;0
1636; 41.1 ; 205.3 ; 21.4 ;5;34;12;0;5;2;3;3;2;2;1;2
1637; 25.8 ; 51.6 ; 1.1 ;2;25;93;0;2;1;1;2;0;2;0;0
1638; 37.0 ; 443.9 ; 14.5 ;12;25;17;0;12;8;4;2;10;4;8;0
1639; 22.6 ; 45.2 ; 11.4 ;2;19;189;2;0;0;2;1;1;1;1;0
1640; 20.9 ; 104.4 ; 7.1 ;5;9;258;0;5;3;2;2;3;5;0;0
1641; 84.0 ; 335.9 ; 13.8 ;4;24;80;4;0;2;2;4;0;0;0;4
1642; 15.9 ; 47.8 ; 1.7 ;3;31;148;0;3;0;3;1;2;3;0;0
1643; 47.6 ; 285.7 ; 24.9 ;6;49;57;0;6;2;4;1;5;2;2;2
1644; 54.8 ; 712.0 ; 14.8 ;13;23;52;0;13;9;4;13;0;0;9;4
1645; 45.6 ; 364.6 ; 15.2 ;8;16;47;6;2;0;8;7;1;0;5;3
1646; 62.1 ; 248.5 ; 54.1 ;4;102;40;0;4;1;3;4;0;1;0;3
1647; 38.4 ; 306.9 ; 5.6 ;8;38;10;0;8;2;6;6;2;0;8;0
1648; 43.9 ; 219.6 ; 17.3 ;5;58;170;0;5;3;2;1;4;2;1;2
1649; 49.2 ; 98.3 ; 3.6 ;2;81;320;0;2;0;2;2;0;0;2;0
1650; 76.1 ; 913.4 ; 20.0 ;12;38;8;0;12;1;11;10;2;0;0;12
1651; 38.6 ; 77.2 ; 28.3 ;2;36;255;0;2;2;0;2;0;1;0;1
1652; 37.3 ; 149.1 ; 21.7 ;4;77;40;0;4;1;3;2;2;1;2;1
1653; 51.1 ; 153.2 ; 5.9 ;3;76;5;0;3;0;3;3;0;0;2;1
1654; 20.0 ; 40.1 ; 7.6 ;2;70;26;0;2;0;2;1;1;2;0;0
1655; 28.1 ; 140.3 ; 8.4 ;5;47;123;0;5;1;4;1;4;3;2;0
1656; 42.3 ; 211.7 ; 31.4 ;5;67;67;0;5;3;2;1;4;2;1;2
1657; 47.7 ; 95.5 ; 1.5 ;2;104;167;0;2;1;1;1;1;0;2;0
1658; 17.9 ; 35.7 ; 1.1 ;2;9;212;0;2;2;0;1;1;2;0;0
1659; 56.3 ; 281.3 ; 45.9 ;5;89;1;2;3;0;5;5;0;2;0;3
1660; 19.2 ; 191.6 ; 6.1 ;10;20;7;0;10;4;6;4;6;10;0;0
1661; 64.0 ; 127.9 ; 44.2 ;2;12;248;0;2;0;2;0;2;1;0;1
1662; 67.7 ; 745.1 ; 18.8 ;11;27;5;0;11;1;10;11;0;0;0;11
1663; 48.0 ; 335.9 ; 10.8 ;7;21;0;0;7;0;7;5;2;0;5;2
1664; 29.1 ; 116.2 ; 10.3 ;4;148;19;0;4;2;2;3;1;3;1;0
1665; 29.3 ; 146.4 ; 19.9 ;5;71;0;0;5;1;4;2;3;3;2;0
1666; 25.1 ; 75.2 ; -   ;3;19;0;0;3;0;3;3;0;3;0;0
1667; 35.4 ; 70.7 ; 30.5 ;2;14;34;2;0;2;0;2;0;1;0;1
1668; 40.1 ; 120.3 ; 16.5 ;3;29;221;0;3;2;1;1;2;1;1;1
1669; 53.5 ; 160.4 ; 0.4 ;3;32;5;0;3;1;2;1;2;0;3;0
1670; 38.0 ; 76.1 ; 19.4 ;2;44;257;0;2;0;2;1;1;1;0;1
1671; 22.5 ; 45.0 ; 3.8 ;2;103;64;0;2;1;1;0;2;2;0;0
1672; 15.0 ; 45.0 ; -   ;3;13;75;0;3;2;1;1;2;3;0;0
1673; 54.9 ; 164.6 ; 4.0 ;3;194;84;0;3;1;2;3;0;0;2;1
1674; 31.8 ; 63.6 ; 25.2 ;2;77;140;0;2;1;1;0;2;1;0;1
1675; 20.0 ; 240.4 ; 12.6 ;12;22;14;2;10;10;2;12;0;8;4;0
1676; 71.8 ; 215.4 ; 14.1 ;3;108;3;3;0;2;1;1;2;0;0;3
1677; 20.4 ; 244.7 ; 5.8 ;12;32;2;0;12;8;4;3;9;12;0;0
1678; 29.6 ; 147.8 ; 2.7 ;5;62;116;0;5;2;3;4;1;3;2;0
1679; 25.8 ; 206.4 ; 19.2 ;8;32;1;0;8;0;8;7;1;5;3;0
1680; 41.6 ; 83.3 ; 32.9 ;2;17;233;0;2;1;1;2;0;1;0;1
1681; 25.3 ; 429.3 ; 12.9 ;17;16;3;0;17;6;11;5;12;11;6;0
1682; 24.8 ; 149.1 ; 17.3 ;6;18;35;0;6;5;1;1;5;4;2;0
1683; 29.9 ; 89.8 ; 11.4 ;3;9;19;0;3;2;1;3;0;2;1;0
1684; 42.7 ; 213.6 ; 19.2 ;5;19;120;0;5;1;4;1;4;2;1;2
1685; 15.0 ; 74.9 ; -   ;5;46;58;0;5;1;4;4;1;5;0;0
1686; 49.0 ; 244.8 ; 13.2 ;5;32;100;0;5;0;5;2;3;0;3;2
1687; 18.6 ; 37.2 ; -   ;2;226;35;0;2;2;0;2;0;2;0;0
1688; 62.5 ; 125.1 ; 22.5 ;2;91;86;0;2;1;1;1;1;0;0;2
1689; 60.8 ; 607.7 ; 18.1 ;10;25;14;0;10;4;6;4;6;0;0;10
1690; 43.3 ; 303.3 ; 16.7 ;7;16;251;0;7;0;7;0;7;2;3;2
1691; 15.0 ; 45.0 ; -   ;3;5;1;0;3;1;2;1;2;3;0;0
1692; 51.4 ; 102.9 ; 7.0 ;2;11;153;2;0;0;2;2;0;0;1;1
1693; 32.0 ; 160.1 ; 9.0 ;5;86;86;0;5;2;3;3;2;2;3;0
1694; 44.6 ; 178.6 ; 20.9 ;4;109;47;0;4;1;3;1;3;1;2;1
1695; 29.7 ; 684.1 ; 14.8 ;23;5;257;0;23;16;7;5;18;15;8;0
1696; 18.0 ; 36.0 ; -   ;2;29;113;0;2;1;1;0;2;2;0;0
1697; 31.4 ; 125.6 ; 13.1 ;4;29;231;0;4;0;4;3;1;1;3;0
1698; 47.5 ; 142.4 ; -   ;3;29;52;0;3;0;3;3;0;0;3;0
1699; 27.1 ; 81.3 ; 9.5 ;3;35;93;0;3;1;2;2;1;2;1;0
1700; 32.2 ; 96.7 ; 18.3 ;3;11;229;0;3;2;1;1;2;1;2;0
1701; 23.4 ; 187.0 ; 11.5 ;8;29;0;0;8;3;5;3;5;5;3;0
1702; 20.7 ; 289.3 ; 10.3 ;14;5;246;0;14;10;4;11;3;9;5;0
1703; 32.5 ; 422.8 ; 16.0 ;13;14;221;0;13;6;7;7;6;4;9;0
1704; 37.8 ; 75.6 ; 14.5 ;2;2;99;0;2;0;2;1;1;1;1;0
1705; 28.2 ; 56.5 ; 2.6 ;2;89;68;0;2;0;2;1;1;1;1;0
1706; 49.6 ; 99.1 ; -   ;2;11;108;2;0;2;0;0;2;0;2;0
1707; 19.8 ; 39.6 ; 7.2 ;2;5;313;0;2;2;0;2;0;2;0;0
1708; 47.1 ; 94.2 ; 0.5 ;2;94;36;0;2;0;2;2;0;0;2;0
1709; 30.6 ; 61.2 ; 8.3 ;2;221;215;0;2;0;2;0;2;1;1;0
1710; 49.0 ; 245.1 ; 13.6 ;5;38;2;0;5;1;4;2;3;0;3;2
1711; 59.8 ; 657.8 ; 78.2 ;11;19;34;0;11;6;5;6;5;4;0;7
1712; 89.9 ; 269.6 ; 61.4 ;3;101;0;0;3;0;3;2;1;1;0;2
1713; 20.0 ; 99.9 ; 13.0 ;5;20;209;0;5;0;5;2;3;3;2;0
1714; 85.5 ; 171.0 ; 38.2 ;2;193;17;0;2;0;2;2;0;0;0;2
1715; 49.8 ; 99.6 ; 4.6 ;2;5;194;1;1;0;2;1;1;0;2;0
1716; 38.8 ; 77.7 ; 3.3 ;2;195;136;0;2;0;2;2;0;0;2;0
1717; 25.1 ; 50.1 ; -   ;2;45;98;2;0;1;1;2;0;2;0;0
1718; 37.1 ; 557.0 ; 14.3 ;15;10;17;0;15;7;8;4;11;5;10;0
1719; 51.0 ; 102.1 ; 5.3 ;2;65;24;2;0;1;1;1;1;0;1;1
1720; 55.3 ; 442.4 ; 24.4 ;8;22;52;0;8;1;7;8;0;0;0;8
1721; 38.2 ; 152.9 ; 31.9 ;4;3;256;0;4;3;1;2;2;1;2;1
1722; 39.1 ; 156.4 ; 7.7 ;4;19;223;0;4;4;0;4;0;0;4;0
1723; 20.7 ; 41.5 ; -   ;2;59;38;2;0;1;1;1;1;2;0;0
1724; 24.7 ; 123.4 ; 12.8 ;5;48;62;0;5;1;4;1;4;3;2;0
1725; 71.1 ; 142.1 ; 33.6 ;2;132;162;0;2;0;2;2;0;0;0;2
1726; 47.5 ; 427.6 ; 10.0 ;9;15;17;0;9;4;5;4;5;0;6;3
1727; 50.6 ; 151.8 ; 3.5 ;3;16;341;0;3;0;3;1;2;0;3;0
1728; 22.6 ; 45.2 ; 11.4 ;2;108;69;2;0;1;1;2;0;1;1;0
1729; 18.9 ; 37.9 ; -   ;2;25;199;2;0;0;2;2;0;2;0;0
1730; 64.9 ; 324.5 ; 29.7 ;5;25;84;0;5;0;5;3;2;0;0;5
1731; 71.3 ; 570.2 ; 35.7 ;8;40;26;0;8;2;6;8;0;0;0;8
1732; 15.0 ; 45.0 ; -   ;3;59;17;0;3;0;3;0;3;3;0;0
1733; 73.2 ; 219.6 ; 67.1 ;3;97;111;0;3;0;3;1;2;1;0;2
1734; 27.4 ; 82.1 ; 10.4 ;3;1;148;3;0;2;1;1;2;2;1;0
1735; 30.2 ; 150.8 ; 17.1 ;5;45;42;0;5;3;2;3;2;2;3;0
1736; 57.9 ; 694.2 ; 42.8 ;12;25;3;0;12;2;10;6;6;4;0;8
1737; 17.5 ; 70.0 ; 5.3 ;4;104;0;2;2;2;2;3;1;4;0;0
1738; 28.9 ; 202.1 ; 5.3 ;7;41;104;0;7;1;6;4;3;5;2;0
1739; 48.9 ; 146.7 ; 34.6 ;3;2;46;0;3;2;1;1;2;1;1;1
1740; 22.6 ; 158.0 ; 13.6 ;7;23;0;0;7;2;5;3;4;5;2;0
1741; 27.5 ; 192.5 ; 5.7 ;7;13;15;0;7;1;6;7;0;5;2;0
1742; 37.3 ; 186.7 ; 8.8 ;5;47;22;0;5;0;5;4;1;2;3;0
1743; 100.0 ; 200.0 ; 39.3 ;2;172;69;0;2;1;1;0;2;0;0;2
1744; 61.8 ; 308.9 ; 34.0 ;5;41;140;0;5;1;4;3;2;2;0;3
1745; 68.4 ; 205.1 ; 43.8 ;3;8;10;1;2;1;2;1;2;1;0;2
1746; 48.1 ; 144.3 ; 0.6 ;3;100;11;0;3;1;2;3;0;0;3;0
1747; 22.1 ; 132.5 ; 8.4 ;6;11;49;0;6;4;2;0;6;4;2;0
1748; 49.0 ; 489.6 ; 42.7 ;10;32;4;0;10;4;6;9;1;3;4;3
1749; 17.8 ; 88.9 ; 2.8 ;5;40;257;0;5;2;3;3;2;5;0;0
1750; 90.3 ; 180.7 ; 6.9 ;2;73;47;0;2;1;1;1;1;0;0;2
1751; 35.4 ; 283.5 ; 10.6 ;8;19;11;0;8;0;8;5;3;3;5;0
1752; 40.7 ; 203.4 ; 18.4 ;5;69;29;2;3;4;1;5;0;2;1;2
1753; 50.5 ; 151.6 ; 26.6 ;3;54;173;0;3;1;2;2;1;1;1;1
1754; 43.5 ; 174.1 ; 13.8 ;4;55;133;0;4;3;1;2;2;1;2;1
1755; 18.0 ; 90.1 ; 7.2 ;5;52;5;2;3;0;5;5;0;5;0;0
1756; 26.8 ; 80.3 ; 3.1 ;3;97;59;0;3;1;2;1;2;3;0;0
1757; 20.9 ; 62.7 ; 9.5 ;3;18;56;0;3;3;0;1;2;2;1;0
1758; 15.6 ; 933.8 ; 2.5 ;60;5;2;0;60;26;34;20;40;60;0;0
1759; 63.9 ; 511.4 ; 24.8 ;8;27;178;0;8;2;6;4;4;0;0;8
1760; 32.5 ; 162.7 ; 12.2 ;5;20;22;0;5;0;5;2;3;2;3;0
1761; 20.6 ; 185.4 ; 7.2 ;9;12;73;0;9;0;9;9;0;9;0;0
1762; 48.1 ; 96.1 ; 0.9 ;2;205;44;0;2;1;1;2;0;0;2;0
1763; 21.2 ; 509.2 ; 6.5 ;24;6;17;0;24;14;10;3;21;24;0;0
1764; 53.8 ; 322.7 ; 17.9 ;6;66;12;0;6;1;5;3;3;0;4;2
1765; 51.8 ; 414.5 ; 37.7 ;8;5;145;0;8;3;5;4;4;3;2;3
1766; 37.7 ; 75.4 ; 14.7 ;2;161;83;0;2;2;0;0;2;1;1;0
1767; 18.6 ; 37.2 ; -   ;2;1;402;0;2;2;0;2;0;2;0;0
1768; 18.6 ; 55.7 ; -   ;3;20;94;3;0;0;3;1;2;3;0;0
1769; 64.9 ; 194.8 ; 33.3 ;3;34;116;3;0;1;2;1;2;0;0;3
1770; 39.0 ; 195.1 ; 5.9 ;5;20;335;0;5;3;2;4;1;0;5;0
1771; 40.8 ; 81.7 ; -   ;2;10;338;0;2;1;1;1;1;0;2;0
1772; 32.0 ; 96.1 ; 6.5 ;3;27;263;0;3;2;1;3;0;1;2;0
1773; 142.5 ; 285.0 ; 89.9 ;2;62;152;0;2;0;2;2;0;0;0;2
1774; 30.1 ; 753.1 ; 21.0 ;25;15;11;0;25;16;9;13;12;8;17;0
1775; 32.0 ; 63.9 ; 22.2 ;2;224;86;0;2;1;1;1;1;1;1;0
1776; 88.0 ; 176.1 ; 71.3 ;2;15;248;0;2;1;1;0;2;1;0;1
1777; 47.9 ; 143.8 ; 0.4 ;3;22;5;0;3;0;3;3;0;0;3;0
1778; 44.8 ; 89.6 ; 2.9 ;2;18;252;0;2;0;2;2;0;0;2;0
1779; 65.5 ; 523.9 ; 20.1 ;8;23;116;0;8;0;8;6;2;0;0;8
1780; 25.1 ; 75.2 ; -   ;3;4;250;0;3;3;0;3;0;3;0;0
1781; 17.9 ; 232.3 ; 5.0 ;13;11;157;0;13;7;6;4;9;13;0;0
1782; 17.0 ; 135.9 ; 2.0 ;8;3;250;0;8;4;4;5;3;8;0;0
1783; 41.1 ; 205.7 ; 16.1 ;5;24;183;0;5;1;4;3;2;2;1;2
1784; 42.9 ; 85.7 ; -   ;2;7;290;0;2;1;1;1;1;0;2;0
1785; 41.9 ; 209.4 ; 17.7 ;5;49;43;0;5;1;4;2;3;2;1;2
1786; 25.0 ; 1,726.7 ; 14.0 ;69;5;4;0;69;26;43;48;21;46;23;0
1787; 21.7 ; 65.1 ; 6.2 ;3;66;26;0;3;0;3;3;0;3;0;0
1788; 58.6 ; 175.7 ; 13.7 ;3;189;110;0;3;0;3;2;1;0;0;3
1789; 18.3 ; 55.0 ; 6.2 ;3;149;0;0;3;1;2;2;1;3;0;0
1790; 58.5 ; 292.4 ; 18.6 ;5;32;40;0;5;1;4;1;4;0;0;5
1791; 27.7 ; 442.4 ; 11.8 ;16;19;2;0;16;8;8;13;3;11;5;0
1792; 68.3 ; 341.6 ; 38.1 ;5;74;26;0;5;0;5;5;0;0;0;5
1793; 47.9 ; 239.5 ; 12.4 ;5;58;23;0;5;5;0;1;4;0;3;2
1794; 17.5 ; 69.9 ; 5.3 ;4;13;245;0;4;3;1;3;1;4;0;0
1795; 39.6 ; 197.8 ; 20.1 ;5;41;33;0;5;3;2;5;0;2;1;2
1796; 15.0 ; 30.0 ; -   ;2;169;78;0;2;0;2;2;0;2;0;0
1797; 15.0 ; 30.0 ; -   ;2;132;122;0;2;0;2;2;0;2;0;0
1798; 55.3 ; 110.7 ; 11.8 ;2;103;0;2;0;1;1;2;0;0;0;2
1799; 48.8 ; 244.0 ; 25.8 ;5;7;226;0;5;0;5;4;1;2;1;2
1800; 28.8 ; 143.9 ; 6.5 ;5;49;37;4;1;1;4;3;2;3;2;0
1801; 44.8 ; 134.4 ; 14.6 ;3;106;29;0;3;2;1;1;2;0;2;1
1802; 47.2 ; 141.7 ; 0.4 ;3;28;86;0;3;3;0;2;1;0;3;0
1803; 50.3 ; 150.8 ; 9.6 ;3;28;56;2;1;3;0;2;1;0;2;1
1804; 54.3 ; 108.6 ; 1.6 ;2;183;100;0;2;0;2;2;0;0;1;1
1805; 47.5 ; 94.9 ; 1.1 ;2;301;22;0;2;0;2;1;1;0;2;0
1806; 38.8 ; 77.7 ; 12.9 ;2;166;62;1;1;1;1;2;0;1;1;0
1807; 18.4 ; 147.4 ; 10.9 ;8;20;14;8;0;6;2;5;3;8;0;0
1808; 36.6 ; 146.4 ; -   ;4;12;2;0;4;3;1;4;0;0;4;0
1809; 45.2 ; 90.3 ; 2.4 ;2;9;97;0;2;1;1;1;1;0;2;0
1810; 37.7 ; 150.9 ; 16.0 ;4;63;26;0;4;0;4;4;0;1;3;0
1811; 30.9 ; 61.7 ; 23.8 ;2;149;89;0;2;1;1;0;2;1;1;0
1812; 83.1 ; 249.3 ; 2.4 ;3;48;93;0;3;2;1;1;2;0;0;3
1813; 33.1 ; 496.7 ; 14.9 ;15;10;119;0;15;2;13;13;2;5;10;0
1814; 48.6 ; 145.8 ; 30.8 ;3;31;199;2;1;1;2;2;1;1;1;1
1815; 22.0 ; 132.2 ; 1.4 ;6;23;108;1;5;5;1;6;0;6;0;0
1816; 47.0 ; 234.9 ; 1.0 ;5;41;94;0;5;0;5;5;0;0;5;0
1817; 43.5 ; 478.6 ; 9.9 ;11;39;23;0;11;2;9;6;5;0;11;0
1818; 34.3 ; 68.6 ; -   ;2;3;269;0;2;1;1;2;0;0;2;0
1819; 32.3 ; 96.9 ; 13.3 ;3;29;258;0;3;1;2;0;3;1;2;0
1820; 38.5 ; 76.9 ; 12.4 ;2;149;106;1;1;0;2;0;2;1;1;0
1821; 48.1 ; 192.3 ; 38.8 ;4;3;111;0;4;2;2;1;3;1;2;1
1822; 36.6 ; 402.6 ; 10.4 ;11;11;3;0;11;4;7;5;6;4;7;0
1823; 17.2 ; 68.9 ; 2.7 ;4;27;223;0;4;2;2;4;0;4;0;0
1824; 63.2 ; 316.1 ; 21.9 ;5;39;99;0;5;0;5;4;1;0;0;5
1825; 61.0 ; 122.1 ; 16.1 ;2;190;56;0;2;1;1;1;1;0;0;2
1826; 57.0 ; 342.1 ; 12.9 ;6;47;45;0;6;2;4;2;4;0;0;6
1827; 18.3 ; 55.0 ; 6.2 ;3;97;26;0;3;0;3;1;2;3;0;0
1828; 24.0 ; 95.9 ; 19.1 ;4;70;36;0;4;1;3;2;2;3;1;0
1829; 38.5 ; 76.9 ; 12.4 ;2;130;88;1;1;2;0;0;2;1;1;0
1830; 31.5 ; 63.0 ; 8.5 ;2;113;60;0;2;2;0;2;0;1;1;0
1831; 31.9 ; 63.8 ; 3.8 ;2;9;296;0;2;1;1;2;0;1;1;0
1832; 23.5 ; 47.0 ; 0.6 ;2;102;189;0;2;0;2;1;1;2;0;0
1833; 55.3 ; 166.0 ; 15.1 ;3;108;68;0;3;1;2;0;3;0;0;3
1834; 54.3 ; 108.6 ; 2.6 ;2;63;83;2;0;0;2;2;0;0;1;1
1835; 25.1 ; 75.2 ; -   ;3;11;260;0;3;3;0;1;2;3;0;0
1836; 53.9 ; 161.6 ; 11.8 ;3;32;49;3;0;3;0;3;0;0;2;1
1837; 34.1 ; 102.4 ; 17.9 ;3;52;104;1;2;1;2;1;2;1;2;0
1838; 50.9 ; 203.5 ; 3.1 ;4;15;296;0;4;3;1;2;2;0;4;0
1839; 54.5 ; 163.6 ; 32.9 ;3;164;110;0;3;1;2;1;2;1;1;1
1840; 45.8 ; 183.3 ; 8.0 ;4;50;242;0;4;3;1;2;2;0;4;0
1841; 26.6 ; 372.2 ; 6.7 ;14;4;1;0;14;7;7;2;12;9;5;0
1842; 42.8 ; 214.0 ; 42.2 ;5;6;68;0;5;1;4;2;3;2;1;2
1843; 15.0 ; 45.0 ; -   ;3;27;9;0;3;1;2;3;0;3;0;0
1844; 103.2 ; 412.8 ; 40.2 ;4;3;245;0;4;1;3;2;2;0;0;4
1845; 53.0 ; 371.2 ; 44.9 ;7;54;5;0;7;0;7;3;4;2;3;2
1846; 22.5 ; 315.5 ; 7.4 ;14;13;2;0;14;7;7;6;8;14;0;0
1847; 37.3 ; 112.0 ; 10.4 ;3;128;83;0;3;1;2;1;2;1;2;0
1848; 61.6 ; 123.2 ; 0.2 ;2;76;335;0;2;1;1;2;0;0;0;2
1849; 53.9 ; 754.1 ; 27.2 ;14;26;5;0;14;0;14;7;7;5;4;5
1850; 42.0 ; 125.9 ; 16.0 ;3;41;206;0;3;2;1;1;2;1;1;1
1851; 31.8 ; 158.9 ; 14.0 ;5;47;179;0;5;1;4;3;2;2;3;0
1852; 44.1 ; 88.2 ; 32.4 ;2;10;196;0;2;1;1;0;2;1;0;1
1853; 130.9 ; 523.7 ; 31.9 ;4;16;15;0;4;0;4;4;0;0;0;4
1854; 52.7 ; 368.8 ; 0.4 ;7;14;68;0;7;2;5;1;6;0;7;0
1855; 51.8 ; 103.5 ; 1.1 ;2;132;188;0;2;0;2;1;1;0;2;0
1856; 40.1 ; 80.1 ; -   ;2;144;136;0;2;0;2;1;1;0;2;0
1857; 28.1 ; 140.3 ; 11.0 ;5;43;54;0;5;1;4;2;3;3;2;0
1858; 47.4 ; 142.2 ; 1.2 ;3;72;120;0;3;0;3;2;1;0;3;0
1859; 20.1 ; 60.2 ; 9.3 ;3;41;68;0;3;2;1;1;2;3;0;0
1860; 24.4 ; 146.2 ; 4.8 ;6;31;0;0;6;2;4;1;5;6;0;0
1861; 39.5 ; 78.9 ; 3.3 ;2;72;138;1;1;2;0;2;0;0;2;0
1862; 46.9 ; 234.5 ; 0.3 ;5;57;73;0;5;0;5;5;0;0;5;0
1863; 41.4 ; 165.4 ; 6.8 ;4;96;5;0;4;0;4;2;2;0;4;0
1864; 28.4 ; 199.1 ; 13.5 ;7;27;12;0;7;3;4;6;1;5;2;0
1865; 81.3 ; 406.3 ; 96.7 ;5;42;182;0;5;3;2;0;5;2;0;3
1866; 15.0 ; 45.0 ; -   ;3;119;77;2;1;3;0;1;2;3;0;0
1867; 47.5 ; 1,186.6 ; 6.4 ;25;10;6;0;25;17;8;3;22;0;25;0
1868; 45.1 ; 225.7 ; 16.9 ;5;36;68;0;5;0;5;2;3;2;1;2
1869; 37.9 ; 113.7 ; 1.3 ;3;22;63;0;3;1;2;3;0;0;3;0
1870; 17.1 ; 136.8 ; 4.5 ;8;47;88;0;8;1;7;4;4;8;0;0
1871; 25.2 ; 252.2 ; 11.9 ;10;16;47;0;10;6;4;9;1;7;3;0
1872; 25.9 ; 155.4 ; 21.2 ;6;48;51;0;6;5;1;6;0;4;2;0
1873; 23.3 ; 209.5 ; 11.2 ;9;32;38;0;9;5;4;3;6;6;3;0
1874; 27.2 ; 869.6 ; 10.9 ;32;9;5;0;32;22;10;16;16;21;11;0
1875; 41.4 ; 82.7 ; 16.7 ;2;4;347;0;2;1;1;0;2;1;0;1
1876; 126.7 ; 633.4 ; 22.4 ;5;34;59;2;3;0;5;5;0;0;0;5
1877; 38.2 ; 267.5 ; 25.5 ;7;36;51;0;7;4;3;3;4;2;3;2
1878; 61.4 ; 983.0 ; 28.7 ;16;13;8;16;0;15;1;2;14;0;0;16
1879; 66.2 ; 132.5 ; 29.2 ;2;90;239;0;2;2;0;1;1;0;0;2
1880; 30.3 ; 60.5 ; 14.7 ;2;248;49;0;2;1;1;2;0;1;1;0
1881; 30.4 ; 455.4 ; 11.5 ;15;26;31;0;15;0;15;8;7;5;10;0
1882; 15.0 ; 30.0 ; -   ;2;41;157;0;2;1;1;1;1;2;0;0
1883; 15.0 ; 195.4 ; 0.2 ;13;19;68;0;13;5;8;10;3;13;0;0
1884; 30.2 ; 60.4 ; -   ;2;221;83;0;2;0;2;2;0;0;2;0
1885; 31.5 ; 157.3 ; 10.5 ;5;40;32;5;0;1;4;4;1;2;3;0
1886; 39.1 ; 156.5 ; 12.2 ;4;29;32;0;4;1;3;2;2;1;3;0
1887; 81.7 ; 653.3 ; 29.7 ;8;34;0;0;8;1;7;4;4;0;0;8
1888; 15.0 ; 45.0 ; -   ;3;30;40;3;0;1;2;2;1;3;0;0
1889; 24.7 ; 49.5 ; 8.1 ;2;1;51;0;2;1;1;1;1;1;1;0
1890; 25.3 ; 202.8 ; 16.8 ;8;44;19;0;8;1;7;6;2;5;3;0
1891; 17.3 ; 34.7 ; 3.5 ;2;24;240;0;2;2;0;2;0;2;0;0
1892; 59.3 ; 118.6 ; 18.8 ;2;67;296;0;2;1;1;2;0;0;0;2
1893; 52.4 ; 157.1 ; 19.0 ;3;86;26;0;3;1;2;1;2;0;2;1
1894; 38.2 ; 76.4 ; 28.3 ;2;1;265;0;2;2;0;1;1;1;0;1
1895; 40.9 ; 81.8 ; 16.2 ;2;50;65;0;2;1;1;1;1;1;0;1
1896; 92.0 ; 276.1 ; 43.7 ;3;73;23;0;3;3;0;1;2;0;0;3
1897; 53.7 ; 161.1 ; 29.8 ;3;43;179;0;3;1;2;1;2;1;1;1
1898; 20.8 ; 41.6 ; 6.4 ;2;3;71;2;0;1;1;1;1;2;0;0
1899; 46.2 ; 92.4 ; 14.4 ;2;98;127;0;2;0;2;2;0;0;1;1
1900; 41.3 ; 165.4 ; 8.0 ;4;35;238;0;4;4;0;1;3;0;4;0
1901; 20.5 ; 102.5 ; 2.4 ;5;23;41;0;5;1;4;4;1;5;0;0
1902; 19.4 ; 77.5 ; 5.4 ;4;105;152;0;4;1;3;2;2;4;0;0
1903; 24.8 ; 74.3 ; 11.4 ;3;25;20;3;0;3;0;3;0;2;1;0
1904; 33.2 ; 165.8 ; 8.8 ;5;35;146;0;5;4;1;1;4;2;3;0
1905; 92.3 ; 461.5 ; 47.1 ;5;34;26;0;5;0;5;5;0;0;0;5
1906; 30.5 ; 244.4 ; 29.9 ;8;45;23;0;8;4;4;6;2;3;2;3
1907; 31.0 ; 62.0 ; 1.2 ;2;29;92;2;0;1;1;0;2;1;1;0
1908; 22.2 ; 133.2 ; 11.7 ;6;41;129;0;6;5;1;3;3;4;2;0
1909; 33.2 ; 66.4 ; 20.3 ;2;190;126;0;2;1;1;1;1;1;1;0
1910; 50.3 ; 150.8 ; 8.3 ;3;50;131;0;3;1;2;3;0;0;2;1
1911; 43.3 ; 433.4 ; 12.0 ;10;31;5;0;10;0;10;9;1;0;7;3
1912; 62.3 ; 187.0 ; 20.4 ;3;49;75;0;3;2;1;0;3;0;0;3
1913; 54.9 ; 109.8 ; 27.4 ;2;11;52;0;2;1;1;1;1;1;0;1
1914; 40.6 ; 202.9 ; 16.5 ;5;68;5;0;5;1;4;4;1;2;1;2
1915; 26.3 ; 131.3 ; 12.4 ;5;66;10;0;5;1;4;4;1;3;2;0
1916; 56.7 ; 170.2 ; 9.2 ;3;49;183;0;3;1;2;1;2;0;0;3
1917; 36.7 ; 330.6 ; 25.2 ;9;29;48;0;9;0;9;9;0;3;3;3
1918; 39.8 ; 79.5 ; 14.7 ;2;14;162;0;2;0;2;2;0;1;1;0
1919; 53.9 ; 107.9 ; -   ;2;4;17;0;2;1;1;1;1;0;2;0
1920; 29.6 ; 414.5 ; 13.2 ;14;11;231;0;14;8;6;6;8;9;5;0
1921; 118.7 ; 237.4 ; 35.5 ;2;14;88;0;2;1;1;1;1;0;0;2
1922; 25.9 ; 284.7 ; 10.5 ;11;42;2;0;11;11;0;11;0;7;4;0
1923; 27.4 ; 575.5 ; 11.8 ;21;14;9;0;21;7;14;15;6;14;7;0
1924; 78.8 ; 315.1 ; 32.1 ;4;14;137;0;4;1;3;1;3;0;0;4
1925; 46.7 ; 140.1 ; 10.7 ;3;38;213;0;3;1;2;3;0;0;2;1
1926; 77.6 ; 310.6 ; 21.5 ;4;70;50;0;4;1;3;4;0;0;0;4
1927; 23.3 ; 186.2 ; 14.0 ;8;38;137;0;8;2;6;4;4;5;3;0
1928; 21.2 ; 1,693.2 ; 9.8 ;80;5;8;0;80;31;49;30;50;53;27;0
1929; 63.7 ; 381.9 ; 58.7 ;6;32;37;6;0;1;5;3;3;2;0;4
1930; 44.5 ; 89.0 ; 18.3 ;2;18;86;0;2;2;0;1;1;1;0;1
1931; 61.8 ; 247.3 ; 19.7 ;4;46;158;0;4;0;4;4;0;0;0;4
1932; 20.4 ; 469.8 ; 7.9 ;23;9;5;0;23;12;11;6;17;23;0;0
1933; 22.5 ; 44.9 ; 11.2 ;2;294;5;0;2;1;1;1;1;1;1;0
1934; 20.2 ; 60.6 ; 4.5 ;3;22;237;0;3;0;3;2;1;3;0;0
1935; 28.5 ; 85.5 ; 22.1 ;3;14;152;3;0;0;3;3;0;2;1;0
1936; 24.6 ; 344.4 ; 25.6 ;14;32;14;0;14;10;4;10;4;9;5;0
1937; 15.0 ; 30.0 ; -   ;2;325;23;0;2;1;1;1;1;2;0;0
1938; 57.6 ; 115.2 ; 51.0 ;2;1;15;2;0;0;2;2;0;1;0;1
1939; 60.7 ; 243.0 ; 27.0 ;4;121;1;0;4;2;2;1;3;0;0;4
1940; 48.1 ; 96.2 ; 0.9 ;2;56;32;0;2;0;2;0;2;0;2;0
1941; 56.2 ; 224.7 ; 30.4 ;4;4;231;0;4;0;4;3;1;1;0;3
1942; 28.2 ; 112.8 ; 15.2 ;4;56;80;0;4;1;3;3;1;3;1;0
1943; 52.7 ; 579.7 ; 7.9 ;11;26;5;0;11;0;11;10;1;0;7;4
1944; 55.9 ; 167.7 ; 6.5 ;3;32;79;0;3;0;3;1;2;0;0;3
1945; 62.8 ; 125.7 ; 25.8 ;2;18;173;0;2;0;2;2;0;0;0;2
1946; 30.6 ; 91.7 ; 16.8 ;3;37;173;0;3;0;3;1;2;1;2;0
1947; 44.5 ; 756.3 ; 19.2 ;17;15;40;0;17;5;12;5;12;6;5;6
1948; 49.2 ; 98.3 ; 36.1 ;2;321;20;0;2;0;2;0;2;1;0;1
1949; 21.7 ; 303.6 ; 6.8 ;14;30;21;0;14;0;14;11;3;14;0;0
1950; 30.8 ; 61.7 ; 8.6 ;2;208;199;0;2;0;2;1;1;1;1;0
1951; 20.0 ; 40.1 ; 7.6 ;2;23;338;0;2;1;1;1;1;2;0;0
1952; 47.5 ; 142.4 ; -   ;3;28;26;0;3;0;3;1;2;0;3;0
1953; 39.2 ; 313.8 ; 33.7 ;8;40;3;0;8;3;5;7;1;3;2;3
1954; 105.5 ; 422.0 ; 103.7 ;4;71;79;0;4;1;3;2;2;1;0;3
1955; 60.3 ; 181.0 ; 13.4 ;3;80;52;0;3;2;1;0;3;0;0;3
1956; 28.1 ; 140.6 ; 11.2 ;5;55;63;0;5;2;3;4;1;3;2;0
1957; 16.0 ; 48.0 ; 1.9 ;3;99;47;0;3;1;2;2;1;3;0;0
1958; 18.3 ; 55.0 ; 6.2 ;3;5;26;0;3;2;1;1;2;3;0;0
1959; 91.8 ; 275.5 ; 83.8 ;3;59;79;0;3;0;3;2;1;1;0;2
1960; 20.8 ; 104.2 ; 15.2 ;5;5;2;5;0;1;4;5;0;3;2;0
1961; 35.0 ; 70.1 ; 4.6 ;2;10;241;0;2;1;1;1;1;0;2;0
1962; 48.9 ; 97.8 ; 3.2 ;2;31;289;0;2;0;2;1;1;0;2;0
1963; 20.0 ; 59.9 ; 9.2 ;3;82;137;0;3;1;2;3;0;3;0;0
1964; 22.9 ; 45.9 ; 10.8 ;2;1;78;2;0;0;2;2;0;1;1;0
1965; 76.0 ; 228.0 ; 27.2 ;3;36;341;0;3;1;2;0;3;0;0;3
1966; 44.1 ; 176.3 ; 2.0 ;4;86;4;0;4;3;1;2;2;0;4;0
1967; 15.0 ; 30.0 ; -   ;2;43;210;0;2;0;2;1;1;2;0;0
1968; 65.6 ; 590.2 ; 27.8 ;9;41;0;0;9;1;8;4;5;0;0;9
1969; 34.4 ; 172.0 ; 13.6 ;5;13;47;0;5;2;3;2;3;2;3;0
1970; 37.6 ; 112.7 ; 16.8 ;3;72;194;0;3;2;1;2;1;1;2;0
1971; 78.4 ; 235.1 ; 27.8 ;3;14;147;0;3;1;2;3;0;0;0;3
1972; 65.1 ; 130.1 ; 18.8 ;2;15;255;0;2;1;1;2;0;0;0;2
1973; 18.8 ; 94.0 ; 0.2 ;5;10;230;0;5;2;3;1;4;5;0;0
1974; 15.0 ; 45.0 ; -   ;3;54;43;0;3;2;1;3;0;3;0;0
1975; 50.4 ; 201.7 ; 10.9 ;4;27;86;0;4;2;2;3;1;0;3;1
1976; 50.4 ; 453.2 ; 6.4 ;9;26;47;0;9;3;6;8;1;0;6;3
1977; 81.2 ; 243.7 ; 15.3 ;3;182;20;1;2;0;3;2;1;0;0;3
1978; 45.2 ; 90.3 ; 2.4 ;2;113;31;1;1;0;2;2;0;0;2;0
1979; 58.4 ; 233.8 ; 24.8 ;4;29;195;0;4;1;3;1;3;0;0;4
1980; 25.8 ; 77.4 ; 19.9 ;3;18;59;0;3;0;3;3;0;2;1;0
1981; 19.5 ; 39.0 ; 0.3 ;2;26;287;0;2;1;1;2;0;2;0;0
1982; 41.9 ; 125.6 ; 10.7 ;3;72;109;0;3;2;1;1;2;0;3;0
1983; 45.1 ; 135.2 ; 21.9 ;3;113;35;0;3;1;2;1;2;1;1;1
1984; 29.9 ; 149.4 ; 18.7 ;5;50;68;0;5;2;3;3;2;3;2;0
1985; 16.2 ; 178.0 ; 0.6 ;11;5;5;0;11;6;5;9;2;11;0;0
1986; 46.8 ; 93.5 ; -   ;2;103;257;0;2;0;2;2;0;0;2;0
1987; 53.5 ; 107.0 ; 5.9 ;2;37;231;0;2;0;2;2;0;0;1;1
1988; 19.2 ; 134.4 ; 12.6 ;7;23;206;0;7;6;1;7;0;5;2;0
1989; 85.8 ; 171.6 ; 29.9 ;2;43;188;0;2;0;2;2;0;0;0;2
1990; 48.6 ; 145.7 ; 7.2 ;3;12;248;0;3;1;2;2;1;0;2;1
1991; 70.1 ; 140.3 ; 40.8 ;2;100;86;2;0;2;0;1;1;1;0;1
1992; 22.6 ; 45.2 ; 11.4 ;2;121;120;0;2;0;2;1;1;1;1;0
1993; 32.6 ; 163.1 ; 15.5 ;5;14;304;0;5;2;3;3;2;2;3;0
1994; 59.0 ; 235.9 ; 13.1 ;4;113;63;0;4;0;4;2;2;0;0;4
1995; 16.5 ; 33.0 ; 2.3 ;2;37;32;0;2;0;2;0;2;2;0;0
1996; 37.5 ; 112.5 ; 20.7 ;3;121;15;3;0;0;3;3;0;1;1;1
1997; 41.2 ; 123.7 ; 10.1 ;3;55;296;0;3;1;2;2;1;0;3;0
1998; 26.6 ; 53.2 ; 17.4 ;2;90;166;0;2;1;1;2;0;1;1;0
1999; 19.9 ; 119.3 ; 7.4 ;6;50;21;0;6;1;5;2;4;6;0;0
2000; 37.9 ; 113.8 ; 19.1 ;3;25;98;3;0;1;2;2;1;1;1;1
2001; 52.1 ; 416.4 ; 11.9 ;8;43;98;0;8;2;6;1;7;0;5;3
2002; 52.3 ; 261.7 ; 7.7 ;5;38;4;0;5;1;4;3;2;0;3;2
2003; 50.6 ; 101.3 ; 4.8 ;2;121;59;0;2;1;1;2;0;0;1;1
2004; 89.6 ; 448.2 ; 17.2 ;5;24;131;0;5;1;4;1;4;0;0;5
2005; 50.0 ; 100.0 ; 3.8 ;2;140;99;1;1;0;2;2;0;0;2;0
2006; 80.5 ; 160.9 ; 28.0 ;2;12;40;0;2;2;0;2;0;0;0;2
2007; 30.5 ; 122.0 ; 11.4 ;4;48;149;0;4;3;1;4;0;1;3;0
2008; 18.4 ; 55.3 ; 3.9 ;3;85;114;0;3;2;1;1;2;3;0;0
2009; 67.9 ; 135.9 ; 31.7 ;2;19;110;0;2;0;2;2;0;0;0;2
2010; 36.6 ; 73.2 ; -   ;2;96;14;0;2;1;1;1;1;0;2;0
2011; 17.0 ; 51.1 ; 3.7 ;3;23;283;0;3;1;2;1;2;3;0;0
2012; 38.0 ; 75.9 ; 14.2 ;2;76;62;1;1;0;2;0;2;1;1;0
2013; 33.7 ; 236.2 ; 7.9 ;7;14;284;0;7;4;3;5;2;2;5;0
2014; 22.6 ; 45.2 ; 11.4 ;2;1;246;0;2;0;2;2;0;1;1;0
2015; 57.2 ; 1,257.9 ; 11.6 ;22;15;5;0;22;3;19;20;2;0;0;22
2016; 36.0 ; 468.5 ; 16.2 ;13;20;0;0;13;1;12;10;3;4;9;0
2017; 59.3 ; 118.6 ; 18.8 ;2;122;160;0;2;1;1;1;1;0;0;2
2018; 27.6 ; 55.3 ; 3.8 ;2;254;165;0;2;1;1;0;2;1;1;0
2019; 21.0 ; 83.8 ; 6.7 ;4;71;163;0;4;0;4;3;1;4;0;0
2020; 30.8 ; 215.8 ; 6.5 ;7;23;104;0;7;0;7;4;3;2;5;0
2021; 63.2 ; 126.5 ; 4.3 ;2;106;250;0;2;2;0;1;1;0;0;2
2022; 40.9 ; 122.8 ; 18.5 ;3;21;264;0;3;1;2;3;0;1;1;1
2023; 73.2 ; 146.4 ; 54.8 ;2;5;5;0;2;1;1;2;0;1;0;1
2024; 20.9 ; 104.5 ; 9.3 ;5;21;152;0;5;0;5;1;4;3;2;0
2025; 15.0 ; 30.0 ; -   ;2;7;201;0;2;2;0;1;1;2;0;0
2026; 21.1 ; 232.3 ; 11.1 ;11;24;14;0;11;8;3;8;3;7;4;0
2027; 33.7 ; 842.6 ; 16.3 ;25;6;56;0;25;8;17;9;16;8;17;0
2028; 35.9 ; 107.6 ; 20.5 ;3;187;6;1;2;0;3;2;1;1;1;1
2029; 25.6 ; 127.8 ; 7.5 ;5;39;51;0;5;3;2;2;3;3;2;0
2030; 46.3 ; 741.1 ; 15.2 ;16;14;23;0;16;7;9;8;8;0;11;5
2031; 36.6 ; 73.2 ; -   ;2;25;185;0;2;0;2;0;2;0;2;0
2032; 47.7 ; 143.1 ; 1.7 ;3;13;226;0;3;0;3;1;2;0;3;0
2033; 44.8 ; 89.6 ; 2.9 ;2;91;273;0;2;1;1;1;1;0;2;0
2034; 31.5 ; 126.0 ; 16.2 ;4;22;41;0;4;2;2;2;2;1;3;0
2035; 26.4 ; 79.3 ; 1.6 ;3;128;102;0;3;2;1;1;2;3;0;0
2036; 51.2 ; 409.8 ; 20.6 ;8;23;58;0;8;3;5;6;2;0;5;3
2037; 32.0 ; 639.7 ; 9.1 ;20;16;10;0;20;3;17;13;7;7;13;0
2038; 88.9 ; 266.6 ; 67.3 ;3;41;15;0;3;0;3;2;1;1;0;2
2039; 33.6 ; 168.0 ; 10.0 ;5;38;89;2;3;2;3;2;3;2;3;0
2040; 29.6 ; 88.9 ; 6.4 ;3;7;250;0;3;2;1;1;2;2;1;0
2041; 25.0 ; 125.0 ; 8.7 ;5;64;17;0;5;2;3;3;2;3;2;0
2042; 26.2 ; 288.2 ; 19.2 ;11;13;74;0;11;7;4;7;4;7;4;0
2043; 42.1 ; 126.4 ; 11.0 ;3;33;65;0;3;2;1;1;2;0;3;0
2044; 51.9 ; 830.4 ; 19.2 ;16;25;5;0;16;3;13;9;7;0;11;5
2045; 47.8 ; 191.0 ; 1.2 ;4;67;26;0;4;0;4;1;3;0;4;0
2046; 84.0 ; 168.1 ; 48.6 ;2;52;221;0;2;1;1;0;2;0;0;2
2047; 56.3 ; 112.5 ; 29.4 ;2;31;52;0;2;0;2;2;0;1;0;1
2048; 15.0 ; 30.0 ; -   ;2;23;236;0;2;1;1;2;0;2;0;0
2049; 38.3 ; 76.7 ; 19.8 ;2;5;269;0;2;2;0;1;1;1;0;1
2050; 49.3 ; 98.7 ; 43.9 ;2;54;217;0;2;1;1;1;1;1;0;1
2051; 47.6 ; 95.2 ; 4.3 ;2;17;263;0;2;0;2;0;2;0;2;0
2052; 38.8 ; 77.7 ; 12.9 ;2;32;26;2;0;0;2;2;0;1;1;0
2053; 57.2 ; 400.6 ; 25.8 ;7;14;97;1;6;0;7;5;2;0;0;7
2054; 54.6 ; 163.8 ; 16.1 ;3;54;184;0;3;0;3;3;0;0;2;1
2055; 36.6 ; 73.2 ; -   ;2;19;178;0;2;0;2;2;0;0;2;0
2056; 40.2 ; 80.4 ; 22.7 ;2;81;162;0;2;0;2;1;1;1;0;1
2057; 21.7 ; 65.1 ; 6.2 ;3;2;259;0;3;2;1;3;0;3;0;0
2058; 33.7 ; 168.4 ; 16.7 ;5;50;103;0;5;2;3;1;4;2;3;0
2059; 47.1 ; 94.2 ; 0.5 ;2;145;26;0;2;0;2;2;0;0;2;0
2060; 21.7 ; 65.1 ; 6.2 ;3;23;109;3;0;1;2;1;2;3;0;0
2061; 21.3 ; 85.1 ; 3.2 ;4;70;35;0;4;1;3;3;1;4;0;0
2062; 48.8 ; 146.4 ; 22.4 ;3;7;151;0;3;1;2;3;0;1;1;1
2063; 37.9 ; 379.1 ; 22.0 ;10;34;5;1;9;2;8;8;2;3;4;3
2064; 31.5 ; 315.2 ; 17.2 ;10;29;22;0;10;7;3;10;0;3;7;0
2065; 27.4 ; 356.7 ; 17.7 ;13;14;85;0;13;4;9;6;7;9;4;0
2066; 51.7 ; 103.4 ; 15.0 ;2;12;15;0;2;0;2;1;1;0;1;1
2067; 15.0 ; 30.0 ; -   ;2;132;162;0;2;0;2;1;1;2;0;0
2068; 20.7 ; 62.1 ; 5.3 ;3;7;92;0;3;2;1;2;1;3;0;0
2069; 15.0 ; 74.9 ; -   ;5;33;146;0;5;1;4;3;2;5;0;0
2070; 25.6 ; 76.7 ; 11.4 ;3;95;10;0;3;0;3;2;1;2;1;0
2071; 47.7 ; 95.5 ; 1.5 ;2;7;258;0;2;1;1;2;0;0;2;0
2072; 32.5 ; 129.8 ; 5.8 ;4;35;5;0;4;2;2;1;3;1;3;0
2073; 18.9 ; 169.8 ; 10.8 ;9;33;6;0;9;4;5;3;6;9;0;0
2074; 65.3 ; 1,370.3 ; 21.3 ;21;14;47;0;21;0;21;18;3;0;0;21
2075; 65.2 ; 130.3 ; 4.8 ;2;283;99;0;2;0;2;0;2;0;0;2
2076; 15.0 ; 45.0 ; -   ;3;41;1;2;1;0;3;1;2;3;0;0
2077; 35.4 ; 177.0 ; 14.8 ;5;24;289;0;5;1;4;2;3;2;3;0
2078; 15.0 ; 30.0 ; -   ;2;4;272;0;2;1;1;1;1;2;0;0
2079; 35.4 ; 141.5 ; 16.8 ;4;8;87;0;4;2;2;1;3;1;3;0
2080; 47.1 ; 235.3 ; 0.8 ;5;13;206;0;5;4;1;3;2;0;5;0
2081; 26.4 ; 423.1 ; 21.4 ;16;10;22;0;16;9;7;6;10;11;5;0
2082; 38.5 ; 76.9 ; 12.4 ;2;76;121;0;2;0;2;0;2;1;1;0
2083; 28.1 ; 56.3 ; 19.7 ;2;50;53;0;2;0;2;1;1;1;1;0
2084; 22.6 ; 362.0 ; 7.8 ;16;3;180;0;16;11;5;2;14;11;5;0
2085; 39.3 ; 78.7 ; -   ;2;4;296;0;2;1;1;2;0;0;2;0
2086; 23.0 ; 322.0 ; 12.3 ;14;22;11;4;10;0;14;10;4;9;5;0
2087; 72.3 ; 144.6 ; 36.1 ;2;21;5;0;2;0;2;1;1;0;0;2
2088; 68.8 ; 344.2 ; 15.9 ;5;43;2;0;5;1;4;3;2;0;0;5
2089; 50.6 ; 101.2 ; 31.9 ;2;4;38;0;2;0;2;2;0;1;0;1
2090; 16.7 ; 67.0 ; 1.8 ;4;2;175;0;4;3;1;3;1;4;0;0
2091; 43.3 ; 606.7 ; 20.3 ;14;17;20;0;14;6;8;4;10;5;4;5
2092; 70.7 ; 212.1 ; 24.8 ;3;22;136;1;2;0;3;3;0;0;0;3
2093; 38.5 ; 76.9 ; 12.4 ;2;65;132;0;2;1;1;0;2;1;1;0
2094; 17.7 ; 564.9 ; 5.7 ;32;7;7;0;32;14;18;17;15;32;0;0
2095; 93.3 ; 186.6 ; 4.1 ;2;1;247;0;2;0;2;1;1;0;0;2
2096; 73.0 ; 584.3 ; 24.6 ;8;36;21;0;8;3;5;2;6;0;0;8
2097; 38.5 ; 76.9 ; 12.4 ;2;17;188;0;2;1;1;1;1;1;1;0
2098; 36.5 ; 438.2 ; 16.9 ;12;22;0;0;12;1;11;10;2;4;8;0
2099; 23.6 ; 732.8 ; 6.6 ;31;7;90;0;31;20;11;23;8;21;10;0
2100; 18.6 ; 148.8 ; 11.5 ;8;17;0;0;8;1;7;7;1;5;3;0
2101; 34.0 ; 102.0 ; 12.0 ;3;5;270;0;3;1;2;0;3;1;2;0
2102; 43.4 ; 86.7 ; 0.8 ;2;191;10;0;2;1;1;1;1;0;2;0
2103; 29.8 ; 386.9 ; 15.4 ;13;24;8;0;13;13;0;3;10;9;4;0
2104; 28.1 ; 56.3 ; 19.7 ;2;93;55;0;2;2;0;0;2;1;1;0
2105; 40.6 ; 81.1 ; 17.9 ;2;12;262;0;2;0;2;2;0;1;0;1
2106; 21.1 ; 42.2 ; 5.9 ;2;16;284;0;2;1;1;0;2;2;0;0
2107; 39.7 ; 159.0 ; 25.4 ;4;41;60;0;4;3;1;2;2;1;2;1
2108; 33.4 ; 66.8 ; 4.8 ;2;14;128;0;2;2;0;0;2;1;1;0
2109; 22.7 ; 432.0 ; 17.4 ;19;16;42;0;19;7;12;12;7;13;6;0
2110; 35.0 ; 70.0 ; 30.0 ;2;12;300;0;2;0;2;0;2;1;0;1
2111; 32.1 ; 64.2 ; 19.2 ;2;14;94;0;2;0;2;2;0;1;1;0
2112; 53.6 ; 214.3 ; 7.1 ;4;33;96;0;4;3;1;1;3;0;3;1
2113; 30.8 ; 954.4 ; 10.6 ;31;13;8;0;31;17;14;4;27;10;21;0
2114; 43.9 ; 307.4 ; 19.1 ;7;38;53;0;7;3;4;1;6;2;3;2
2115; 22.8 ; 91.4 ; 5.6 ;4;13;50;0;4;3;1;2;2;4;0;0
2116; 70.4 ; 211.1 ; 12.0 ;3;4;247;0;3;1;2;1;2;0;0;3
2117; 15.8 ; 78.8 ; 2.0 ;5;22;169;0;5;2;3;1;4;5;0;0
2118; 16.0 ; 80.0 ; 2.4 ;5;43;41;1;4;3;2;1;4;5;0;0
2119; 71.5 ; 214.4 ; 26.2 ;3;70;104;0;3;2;1;1;2;0;0;3
2120; 31.2 ; 343.6 ; 17.7 ;11;13;7;0;11;7;4;11;0;4;7;0
2121; 46.8 ; 93.5 ; -   ;2;14;315;0;2;1;1;0;2;0;2;0
2122; 95.9 ; 287.8 ; 19.6 ;3;13;78;3;0;0;3;2;1;0;0;3
2123; 45.2 ; 90.3 ; -   ;2;1;94;2;0;0;2;0;2;0;2;0
2124; 49.0 ; 98.0 ; 19.2 ;2;90;87;0;2;1;1;0;2;1;0;1
2125; 23.5 ; 211.9 ; 7.9 ;9;41;6;0;9;0;9;2;7;6;3;0
2126; 22.3 ; 44.5 ; 4.2 ;2;3;265;0;2;1;1;0;2;2;0;0
2127; 63.4 ; 190.2 ; 37.3 ;3;40;101;0;3;2;1;3;0;1;0;2
2128; 72.4 ; 506.9 ; 17.3 ;7;33;77;0;7;7;0;7;0;0;0;7
2129; 63.0 ; 756.3 ; 18.6 ;12;15;23;0;12;5;7;11;1;0;0;12
2130; 15.0 ; 30.0 ; -   ;2;181;113;0;2;1;1;1;1;2;0;0
2131; 23.5 ; 399.1 ; 8.3 ;17;16;22;0;17;8;9;6;11;11;6;0
2132; 50.6 ; 151.8 ; 3.5 ;3;25;236;0;3;0;3;3;0;0;3;0
2133; 43.9 ; 1,186.1 ; 18.7 ;27;16;6;0;27;0;27;21;6;9;9;9
2134; 18.1 ; 54.3 ; 2.9 ;3;18;293;0;3;3;0;1;2;3;0;0
2135; 15.0 ; 59.9 ; -   ;4;20;324;0;4;2;2;4;0;4;0;0
2136; 29.0 ; 290.2 ; 13.9 ;10;22;8;10;0;6;4;9;1;7;3;0
2137; 25.1 ; 200.5 ; -   ;8;16;5;0;8;2;6;4;4;8;0;0
2138; 32.3 ; 354.8 ; 10.5 ;11;9;217;0;11;3;8;9;2;4;7;0
2139; 28.3 ; 84.8 ; 17.6 ;3;132;86;0;3;2;1;1;2;2;1;0
2140; 90.1 ; 270.4 ; 59.1 ;3;32;163;0;3;2;1;1;2;0;0;3
2141; 28.2 ; 169.3 ; 17.8 ;6;30;120;0;6;2;4;3;3;4;2;0
2142; 37.5 ; 225.1 ; 20.0 ;6;48;110;0;6;2;4;4;2;2;2;2
2143; 55.8 ; 167.5 ; 7.2 ;3;56;120;0;3;0;3;3;0;0;0;3
2144; 45.7 ; 777.6 ; 12.0 ;17;14;32;0;17;2;15;6;11;0;11;6
2145; 36.8 ; 552.3 ; 35.9 ;15;8;20;1;14;1;14;13;2;5;5;5
2146; 47.2 ; 235.9 ; 19.7 ;5;11;110;0;5;1;4;4;1;2;1;2
2147; 48.6 ; 97.2 ; -   ;2;42;226;0;2;0;2;1;1;0;2;0
2148; 27.6 ; 385.8 ; 12.2 ;14;28;1;12;2;6;8;10;4;9;5;0
2149; 46.8 ; 93.5 ; -   ;2;147;200;0;2;1;1;1;1;0;2;0
2150; 19.5 ; 136.4 ; 13.5 ;7;25;200;0;7;0;7;2;5;5;2;0
2151; 38.5 ; 153.9 ; 10.1 ;4;67;74;0;4;1;3;2;2;1;3;0
2152; 24.9 ; 348.6 ; 8.6 ;14;21;8;0;14;0;14;8;6;9;5;0
2153; 36.6 ; 73.2 ; -   ;2;236;146;0;2;1;1;2;0;0;2;0
2154; 40.8 ; 285.5 ; 5.0 ;7;49;34;0;7;3;4;2;5;0;7;0
2155; 21.9 ; 109.3 ; 16.3 ;5;52;44;0;5;3;2;2;3;3;2;0
2156; 54.9 ; 109.8 ; 27.4 ;2;75;57;0;2;0;2;2;0;1;0;1
2157; 56.3 ; 506.8 ; 10.2 ;9;32;32;4;5;3;6;3;6;0;0;9
2158; 49.9 ; 99.8 ; 2.5 ;2;244;25;0;2;2;0;2;0;0;2;0
2159; 28.6 ; 142.9 ; 6.5 ;5;30;141;0;5;2;3;4;1;3;2;0
2160; 25.8 ; 180.5 ; 12.2 ;7;22;5;0;7;2;5;3;4;5;2;0
2161; 43.1 ; 86.2 ; 12.9 ;2;5;53;0;2;0;2;1;1;0;1;1
2162; 24.2 ; 386.6 ; 7.0 ;16;20;0;0;16;2;14;13;3;11;5;0
2163; 73.2 ; 146.4 ; -   ;2;138;104;0;2;0;2;1;1;0;0;2
2164; 35.3 ; 424.0 ; 30.6 ;12;32;5;0;12;2;10;9;3;4;4;4
2165; 41.9 ; 125.8 ; 10.8 ;3;91;0;1;2;0;3;3;0;0;3;0
2166; 43.6 ; 130.8 ; 6.4 ;3;131;63;0;3;0;3;2;1;0;3;0
2167; 51.7 ; 361.8 ; 6.4 ;7;47;0;0;7;0;7;7;0;0;5;2
2168; 77.7 ; 388.7 ; 25.6 ;5;80;6;1;4;0;5;1;4;0;0;5
2169; 30.2 ; 60.4 ; -   ;2;5;377;0;2;0;2;0;2;0;2;0
2170; 26.7 ; 133.3 ; 11.9 ;5;38;163;0;5;0;5;1;4;3;2;0
2171; 22.5 ; 134.9 ; 9.9 ;6;9;0;6;0;4;2;5;1;4;2;0
2172; 35.8 ; 286.6 ; 13.5 ;8;20;9;0;8;3;5;2;6;3;5;0
2173; 48.2 ; 144.6 ; -   ;3;2;4;3;0;1;2;3;0;0;3;0
2174; 41.0 ; 81.9 ; 9.8 ;2;14;57;0;2;0;2;0;2;0;2;0
2175; 34.3 ; 171.7 ; 15.0 ;5;59;21;0;5;3;2;3;2;2;3;0
2176; 39.7 ; 79.5 ; 4.7 ;2;18;335;0;2;0;2;2;0;0;2;0
2177; 25.5 ; 153.0 ; 1.2 ;6;17;44;0;6;5;1;2;4;6;0;0
2178; 19.3 ; 38.6 ; -   ;2;13;5;0;2;0;2;0;2;2;0;0
2179; 33.3 ; 466.5 ; 11.2 ;14;17;55;0;14;6;8;4;10;5;9;0
2180; 41.7 ; 166.9 ; 16.8 ;4;84;11;0;4;1;3;2;2;1;2;1
2181; 32.4 ; 194.7 ; 12.1 ;6;16;108;0;6;3;3;1;5;2;4;0
2182; 20.2 ; 80.8 ; 4.6 ;4;8;95;0;4;1;3;4;0;4;0;0
2183; 48.1 ; 96.1 ; 0.9 ;2;196;83;0;2;0;2;1;1;0;2;0
2184; 21.5 ; 128.7 ; 6.6 ;6;50;31;0;6;2;4;4;2;6;0;0
2185; 60.5 ; 846.9 ; 31.1 ;14;14;5;0;14;7;7;6;8;5;0;9
2186; 20.1 ; 221.5 ; 10.9 ;11;17;14;0;11;5;6;8;3;7;4;0
2187; 48.0 ; 95.9 ; 26.6 ;2;19;243;0;2;2;0;1;1;1;0;1
2188; 46.7 ; 233.5 ; 9.8 ;5;47;122;0;5;1;4;3;2;0;3;2
2189; 33.6 ; 67.3 ; 5.7 ;2;26;220;0;2;0;2;1;1;1;1;0
2190; 34.6 ; 173.2 ; 8.3 ;5;84;17;0;5;4;1;2;3;2;3;0
2191; 28.3 ; 56.6 ; 3.7 ;2;139;152;0;2;0;2;0;2;1;1;0
2192; 22.0 ; 110.1 ; 7.1 ;5;24;299;0;5;1;4;2;3;5;0;0
2193; 100.2 ; 400.7 ; 86.0 ;4;33;79;0;4;0;4;2;2;1;0;3
2194; 44.6 ; 89.1 ; 5.4 ;2;74;22;2;0;0;2;2;0;0;2;0
2195; 24.7 ; 49.4 ; 10.3 ;2;212;4;0;2;2;0;0;2;1;1;0
2196; 34.0 ; 136.1 ; 19.2 ;4;68;223;0;4;3;1;1;3;1;3;0
2197; 67.4 ; 202.3 ; 28.1 ;3;148;21;0;3;0;3;3;0;0;0;3
2198; 30.4 ; 121.4 ; 0.4 ;4;109;19;0;4;4;0;2;2;1;3;0
2199; 28.0 ; 111.9 ; 7.7 ;4;38;50;0;4;4;0;3;1;3;1;0
2200; 16.6 ; 198.8 ; 3.4 ;12;30;8;0;12;7;5;5;7;12;0;0
2201; 27.8 ; 111.4 ; 2.6 ;4;7;125;0;4;2;2;0;4;3;1;0
2202; 28.2 ; 141.2 ; 6.2 ;5;23;20;0;5;1;4;3;2;3;2;0
2203; 41.8 ; 167.3 ; 11.9 ;4;65;20;0;4;1;3;4;0;1;3;0
2204; 20.4 ; 61.1 ; 7.3 ;3;5;138;0;3;1;2;1;2;3;0;0
2205; 20.1 ; 100.6 ; 3.6 ;5;44;5;0;5;1;4;1;4;5;0;0
2206; 47.4 ; 1,090.9 ; 2.6 ;23;15;10;0;23;7;16;17;6;0;23;0
2207; 53.2 ; 159.7 ; 2.9 ;3;74;94;1;2;2;1;1;2;0;2;1
2208; 17.3 ; 138.8 ; 3.1 ;8;44;6;0;8;6;2;5;3;8;0;0
2209; 17.1 ; 137.0 ; 2.8 ;8;17;109;7;1;5;3;4;4;8;0;0
2210; 25.1 ; 50.1 ; -   ;2;165;41;0;2;0;2;1;1;2;0;0
2211; 33.3 ; 66.6 ; 27.4 ;2;42;239;0;2;1;1;2;0;1;0;1
2212; 15.0 ; 30.0 ; -   ;2;76;89;0;2;0;2;2;0;2;0;0
2213; 46.0 ; 276.0 ; 2.3 ;6;33;0;0;6;1;5;2;4;0;6;0
2214; 60.7 ; 667.7 ; 6.9 ;11;31;26;0;11;7;4;9;2;0;0;11
2215; 31.3 ; 313.2 ; 25.6 ;10;32;5;0;10;3;7;2;8;3;4;3
2216; 43.2 ; 302.3 ; 24.1 ;7;53;37;0;7;2;5;3;4;2;3;2
2217; 139.2 ; 417.6 ; 102.5 ;3;34;77;3;0;3;0;3;0;0;0;3
2218; 76.9 ; 384.3 ; 42.4 ;5;63;10;0;5;1;4;4;1;0;0;5
2219; 71.9 ; 143.7 ; 37.6 ;2;32;326;0;2;0;2;1;1;0;0;2
2220; 93.6 ; 468.2 ; 23.8 ;5;45;183;0;5;0;5;3;2;0;0;5
2221; 55.8 ; 167.3 ; 37.2 ;3;65;21;0;3;1;2;2;1;1;0;2
2222; 21.7 ; 282.3 ; 10.5 ;13;31;3;0;13;5;8;3;10;9;4;0
2223; 27.7 ; 332.7 ; 14.8 ;12;16;47;0;12;5;7;10;2;8;4;0
2224; 41.9 ; 167.4 ; 17.7 ;4;63;23;2;2;2;2;2;2;1;2;1
2225; 15.9 ; 31.8 ; 1.4 ;2;6;373;0;2;0;2;1;1;2;0;0
2226; 114.3 ; 228.7 ; 92.9 ;2;75;5;0;2;0;2;1;1;1;0;1
2227; 36.6 ; 73.2 ; -   ;2;2;13;2;0;1;1;0;2;0;2;0
2228; 16.9 ; 557.9 ; 6.1 ;33;8;8;0;33;24;9;32;1;33;0;0
2229; 32.2 ; 450.5 ; 15.1 ;14;22;22;0;14;3;11;4;10;5;9;0
2230; 33.3 ; 99.9 ; 17.5 ;3;68;189;0;3;1;2;3;0;1;2;0
2231; 33.0 ; 660.1 ; 15.3 ;20;12;62;0;20;11;9;19;1;7;13;0
2232; 28.6 ; 142.8 ; 3.4 ;5;50;23;0;5;2;3;3;2;3;2;0
2233; 47.8 ; 95.7 ; 0.5 ;2;94;0;1;1;0;2;0;2;0;2;0
2234; 48.0 ; 143.9 ; 21.5 ;3;44;162;0;3;1;2;1;2;1;1;1
2235; 18.7 ; 74.9 ; 7.9 ;4;5;113;0;4;4;0;4;0;4;0;0
2236; 34.6 ; 346.0 ; 15.9 ;10;5;2;0;10;4;6;5;5;3;7;0
2237; 36.1 ; 469.1 ; 5.6 ;13;24;84;1;12;4;9;6;7;0;13;0
2238; 47.8 ; 191.0 ; 12.6 ;4;50;169;0;4;1;3;3;1;0;3;1
2239; 16.4 ; 32.8 ; 2.1 ;2;50;150;0;2;2;0;0;2;2;0;0
2240; 99.4 ; 198.7 ; 3.2 ;2;9;186;0;2;1;1;1;1;0;0;2
2241; 42.0 ; 83.9 ; 7.2 ;2;50;160;0;2;2;0;1;1;0;2;0
2242; 25.3 ; 50.6 ; 7.3 ;2;32;338;0;2;2;0;0;2;1;1;0
2243; 23.7 ; 94.9 ; 7.9 ;4;61;20;0;4;1;3;3;1;3;1;0
2244; 42.0 ; 462.0 ; 16.5 ;11;34;23;0;11;1;10;3;8;4;3;4
2245; 49.5 ; 198.2 ; 26.9 ;4;51;140;0;4;2;2;2;2;1;2;1
2246; 16.5 ; 33.0 ; 2.3 ;2;112;6;0;2;0;2;2;0;2;0;0
2247; 18.7 ; 74.9 ; 7.9 ;4;40;24;0;4;4;0;4;0;4;0;0
2248; 51.7 ; 155.0 ; 9.0 ;3;2;269;0;3;1;2;1;2;0;2;1
2249; 83.6 ; 250.9 ; 3.8 ;3;51;120;0;3;1;2;3;0;0;0;3
2250; 49.1 ; 1,719.6 ; 20.9 ;35;10;41;0;35;0;35;29;6;12;11;12
2251; 103.5 ; 207.0 ; 15.1 ;2;37;11;0;2;0;2;2;0;0;0;2
2252; 48.2 ; 144.5 ; 2.6 ;3;74;143;0;3;1;2;0;3;0;3;0
2253; 36.0 ; 216.1 ; 15.3 ;6;54;0;0;6;2;4;4;2;2;4;0
2254; 47.2 ; 236.2 ; 23.6 ;5;31;134;0;5;4;1;2;3;2;1;2
2255; 36.7 ; 477.1 ; 13.2 ;13;18;2;0;13;12;1;3;10;4;9;0
2256; 48.4 ; 338.5 ; 2.7 ;7;44;5;0;7;0;7;6;1;0;7;0
2257; 107.3 ; 429.3 ; 29.4 ;4;76;36;2;2;0;4;4;0;0;0;4
2258; 35.7 ; 178.4 ; 46.4 ;5;53;32;0;5;2;3;5;0;2;1;2
2259; 40.8 ; 611.5 ; 14.2 ;15;19;5;0;15;3;12;11;4;5;10;0
2260; 44.0 ; 132.0 ; 6.7 ;3;6;420;0;3;0;3;1;2;0;3;0
2261; 49.2 ; 246.2 ; 1.3 ;5;33;77;0;5;0;5;3;2;0;5;0
2262; 29.6 ; 118.4 ; 20.7 ;4;105;2;0;4;3;1;2;2;3;1;0
2263; 53.6 ; 107.1 ; 8.0 ;2;50;5;0;2;0;2;1;1;0;1;1
2264; 32.2 ; 64.4 ; 20.4 ;2;34;285;0;2;1;1;0;2;1;1;0
2265; 37.5 ; 899.0 ; 15.8 ;24;18;11;0;24;4;20;22;2;8;16;0
2266; 60.0 ; 239.9 ; 15.6 ;4;106;69;0;4;1;3;3;1;0;0;4
2267; 54.4 ; 271.8 ; 1.6 ;5;12;62;0;5;1;4;4;1;0;3;2
2268; 36.5 ; 73.0 ; 9.5 ;2;68;158;0;2;0;2;2;0;1;1;0
2269; 39.8 ; 159.2 ; 8.7 ;4;54;142;0;4;2;2;2;2;0;4;0
2270; 27.4 ; 137.1 ; 13.5 ;5;33;56;0;5;4;1;3;2;3;2;0
2271; 28.6 ; 200.4 ; 17.3 ;7;26;115;0;7;0;7;4;3;5;2;0
2272; 64.2 ; 128.4 ; 44.3 ;2;44;352;0;2;0;2;1;1;1;0;1
2273; 50.8 ; 559.2 ; 6.3 ;11;28;5;0;11;1;10;10;1;0;7;4
2274; 33.1 ; 396.8 ; 18.4 ;12;27;99;0;12;3;9;9;3;4;8;0
2275; 38.5 ; 76.9 ; 12.4 ;2;46;241;0;2;1;1;2;0;1;1;0
2276; 22.2 ; 88.7 ; 5.1 ;4;41;171;0;4;3;1;1;3;4;0;0
2277; 21.8 ; 43.7 ; 4.9 ;2;220;24;0;2;2;0;2;0;2;0;0
2278; 23.8 ; 95.3 ; 16.3 ;4;59;132;0;4;1;3;2;2;3;1;0
2279; 34.3 ; 102.9 ; 18.1 ;3;9;335;0;3;3;0;1;2;1;2;0
2280; 77.3 ; 850.6 ; 33.1 ;11;18;27;0;11;1;10;9;2;0;0;11
2281; 40.3 ; 80.6 ; 37.9 ;2;1;217;0;2;2;0;0;2;1;0;1
2282; 27.8 ; 278.3 ; 22.5 ;10;21;18;0;10;8;2;6;4;7;3;0
2283; 51.1 ; 102.2 ; 9.2 ;2;50;99;1;1;0;2;1;1;0;1;1
2284; 38.5 ; 76.9 ; 12.4 ;2;5;162;0;2;0;2;2;0;1;1;0
2285; 50.0 ; 149.9 ; 12.3 ;3;22;241;0;3;0;3;3;0;0;2;1
2286; 30.2 ; 60.4 ; -   ;2;14;129;0;2;1;1;1;1;0;2;0
2287; 15.9 ; 47.8 ; 1.7 ;3;79;63;0;3;1;2;1;2;3;0;0
2288; 32.8 ; 164.1 ; 22.7 ;5;60;20;0;5;3;2;1;4;2;1;2
2289; 45.4 ; 362.8 ; 31.3 ;8;21;174;0;8;4;4;4;4;3;2;3
2290; 22.0 ; 439.1 ; 14.6 ;20;8;5;0;20;12;8;18;2;13;7;0
2291; 70.1 ; 140.3 ; 35.0 ;2;67;104;1;1;1;1;2;0;0;0;2
2292; 34.2 ; 102.7 ; 12.4 ;3;103;6;0;3;1;2;0;3;1;2;0
2293; 68.6 ; 411.4 ; 1.5 ;6;42;23;0;6;2;4;3;3;0;0;6
2294; 23.8 ; 119.1 ; 9.1 ;5;58;35;0;5;1;4;0;5;3;2;0
2295; 20.7 ; 41.5 ; -   ;2;118;62;0;2;1;1;1;1;2;0;0
2296; 58.3 ; 291.4 ; 24.2 ;5;61;26;0;5;2;3;1;4;0;0;5
2297; 50.3 ; 251.6 ; 7.2 ;5;77;1;2;3;3;2;5;0;0;3;2
2298; 29.0 ; 115.8 ; 9.2 ;4;65;14;0;4;2;2;4;0;3;1;0
2299; 32.4 ; 97.2 ; 19.0 ;3;177;0;0;3;2;1;3;0;1;2;0
2300; 24.8 ; 273.0 ; 15.1 ;11;29;1;0;11;6;5;8;3;7;4;0
2301; 70.8 ; 141.7 ; 36.1 ;2;238;73;0;2;1;1;1;1;0;0;2
2302; 81.8 ; 736.4 ; 16.0 ;9;21;15;0;9;0;9;7;2;0;0;9
2303; 28.4 ; 198.6 ; 13.8 ;7;21;95;1;6;1;6;7;0;5;2;0
2304; 18.6 ; 111.8 ; 4.3 ;6;34;93;0;6;3;3;4;2;6;0;0
2305; 19.1 ; 38.3 ; 0.8 ;2;33;263;0;2;1;1;1;1;2;0;0
2306; 30.2 ; 151.2 ; 12.9 ;5;32;71;0;5;4;1;4;1;2;3;0
2307; 48.3 ; 145.0 ; 1.5 ;3;49;170;0;3;1;2;0;3;0;3;0
2308; 46.9 ; 609.6 ; 18.0 ;13;30;0;0;13;0;13;6;7;4;5;4
2309; 67.4 ; 337.1 ; 25.9 ;5;62;57;0;5;0;5;5;0;0;0;5
2310; 32.6 ; 65.1 ; 11.2 ;2;13;48;0;2;0;2;2;0;1;1;0
2311; 31.4 ; 408.2 ; 15.5 ;13;24;5;0;13;2;11;9;4;4;9;0
2312; 48.1 ; 336.9 ; 14.0 ;7;48;32;0;7;2;5;3;4;0;5;2
2313; 102.9 ; 205.7 ; 14.0 ;2;140;180;0;2;2;0;1;1;0;0;2
2314; 38.5 ; 76.9 ; 12.4 ;2;6;263;0;2;0;2;2;0;1;1;0
2315; 28.3 ; 226.2 ; 7.5 ;8;27;101;0;8;1;7;5;3;5;3;0
2316; 48.6 ; 631.3 ; 16.1 ;13;23;8;0;13;5;8;6;7;0;9;4
2317; 22.6 ; 45.1 ; 3.8 ;2;32;183;2;0;0;2;1;1;2;0;0
2318; 28.2 ; 169.1 ; 13.1 ;6;20;47;0;6;2;4;0;6;4;2;0
2319; 36.4 ; 109.2 ; 9.9 ;3;23;110;3;0;1;2;1;2;1;2;0
2320; 42.9 ; 171.7 ; 9.2 ;4;38;57;0;4;0;4;2;2;0;4;0
2321; 19.1 ; 57.2 ; 3.7 ;3;4;250;0;3;1;2;1;2;3;0;0
2322; 33.2 ; 331.7 ; 6.2 ;10;31;11;0;10;3;7;2;8;3;7;0
2323; 99.8 ; 199.6 ; 95.7 ;2;12;11;1;1;0;2;1;1;1;0;1
2324; 41.1 ; 575.0 ; 31.4 ;14;22;2;0;14;1;13;8;6;5;4;5
2325; 20.3 ; 142.2 ; 5.7 ;7;32;14;0;7;3;4;4;3;7;0;0
2326; 55.8 ; 278.8 ; 11.5 ;5;56;80;0;5;3;2;1;4;0;0;5
2327; 44.7 ; 357.4 ; 19.5 ;8;36;57;0;8;2;6;3;5;3;2;3
2328; 19.1 ; 57.2 ; 5.6 ;3;83;18;0;3;2;1;0;3;3;0;0
2329; 65.6 ; 131.1 ; 43.6 ;2;139;12;0;2;2;0;0;2;1;0;1
2330; 35.3 ; 141.3 ; 10.9 ;4;13;314;0;4;2;2;1;3;1;3;0
2331; 17.0 ; 85.0 ; 4.8 ;5;68;61;2;3;1;4;2;3;5;0;0
2332; 22.8 ; 159.3 ; 15.1 ;7;5;199;0;7;2;5;4;3;5;2;0
2333; 15.0 ; 74.9 ; -   ;5;37;8;1;4;3;2;1;4;5;0;0
2334; 50.1 ; 100.3 ; 2.2 ;2;31;149;0;2;1;1;0;2;0;2;0
2335; 39.5 ; 118.6 ; 23.1 ;3;77;54;0;3;2;1;2;1;1;1;1
2336; 20.8 ; 353.7 ; 9.3 ;17;22;33;0;17;5;12;8;9;11;6;0
2337; 44.8 ; 89.6 ; 2.9 ;2;130;170;0;2;1;1;0;2;0;2;0
2338; 26.6 ; 372.5 ; 10.6 ;14;27;51;0;14;6;8;1;13;9;5;0
2339; 40.9 ; 204.6 ; 7.8 ;5;3;297;0;5;1;4;4;1;0;5;0
2340; 32.0 ; 160.0 ; 9.5 ;5;59;61;0;5;3;2;2;3;2;3;0
2341; 32.3 ; 161.7 ; 8.8 ;5;59;83;0;5;1;4;1;4;2;3;0
2342; 40.6 ; 894.0 ; 18.0 ;22;19;26;0;22;6;16;12;10;7;8;7
2343; 50.1 ; 150.2 ; 3.0 ;3;20;96;3;0;3;0;1;2;0;3;0
2344; 27.9 ; 111.8 ; 6.1 ;4;16;15;0;4;0;4;3;1;3;1;0
2345; 30.2 ; 150.9 ; 9.9 ;5;18;1;0;5;2;3;3;2;2;3;0
2346; 54.9 ; 164.7 ; 2.4 ;3;40;150;3;0;1;2;1;2;0;2;1
2347; 34.2 ; 102.7 ; 12.4 ;3;29;69;0;3;2;1;1;2;1;2;0
2348; 54.6 ; 218.6 ; 5.3 ;4;94;21;1;3;2;2;4;0;0;3;1
2349; 58.5 ; 468.2 ; 26.2 ;8;25;10;0;8;2;6;6;2;0;0;8
2350; 33.4 ; 133.6 ; 16.9 ;4;109;23;0;4;4;0;2;2;1;3;0
2351; 39.6 ; 158.5 ; 6.4 ;4;9;245;0;4;2;2;3;1;0;4;0
2352; 32.0 ; 127.9 ; 19.0 ;4;104;23;0;4;1;3;2;2;1;3;0
2353; 16.8 ; 33.6 ; 2.7 ;2;33;112;2;0;2;0;1;1;2;0;0
2354; 33.8 ; 135.0 ; 22.9 ;4;3;251;0;4;1;3;2;2;1;2;1
2355; 62.7 ; 188.2 ; 21.3 ;3;16;133;0;3;3;0;1;2;0;0;3
2356; 33.6 ; 67.3 ; 22.5 ;2;162;129;0;2;2;0;2;0;1;0;1
2357; 46.0 ; 230.1 ; 8.7 ;5;59;42;0;5;2;3;3;2;0;5;0
2358; 15.0 ; 45.0 ; -   ;3;13;200;0;3;1;2;1;2;3;0;0
2359; 24.1 ; 168.7 ; 20.3 ;7;23;7;0;7;1;6;1;6;5;2;0
2360; 48.3 ; 241.6 ; 9.7 ;5;20;22;0;5;1;4;5;0;0;3;2
2361; 27.3 ; 81.8 ; 11.8 ;3;16;110;0;3;0;3;2;1;2;1;0
2362; 35.4 ; 318.6 ; 11.4 ;9;25;164;0;9;3;6;6;3;3;6;0
2363; 33.0 ; 66.0 ; 4.5 ;2;62;106;0;2;0;2;1;1;1;1;0
2364; 50.5 ; 151.6 ; 3.8 ;3;16;234;0;3;1;2;3;0;0;3;0
2365; 41.2 ; 536.1 ; 9.9 ;13;14;14;0;13;1;12;6;7;0;13;0
2366; 17.5 ; 70.0 ; 3.1 ;4;23;41;0;4;1;3;2;2;4;0;0
2367; 54.2 ; 162.6 ; 29.1 ;3;94;119;0;3;3;0;2;1;1;1;1
2368; 58.8 ; 293.8 ; 28.6 ;5;110;5;0;5;0;5;1;4;0;0;5
2369; 26.8 ; 348.3 ; 10.0 ;13;17;21;0;13;7;6;10;3;9;4;0
2370; 49.3 ; 246.7 ; -   ;5;11;62;0;5;3;2;1;4;0;5;0
2371; 44.9 ; 134.6 ; 13.1 ;3;22;246;0;3;0;3;1;2;0;2;1
2372; 22.7 ; 113.7 ; 14.1 ;5;15;173;0;5;3;2;1;4;3;2;0
2373; 78.2 ; 156.5 ; 6.7 ;2;131;99;2;0;0;2;2;0;0;0;2
2374; 67.2 ; 335.9 ; 44.8 ;5;37;99;0;5;4;1;4;1;2;0;3
2375; 17.2 ; 34.4 ; 3.3 ;2;65;168;0;2;1;1;0;2;2;0;0
2376; 25.8 ; 51.6 ; 16.2 ;2;21;26;0;2;0;2;2;0;1;1;0
2377; 52.0 ; 156.0 ; 8.9 ;3;74;99;0;3;1;2;3;0;0;2;1
2378; 19.5 ; 409.3 ; 4.0 ;21;8;192;0;21;12;9;13;8;21;0;0
2379; 49.5 ; 247.7 ; 6.8 ;5;26;10;0;5;0;5;5;0;0;3;2
2380; 66.2 ; 198.5 ; 34.3 ;3;18;36;0;3;0;3;3;0;0;0;3
2381; 40.4 ; 161.6 ; 12.6 ;4;53;79;4;0;2;2;2;2;1;3;0
2382; 49.2 ; 196.7 ; 0.7 ;4;50;15;0;4;0;4;1;3;0;4;0
2383; 88.2 ; 441.1 ; 40.4 ;5;6;244;0;5;5;0;1;4;0;0;5
2384; 35.9 ; 71.8 ; 16.2 ;2;37;194;0;2;0;2;0;2;1;1;0
2385; 77.5 ; 774.8 ; 34.3 ;10;23;77;0;10;2;8;7;3;0;0;10
2386; 47.1 ; 94.2 ; 0.5 ;2;51;68;0;2;1;1;1;1;0;2;0
2387; 58.5 ; 175.4 ; 14.6 ;3;72;131;0;3;1;2;3;0;0;0;3
2388; 26.6 ; 53.2 ; 2.3 ;2;14;128;0;2;2;0;2;0;2;0;0
2389; 47.7 ; 238.7 ; 0.8 ;5;43;27;0;5;2;3;5;0;0;5;0
2390; 20.0 ; 540.7 ; 11.4 ;27;11;3;0;27;12;15;13;14;18;9;0
2391; 42.8 ; 1,371.2 ; 20.3 ;32;10;15;0;32;1;31;15;17;11;10;11
2392; 62.3 ; 249.4 ; 19.1 ;4;86;77;0;4;2;2;2;2;0;0;4
2393; 32.3 ; 64.6 ; 23.8 ;2;12;1;0;2;0;2;2;0;1;0;1
2394; 59.9 ; 299.6 ; 26.4 ;5;31;137;0;5;2;3;5;0;0;0;5
2395; 19.2 ; 38.3 ; 1.9 ;2;47;307;0;2;1;1;1;1;2;0;0
2396; 17.1 ; 325.1 ; 8.2 ;19;8;4;0;19;9;10;8;11;19;0;0
2397; 21.3 ; 85.1 ; 5.1 ;4;13;142;0;4;1;3;2;2;4;0;0
2398; 46.5 ; 232.5 ; 18.6 ;5;36;0;0;5;0;5;1;4;2;1;2
2399; 19.5 ; 78.0 ; 7.6 ;4;51;24;0;4;3;1;3;1;4;0;0
2400; 51.5 ; 206.1 ; 28.5 ;4;86;52;0;4;1;3;2;2;1;2;1
2401; 52.3 ; 104.5 ; 17.0 ;2;77;153;0;2;1;1;2;0;0;1;1
2402; 64.4 ; 128.9 ; 16.2 ;2;194;38;0;2;1;1;2;0;0;0;2
2403; 17.0 ; 255.6 ; 4.9 ;15;23;8;0;15;7;8;7;8;15;0;0
2404; 53.4 ; 801.0 ; 19.3 ;15;9;149;0;15;7;8;8;7;0;10;5
2405; 34.8 ; 139.0 ; 24.3 ;4;58;25;0;4;4;0;1;3;1;2;1
2406; 25.1 ; 50.1 ; -   ;2;83;78;0;2;0;2;1;1;2;0;0
2407; 52.3 ; 313.8 ; 33.4 ;6;38;85;0;6;3;3;1;5;2;2;2
2408; 24.8 ; 247.8 ; 15.7 ;10;32;26;0;10;5;5;7;3;7;3;0
2409; 20.1 ; 40.2 ; 2.3 ;2;109;55;0;2;1;1;1;1;2;0;0
2410; 18.0 ; 89.9 ; 7.1 ;5;26;99;5;0;2;3;5;0;5;0;0
2411; 54.2 ; 108.4 ; 9.1 ;2;15;295;0;2;1;1;0;2;0;1;1
2412; 73.9 ; 147.9 ; 32.1 ;2;112;123;0;2;2;0;0;2;0;0;2
2413; 46.8 ; 187.0 ; -   ;4;27;123;0;4;3;1;1;3;0;4;0
2414; 45.3 ; 90.6 ; 2.2 ;2;150;15;0;2;0;2;2;0;0;2;0
2415; 48.1 ; 96.2 ; 13.1 ;2;25;58;0;2;0;2;2;0;0;1;1
2416; 38.5 ; 308.2 ; 12.8 ;8;27;113;0;8;4;4;6;2;3;5;0
2417; 27.5 ; 358.0 ; 4.9 ;13;9;164;0;13;3;10;7;6;9;4;0
2418; 30.2 ; 60.4 ; -   ;2;23;80;1;1;1;1;1;1;0;2;0
2419; 32.9 ; 230.0 ; 15.6 ;7;30;53;0;7;2;5;4;3;2;5;0
2420; 53.7 ; 268.6 ; 6.7 ;5;61;41;0;5;1;4;5;0;0;3;2
2421; 15.0 ; 45.0 ; -   ;3;74;190;0;3;2;1;1;2;3;0;0
2422; 24.0 ; 191.9 ; 9.5 ;8;35;32;0;8;1;7;3;5;5;3;0
2423; 46.9 ; 93.7 ; 15.4 ;2;54;164;0;2;1;1;1;1;0;1;1
2424; 31.8 ; 95.4 ; 30.9 ;3;85;152;0;3;0;3;3;0;1;1;1
2425; 38.1 ; 76.1 ; 12.1 ;2;88;272;0;2;0;2;1;1;1;1;0
2426; 36.6 ; 109.8 ; -   ;3;50;50;0;3;3;0;1;2;0;3;0
2427; 55.8 ; 837.3 ; 27.6 ;15;15;12;0;15;6;9;13;2;5;0;10
2428; 17.2 ; 567.7 ; 2.3 ;33;8;26;0;33;1;32;27;6;33;0;0
2429; 20.0 ; 40.1 ; 7.6 ;2;101;21;0;2;0;2;1;1;2;0;0
2430; 24.2 ; 72.7 ; 4.2 ;3;5;92;0;3;2;1;1;2;3;0;0
2431; 32.8 ; 98.3 ; 7.0 ;3;79;163;0;3;0;3;1;2;1;2;0
2432; 20.2 ; 60.7 ; 9.6 ;3;7;218;0;3;1;2;2;1;3;0;0
2433; 65.2 ; 195.5 ; 34.1 ;3;27;205;0;3;1;2;3;0;0;0;3
2434; 47.0 ; 986.7 ; 14.6 ;21;14;15;5;16;0;21;20;1;0;14;7
2435; 15.0 ; 30.0 ; -   ;2;125;26;1;1;0;2;2;0;2;0;0
2436; 33.9 ; 169.6 ; 14.3 ;5;56;28;0;5;1;4;2;3;2;3;0
2437; 69.8 ; 279.0 ; 58.9 ;4;39;160;0;4;2;2;4;0;1;0;3
2438; 17.5 ; 35.0 ; 3.8 ;2;29;98;0;2;2;0;0;2;2;0;0
2439; 47.5 ; 94.9 ; -   ;2;73;38;1;1;0;2;0;2;0;2;0
2440; 52.4 ; 733.2 ; 37.1 ;14;13;233;0;14;4;10;5;9;5;4;5
2441; 29.9 ; 119.4 ; 19.0 ;4;17;125;0;4;3;1;4;0;3;1;0
2442; 20.2 ; 81.0 ; 7.1 ;4;9;59;0;4;2;2;4;0;4;0;0
2443; 48.2 ; 192.6 ; 1.0 ;4;41;167;0;4;0;4;2;2;0;4;0
2444; 43.0 ; 214.8 ; 34.4 ;5;32;47;0;5;1;4;2;3;2;1;2
2445; 31.7 ; 253.5 ; 32.2 ;8;41;6;0;8;2;6;1;7;3;2;3
2446; 59.9 ; 179.6 ; 68.8 ;3;74;101;1;2;1;2;2;1;1;0;2
2447; 29.2 ; 291.7 ; 9.1 ;10;32;36;0;10;3;7;3;7;7;3;0
2448; 33.7 ; 168.4 ; 18.1 ;5;24;104;0;5;2;3;2;3;2;3;0
2449; 67.4 ; 134.8 ; 46.2 ;2;210;15;0;2;1;1;1;1;1;0;1
2450; 41.1 ; 164.3 ; 16.0 ;4;14;8;0;4;3;1;1;3;1;2;1
2451; 27.0 ; 324.3 ; 5.0 ;12;32;60;0;12;6;6;12;0;8;4;0
2452; 37.9 ; 530.6 ; 31.1 ;14;16;11;0;14;7;7;12;2;5;4;5
2453; 29.4 ; 88.2 ; 14.7 ;3;47;22;0;3;0;3;3;0;2;1;0
2454; 56.1 ; 112.2 ; 11.2 ;2;75;215;0;2;0;2;0;2;0;0;2
2455; 88.5 ; 176.9 ; 2.1 ;2;120;93;2;0;1;1;1;1;0;0;2
2456; 36.3 ; 72.5 ; 16.8 ;2;15;28;0;2;2;0;0;2;1;1;0
2457; 25.9 ; 155.3 ; 13.9 ;6;9;53;0;6;3;3;1;5;4;2;0
2458; 84.7 ; 254.0 ; 68.9 ;3;78;79;0;3;0;3;3;0;1;0;2
2459; 15.0 ; 74.9 ; -   ;5;34;22;0;5;0;5;4;1;5;0;0
2460; 56.5 ; 113.0 ; 11.8 ;2;28;243;0;2;1;1;2;0;0;0;2
2461; 32.9 ; 493.6 ; 15.0 ;15;14;4;0;15;6;9;12;3;5;10;0
2462; 48.4 ; 628.9 ; 18.1 ;13;24;0;0;13;8;5;12;1;0;9;4
2463; 29.2 ; 116.8 ; 5.9 ;4;42;95;0;4;0;4;2;2;3;1;0
2464; 16.5 ; 33.0 ; -   ;2;7;136;0;2;0;2;0;2;2;0;0
2465; 21.7 ; 65.1 ; 6.2 ;3;81;22;0;3;0;3;1;2;3;0;0
2466; 31.8 ; 63.7 ; 25.2 ;2;2;288;0;2;0;2;2;0;1;0;1
2467; 50.0 ; 250.2 ; 27.5 ;5;53;7;0;5;3;2;4;1;2;1;2
2468; 25.3 ; 126.4 ; 15.5 ;5;42;62;5;0;1;4;4;1;3;2;0
2469; 39.4 ; 78.8 ; 13.8 ;2;173;117;0;2;1;1;1;1;1;1;0
2470; 34.7 ; 173.6 ; 11.9 ;5;32;23;1;4;4;1;2;3;2;3;0
2471; 54.2 ; 108.5 ; 8.3 ;2;5;278;0;2;0;2;0;2;0;1;1
2472; 65.8 ; 197.3 ; 11.6 ;3;76;94;0;3;0;3;1;2;0;0;3
2473; 63.9 ; 510.9 ; 20.6 ;8;35;29;0;8;5;3;4;4;0;0;8
2474; 28.2 ; 112.7 ; 6.6 ;4;71;9;1;3;2;2;2;2;3;1;0
2475; 71.9 ; 719.2 ; 34.8 ;10;33;13;0;10;3;7;10;0;0;0;10
2476; 29.2 ; 145.9 ; 12.4 ;5;24;26;0;5;0;5;1;4;3;2;0
2477; 18.2 ; 436.2 ; 1.3 ;24;5;52;0;24;5;19;24;0;24;0;0
2478; 33.6 ; 268.6 ; 12.7 ;8;23;263;0;8;1;7;5;3;3;5;0
2479; 28.4 ; 85.3 ; 3.1 ;3;43;17;0;3;0;3;3;0;2;1;0
2480; 21.2 ; 63.6 ; 5.8 ;3;33;204;0;3;1;2;0;3;3;0;0
2481; 38.0 ; 303.8 ; 8.7 ;8;44;15;0;8;2;6;1;7;3;5;0
2482; 38.0 ; 1,443.5 ; 40.5 ;38;11;15;0;38;17;21;29;9;13;12;13
2483; 22.6 ; 45.2 ; 11.4 ;2;5;99;0;2;0;2;2;0;1;1;0
2484; 27.2 ; 272.4 ; 10.9 ;10;12;139;0;10;5;5;8;2;7;3;0
2485; 20.7 ; 82.8 ; 6.4 ;4;86;73;0;4;1;3;1;3;4;0;0
2486; 30.4 ; 152.2 ; 38.6 ;5;47;29;1;4;0;5;5;0;2;1;2
2487; 33.0 ; 132.2 ; 10.0 ;4;14;174;0;4;0;4;2;2;1;3;0
2488; 40.3 ; 161.4 ; 14.0 ;4;53;84;4;0;2;2;2;2;1;3;0
2489; 44.2 ; 88.3 ; 11.3 ;2;201;94;0;2;0;2;2;0;0;1;1
2490; 26.2 ; 601.7 ; 11.3 ;23;17;8;0;23;11;12;19;4;15;8;0
2491; 30.9 ; 92.6 ; 20.6 ;3;105;115;0;3;1;2;1;2;1;2;0
2492; 70.6 ; 141.2 ; -   ;2;12;188;0;2;0;2;2;0;0;0;2
2493; 25.1 ; 75.2 ; -   ;3;23;41;0;3;2;1;2;1;3;0;0
2494; 42.7 ; 256.4 ; 9.1 ;6;5;10;0;6;0;6;5;1;0;6;0
2495; 57.1 ; 1,654.8 ; 13.2 ;29;13;5;0;29;7;22;14;15;0;0;29
2496; 15.0 ; 45.0 ; -   ;3;65;119;0;3;1;2;3;0;3;0;0
2497; 35.3 ; 176.5 ; 12.4 ;5;43;132;0;5;2;3;1;4;2;3;0
2498; 49.3 ; 98.7 ; 3.6 ;2;12;16;0;2;0;2;1;1;0;2;0
2499; 18.6 ; 222.8 ; 4.9 ;12;17;104;1;11;1;11;9;3;12;0;0
2500; 21.0 ; 104.9 ; 14.2 ;5;10;315;0;5;2;3;5;0;3;2;0
2501; 19.0 ; 114.2 ; 2.4 ;6;11;7;6;0;4;2;6;0;6;0;0
2502; 16.5 ; 279.9 ; 4.3 ;17;11;50;0;17;4;13;10;7;17;0;0
2503; 38.5 ; 76.9 ; 12.4 ;2;297;126;0;2;0;2;2;0;1;1;0
2504; 15.0 ; 30.0 ; -   ;2;10;259;0;2;1;1;1;1;2;0;0
2505; 45.5 ; 91.1 ; 2.9 ;2;36;69;0;2;0;2;1;1;0;2;0
2506; 31.0 ; 619.5 ; 18.7 ;20;14;33;0;20;9;11;14;6;7;13;0
2507; 53.6 ; 160.8 ; 17.6 ;3;13;162;0;3;0;3;3;0;0;2;1
2508; 17.5 ; 105.2 ; 5.9 ;6;29;223;0;6;4;2;4;2;6;0;0
2509; 46.8 ; 93.5 ; -   ;2;32;353;0;2;0;2;1;1;0;2;0
2510; 32.1 ; 96.4 ; 27.3 ;3;111;88;0;3;2;1;2;1;1;1;1
2511; 38.2 ; 114.5 ; 16.2 ;3;73;93;0;3;2;1;2;1;1;2;0
2512; 37.2 ; 74.4 ; 18.2 ;2;41;2;0;2;1;1;0;2;1;0;1
2513; 16.3 ; 375.8 ; 3.5 ;23;16;36;0;23;6;17;17;6;23;0;0
2514; 31.2 ; 218.2 ; 16.3 ;7;22;5;0;7;2;5;5;2;2;5;0
2515; 80.4 ; 241.3 ; 23.8 ;3;27;1;0;3;0;3;2;1;0;0;3
2516; 47.4 ; 94.9 ; 24.3 ;2;77;16;0;2;0;2;1;1;1;0;1
2517; 19.7 ; 39.3 ; -   ;2;19;288;0;2;0;2;2;0;2;0;0
2518; 50.2 ; 351.2 ; 2.8 ;7;18;36;0;7;3;4;1;6;0;7;0
2519; 31.2 ; 406.2 ; 18.5 ;13;32;14;1;12;2;11;5;8;4;9;0
2520; 44.4 ; 177.6 ; 17.3 ;4;5;85;1;3;3;1;3;1;1;2;1
2521; 20.8 ; 145.3 ; 11.4 ;7;23;62;0;7;5;2;6;1;5;2;0
2522; 19.5 ; 273.3 ; 9.7 ;14;17;0;0;14;6;8;4;10;14;0;0
2523; 23.5 ; 376.4 ; 12.4 ;16;22;29;0;16;5;11;7;9;11;5;0
2524; 25.1 ; 100.4 ; 9.9 ;4;91;21;0;4;2;2;2;2;3;1;0
2525; 19.7 ; 39.3 ; -   ;2;35;250;0;2;1;1;0;2;2;0;0
2526; 37.4 ; 187.2 ; 2.0 ;5;67;62;0;5;0;5;5;0;0;5;0
2527; 47.6 ; 142.9 ; 1.0 ;3;50;79;0;3;0;3;1;2;0;3;0
2528; 60.1 ; 120.2 ; 0.5 ;2;50;288;0;2;0;2;2;0;0;0;2
2529; 36.6 ; 73.2 ; -   ;2;17;205;0;2;1;1;2;0;0;2;0
2530; 42.7 ; 641.1 ; 6.3 ;15;27;32;0;15;4;11;3;12;0;15;0
2531; 51.0 ; 102.0 ; -   ;2;79;183;0;2;1;1;1;1;0;2;0
2532; 20.8 ; 416.8 ; 9.3 ;20;20;40;0;20;7;13;14;6;13;7;0
2533; 45.5 ; 136.6 ; 14.4 ;3;112;134;0;3;1;2;1;2;0;2;1
2534; 28.5 ; 484.4 ; 12.0 ;17;14;74;0;17;6;11;8;9;11;6;0
2535; 26.5 ; 238.3 ; 10.6 ;9;14;99;0;9;2;7;4;5;6;3;0
2536; 26.5 ; 398.2 ; 18.1 ;15;24;5;0;15;6;9;8;7;10;5;0
2537; 63.1 ; 126.3 ; 20.3 ;2;62;68;0;2;0;2;0;2;0;0;2
2538; 89.3 ; 1,697.2 ; 31.9 ;19;17;5;0;19;3;16;4;15;0;0;19
2539; 17.5 ; 52.5 ; 2.5 ;3;3;271;0;3;2;1;1;2;3;0;0
2540; 47.2 ; 141.7 ; 0.4 ;3;78;26;3;0;0;3;3;0;0;3;0
2541; 16.9 ; 236.0 ; 2.6 ;14;16;17;14;0;7;7;4;10;14;0;0
2542; 69.2 ; 207.5 ; 22.8 ;3;44;173;0;3;1;2;3;0;0;0;3
2543; 38.8 ; 77.6 ; 20.5 ;2;29;204;0;2;1;1;1;1;1;0;1
2544; 25.4 ; 584.9 ; 12.6 ;23;18;0;0;23;12;11;20;3;15;8;0
2545; 49.0 ; 244.8 ; 2.2 ;5;36;21;2;3;0;5;5;0;0;5;0
2546; 55.3 ; 331.9 ; 3.0 ;6;25;121;0;6;1;5;5;1;0;0;6
2547; 42.3 ; 84.6 ; 8.8 ;2;18;0;0;2;0;2;2;0;0;2;0
2548; 23.6 ; 70.7 ; 8.2 ;3;43;99;0;3;2;1;1;2;2;1;0
2549; 49.6 ; 247.8 ; 16.6 ;5;50;160;0;5;1;4;5;0;0;3;2
2550; 49.7 ; 149.0 ; 1.8 ;3;50;100;0;3;0;3;1;2;0;3;0
2551; 20.7 ; 186.1 ; 8.5 ;9;34;15;0;9;5;4;8;1;9;0;0
2552; 28.3 ; 141.3 ; 16.5 ;5;33;98;0;5;3;2;3;2;3;2;0
2553; 64.6 ; 322.9 ; 10.0 ;5;67;173;0;5;3;2;1;4;0;0;5
2554; 72.9 ; 218.6 ; 21.3 ;3;22;89;0;3;0;3;3;0;0;0;3
2555; 33.2 ; 298.8 ; 16.8 ;9;13;71;0;9;5;4;2;7;3;6;0
2556; 53.2 ; 638.7 ; 8.6 ;12;26;16;0;12;3;9;3;9;0;8;4
2557; 35.7 ; 107.1 ; 10.1 ;3;101;125;0;3;0;3;1;2;1;2;0
2558; 32.2 ; 64.4 ; 3.3 ;2;1;130;0;2;1;1;1;1;1;1;0
2559; 36.4 ; 72.8 ; 12.8 ;2;11;83;0;2;1;1;0;2;1;1;0
2560; 49.4 ; 790.2 ; 26.2 ;16;21;57;0;16;8;8;13;3;5;6;5
2561; 35.0 ; 70.0 ; 20.8 ;2;39;41;0;2;1;1;1;1;1;0;1
2562; 45.6 ; 637.7 ; 13.3 ;14;6;28;14;0;7;7;8;6;0;9;5
2563; 41.7 ; 917.6 ; 16.1 ;22;7;10;2;20;5;17;12;10;7;8;7
2564; 33.2 ; 132.7 ; 14.2 ;4;122;7;0;4;4;0;2;2;1;3;0
2565; 43.0 ; 86.1 ; 14.2 ;2;19;245;0;2;1;1;2;0;1;0;1
2566; 18.3 ; 55.0 ; 6.2 ;3;106;26;0;3;1;2;1;2;3;0;0
2567; 28.4 ; 142.2 ; 6.3 ;5;11;93;0;5;4;1;3;2;3;2;0
2568; 51.3 ; 102.6 ; 22.1 ;2;55;195;0;2;0;2;1;1;1;0;1
2569; 41.9 ; 460.5 ; 10.7 ;11;36;32;0;11;4;7;7;4;0;11;0
2570; 57.1 ; 171.4 ; 19.8 ;3;4;256;0;3;2;1;1;2;0;0;3
2571; 56.4 ; 169.3 ; 7.2 ;3;72;152;0;3;0;3;1;2;0;0;3
2572; 47.6 ; 666.2 ; 37.3 ;14;23;5;0;14;6;8;4;10;5;4;5
2573; 31.7 ; 190.3 ; 4.3 ;6;3;263;0;6;0;6;5;1;2;4;0
2574; 16.8 ; 100.7 ; 1.8 ;6;9;2;0;6;4;2;3;3;6;0;0
2575; 26.4 ; 79.3 ; 21.0 ;3;18;47;0;3;1;2;1;2;2;1;0
2576; 49.3 ; 147.9 ; 3.1 ;3;103;125;0;3;2;1;3;0;0;3;0
2577; 19.3 ; 231.7 ; 11.2 ;12;27;9;0;12;12;0;11;1;8;4;0
2578; 29.2 ; 87.5 ; 17.6 ;3;32;59;1;2;2;1;2;1;2;1;0
2579; 31.7 ; 63.5 ; 2.3 ;2;156;208;1;1;2;0;0;2;1;1;0
2580; 37.5 ; 187.7 ; 9.0 ;5;26;40;0;5;1;4;3;2;2;3;0
2581; 41.4 ; 331.0 ; 14.0 ;8;52;41;0;8;0;8;3;5;3;2;3
2582; 15.0 ; 74.9 ; -   ;5;112;24;0;5;3;2;2;3;5;0;0
2583; 38.7 ; 232.2 ; 13.7 ;6;42;75;0;6;1;5;2;4;2;4;0
2584; 39.6 ; 79.1 ; 12.9 ;2;4;11;2;0;1;1;0;2;1;1;0
2585; 42.9 ; 85.7 ; -   ;2;12;173;2;0;0;2;2;0;0;2;0
2586; 51.4 ; 102.9 ; 15.4 ;2;1;126;2;0;0;2;1;1;0;1;1
2587; 30.4 ; 60.9 ; 0.7 ;2;241;15;0;2;1;1;1;1;1;1;0
2588; 24.6 ; 147.6 ; 11.4 ;6;29;99;0;6;0;6;1;5;4;2;0
2589; 22.6 ; 90.6 ; 2.6 ;4;2;3;0;4;4;0;1;3;4;0;0
2590; 38.7 ; 193.5 ; 12.1 ;5;35;116;0;5;2;3;3;2;2;3;0
2591; 37.0 ; 148.0 ; 2.7 ;4;31;259;0;4;1;3;4;0;0;4;0
2592; 57.1 ; 171.2 ; 29.2 ;3;97;105;0;3;0;3;1;2;1;0;2
2593; 52.8 ; 158.5 ; 19.7 ;3;56;153;0;3;0;3;1;2;0;2;1
2594; 15.0 ; 30.0 ; -   ;2;4;47;0;2;1;1;1;1;2;0;0
2595; 23.2 ; 625.8 ; 12.0 ;27;14;12;0;27;8;19;11;16;18;9;0
2596; 15.0 ; 30.0 ; -   ;2;15;169;0;2;1;1;1;1;2;0;0
2597; 51.8 ; 1,657.8 ; 9.3 ;32;11;11;0;32;11;21;17;15;0;21;11
2598; 48.0 ; 239.8 ; 13.1 ;5;86;6;0;5;2;3;2;3;0;3;2
2599; 35.1 ; 492.1 ; 9.6 ;14;23;5;0;14;0;14;3;11;5;9;0
2600; 19.7 ; 275.6 ; 5.5 ;14;17;4;0;14;7;7;4;10;14;0;0
2601; 54.0 ; 269.9 ; 35.3 ;5;56;31;0;5;3;2;3;2;2;1;2
2602; 48.2 ; 96.3 ; 2.1 ;2;11;260;0;2;2;0;0;2;0;2;0
2603; 52.4 ; 209.6 ; 37.9 ;4;4;152;0;4;2;2;3;1;1;2;1
2604; 22.7 ; 181.5 ; 9.8 ;8;23;233;0;8;6;2;8;0;5;3;0
2605; 38.2 ; 114.7 ; 12.2 ;3;57;167;0;3;1;2;3;0;1;2;0
2606; 36.3 ; 181.7 ; 13.3 ;5;68;47;0;5;1;4;2;3;2;3;0
2607; 56.1 ; 112.2 ; 61.6 ;2;14;236;0;2;0;2;0;2;1;0;1
2608; 36.6 ; 73.2 ; -   ;2;50;11;0;2;0;2;1;1;0;2;0
2609; 73.6 ; 367.9 ; 43.4 ;5;8;116;0;5;2;3;1;4;0;0;5
2610; 63.9 ; 319.5 ; 10.2 ;5;23;264;0;5;2;3;2;3;0;0;5
2611; 15.0 ; 45.0 ; -   ;3;99;22;0;3;1;2;3;0;3;0;0
2612; 42.6 ; 213.1 ; 30.6 ;5;17;74;0;5;0;5;2;3;2;1;2
2613; 74.3 ; 148.6 ; 31.5 ;2;69;62;0;2;0;2;1;1;0;0;2
2614; 87.1 ; 174.2 ; 1.0 ;2;157;197;0;2;2;0;0;2;0;0;2
2615; 45.7 ; 91.5 ; 4.3 ;2;58;204;0;2;0;2;1;1;0;2;0
2616; 51.1 ; 357.4 ; 10.1 ;7;30;151;0;7;3;4;2;5;0;5;2
2617; 16.4 ; 32.8 ; 2.1 ;2;68;219;0;2;2;0;1;1;2;0;0
2618; 18.9 ; 245.6 ; 3.4 ;13;9;10;0;13;5;8;11;2;13;0;0
2619; 58.2 ; 116.4 ; 6.4 ;2;31;0;0;2;0;2;2;0;0;0;2
2620; 15.6 ; 77.9 ; 1.6 ;5;39;137;0;5;1;4;2;3;5;0;0
2621; 42.5 ; 339.9 ; 8.1 ;8;37;12;0;8;0;8;7;1;0;8;0
2622; 57.3 ; 114.5 ; 26.6 ;2;192;97;0;2;1;1;2;0;0;0;2
2623; 42.9 ; 85.8 ; 1.6 ;2;12;254;0;2;2;0;0;2;0;2;0
2624; 36.5 ; 73.0 ; 2.6 ;2;5;47;0;2;0;2;1;1;0;2;0
2625; 24.7 ; 123.6 ; 10.4 ;5;36;11;4;1;1;4;1;4;3;2;0
2626; 17.0 ; 85.0 ; 4.8 ;5;90;56;0;5;2;3;2;3;5;0;0
2627; 31.5 ; 503.9 ; 20.5 ;16;12;2;0;16;5;11;9;7;5;11;0
2628; 36.6 ; 73.2 ; -   ;2;81;26;1;1;1;1;2;0;0;2;0
2629; 29.4 ; 117.4 ; 21.2 ;4;11;74;0;4;0;4;4;0;3;1;0
2630; 34.0 ; 237.8 ; 17.7 ;7;45;15;0;7;0;7;6;1;2;5;0
2631; 28.1 ; 84.2 ; 10.8 ;3;41;209;0;3;1;2;3;0;2;1;0
2632; 47.8 ; 95.7 ; 0.5 ;2;18;15;0;2;0;2;1;1;0;2;0
2633; 42.5 ; 467.1 ; 8.6 ;11;20;26;11;0;4;7;3;8;0;11;0
2634; 15.8 ; 79.1 ; 2.2 ;5;23;59;0;5;2;3;4;1;5;0;0
2635; 33.3 ; 66.6 ; 18.8 ;2;215;0;0;2;1;1;0;2;1;1;0
2636; 29.5 ; 58.9 ; 2.6 ;2;157;47;0;2;0;2;1;1;1;1;0
2637; 31.2 ; 62.5 ; 24.3 ;2;236;70;0;2;2;0;1;1;1;0;1
2638; 33.9 ; 509.2 ; 16.4 ;15;5;280;0;15;5;10;6;9;5;10;0
2639; 25.1 ; 75.2 ; -   ;3;9;116;0;3;0;3;2;1;3;0;0
2640; 31.3 ; 156.7 ; 3.2 ;5;31;178;0;5;2;3;2;3;2;3;0
2641; 25.8 ; 51.6 ; 16.2 ;2;321;83;0;2;0;2;1;1;1;1;0
2642; 50.8 ; 254.2 ; 9.9 ;5;26;215;0;5;4;1;2;3;0;3;2
2643; 27.0 ; 107.9 ; 14.6 ;4;92;32;0;4;0;4;2;2;3;1;0
2644; 48.7 ; 97.5 ; 34.6 ;2;14;142;0;2;1;1;1;1;1;0;1
2645; 21.8 ; 87.0 ; 6.0 ;4;8;340;0;4;2;2;1;3;4;0;0
2646; 49.5 ; 99.0 ; 9.9 ;2;6;393;0;2;0;2;0;2;0;1;1
2647; 28.4 ; 198.5 ; 7.9 ;7;14;96;0;7;2;5;7;0;5;2;0
2648; 57.6 ; 4,431.6 ; 30.9 ;77;5;10;0;77;23;54;49;28;26;0;51
2649; 18.9 ; 207.4 ; 10.2 ;11;20;2;0;11;7;4;1;10;11;0;0
2650; 41.4 ; 289.5 ; 21.8 ;7;32;26;0;7;0;7;5;2;2;3;2
2651; 81.2 ; 162.4 ; 29.2 ;2;227;68;0;2;0;2;1;1;0;0;2
2652; 62.7 ; 188.1 ; 11.3 ;3;31;215;0;3;0;3;2;1;0;0;3
2653; 82.4 ; 247.1 ; 54.8 ;3;121;152;1;2;2;1;2;1;1;0;2
2654; 25.1 ; 50.1 ; -   ;2;1;189;0;2;1;1;0;2;2;0;0
2655; 31.2 ; 62.5 ; 24.3 ;2;212;95;0;2;1;1;1;1;1;0;1
2656; 50.0 ; 100.0 ; 4.9 ;2;253;99;1;1;0;2;0;2;0;2;0
2657; 24.3 ; 121.3 ; 8.7 ;5;13;159;0;5;5;0;2;3;3;2;0
2658; 17.1 ; 51.4 ; 3.9 ;3;24;217;0;3;2;1;3;0;3;0;0
2659; 47.1 ; 94.2 ; 0.5 ;2;284;38;1;1;2;0;1;1;0;2;0
2660; 19.3 ; 38.6 ; -   ;2;13;17;0;2;2;0;2;0;2;0;0
2661; 82.1 ; 164.2 ; 1.4 ;2;75;126;0;2;0;2;0;2;0;0;2
2662; 31.7 ; 158.7 ; 8.5 ;5;42;7;0;5;1;4;2;3;2;3;0
2663; 25.0 ; 100.0 ; 7.5 ;4;52;20;0;4;4;0;3;1;3;1;0
2664; 20.8 ; 374.5 ; 7.0 ;18;24;2;0;18;7;11;14;4;18;0;0
2665; 78.2 ; 156.5 ; 17.5 ;2;6;133;2;0;2;0;2;0;0;0;2
2666; 28.9 ; 115.6 ; 14.1 ;4;69;33;0;4;3;1;4;0;3;1;0
2667; 23.1 ; 92.4 ; 17.2 ;4;6;64;0;4;1;3;2;2;3;1;0
2668; 40.2 ; 281.2 ; 20.6 ;7;47;1;0;7;0;7;5;2;2;3;2
2669; 56.1 ; 168.4 ; 35.8 ;3;22;325;0;3;0;3;3;0;1;0;2
2670; 39.5 ; 78.9 ; -   ;2;134;33;0;2;2;0;0;2;0;2;0
2671; 94.9 ; 189.9 ; -   ;2;32;43;1;1;1;1;0;2;0;0;2
2672; 30.1 ; 90.3 ; 17.3 ;3;101;26;0;3;0;3;3;0;1;2;0
2673; 18.0 ; 234.4 ; 9.4 ;13;22;3;0;13;3;10;6;7;13;0;0
2674; 44.9 ; 89.8 ; 3.1 ;2;42;308;0;2;2;0;1;1;0;2;0
2675; 40.7 ; 122.0 ; 6.1 ;3;76;131;0;3;2;1;3;0;0;3;0
2676; 20.2 ; 40.3 ; 7.8 ;2;1;188;2;0;0;2;1;1;2;0;0
2677; 42.9 ; 85.9 ; 5.7 ;2;203;132;0;2;1;1;2;0;0;2;0
2678; 49.9 ; 149.8 ; 14.3 ;3;144;16;0;3;1;2;0;3;0;2;1
2679; 27.3 ; 54.5 ; 11.3 ;2;70;88;0;2;1;1;2;0;1;1;0
2680; 25.8 ; 128.9 ; 0.6 ;5;32;106;0;5;0;5;0;5;5;0;0
2681; 28.6 ; 143.0 ; 3.4 ;5;81;8;0;5;1;4;1;4;3;2;0
2682; 27.5 ; 82.5 ; 4.5 ;3;20;10;0;3;0;3;3;0;2;1;0
2683; 41.4 ; 124.2 ; 7.5 ;3;82;64;2;1;1;2;1;2;0;3;0
2684; 22.1 ; 88.5 ; 8.7 ;4;106;24;0;4;2;2;2;2;3;1;0
2685; 55.8 ; 111.7 ; 6.4 ;2;211;62;0;2;1;1;2;0;0;0;2
2686; 54.4 ; 598.0 ; 4.7 ;11;27;6;0;11;0;11;11;0;0;7;4
2687; 20.5 ; 164.2 ; 4.8 ;8;23;1;0;8;0;8;1;7;8;0;0
2688; 46.8 ; 93.5 ; -   ;2;157;105;0;2;0;2;1;1;0;2;0
2689; 30.4 ; 91.1 ; 19.7 ;3;36;274;0;3;2;1;3;0;1;2;0
2690; 94.5 ; 472.7 ; 26.2 ;5;9;10;0;5;2;3;3;2;0;0;5
2691; 15.0 ; 30.0 ; -   ;2;104;266;0;2;2;0;1;1;2;0;0
2692; 34.3 ; 102.9 ; 13.4 ;3;108;15;0;3;0;3;3;0;1;2;0
2693; 36.8 ; 514.9 ; 18.7 ;14;19;149;0;14;8;6;2;12;5;4;5
2694; 52.1 ; 104.2 ; 8.0 ;2;86;158;0;2;0;2;1;1;0;1;1
2695; 47.2 ; 283.1 ; 8.7 ;6;63;57;0;6;4;2;3;3;0;4;2
2696; 26.4 ; 52.8 ; 12.6 ;2;144;58;0;2;0;2;2;0;1;1;0
2697; 58.5 ; 467.7 ; 25.2 ;8;38;5;0;8;1;7;7;1;0;0;8
2698; 41.0 ; 205.2 ; 23.8 ;5;59;11;0;5;0;5;4;1;2;1;2
2699; 103.3 ; 309.9 ; 43.3 ;3;72;120;0;3;0;3;3;0;0;0;3
2700; 33.3 ; 66.6 ; 27.4 ;2;164;68;0;2;0;2;1;1;1;0;1
2701; 49.6 ; 99.3 ; 4.3 ;2;59;306;0;2;2;0;0;2;0;2;0
2702; 27.3 ; 54.6 ; 18.4 ;2;26;122;0;2;1;1;0;2;1;1;0
2703; 41.0 ; 81.9 ; 16.1 ;2;232;73;0;2;0;2;2;0;1;0;1
2704; 19.7 ; 177.6 ; 5.7 ;9;18;40;0;9;2;7;3;6;9;0;0
2705; 29.6 ; 88.7 ; 18.3 ;3;90;27;0;3;0;3;1;2;2;1;0
2706; 60.4 ; 664.4 ; 16.6 ;11;30;15;0;11;1;10;9;2;0;0;11
2707; 48.7 ; 2,094.7 ; 11.5 ;43;6;44;0;43;20;23;13;30;0;29;14
2708; 66.9 ; 200.6 ; 25.5 ;3;94;110;0;3;0;3;2;1;0;0;3
2709; 19.7 ; 334.2 ; 11.0 ;17;13;26;8;9;9;8;9;8;11;6;0
2710; 25.6 ; 127.8 ; 6.7 ;5;29;110;0;5;0;5;2;3;3;2;0
2711; 30.6 ; 275.2 ; 13.5 ;9;27;26;0;9;1;8;4;5;3;6;0
2712; 40.5 ; 768.6 ; 22.7 ;19;22;5;0;19;4;15;8;11;6;7;6
2713; 29.2 ; 87.5 ; 17.6 ;3;18;68;0;3;1;2;2;1;2;1;0
2714; 46.6 ; 233.0 ; 28.5 ;5;23;215;0;5;0;5;4;1;2;1;2
2715; 93.9 ; 563.3 ; 48.1 ;6;67;11;0;6;1;5;3;3;0;0;6
2716; 86.5 ; 778.8 ; 26.2 ;9;17;47;0;9;0;9;9;0;0;0;9
2717; 58.2 ; 174.5 ; 13.2 ;3;116;78;0;3;0;3;3;0;0;0;3
2718; 33.6 ; 369.4 ; 14.4 ;11;38;10;0;11;0;11;6;5;4;7;0
2719; 35.3 ; 353.1 ; 25.6 ;10;7;137;0;10;5;5;6;4;3;4;3
2720; 46.2 ; 138.7 ; 23.2 ;3;45;93;0;3;1;2;3;0;1;1;1
2721; 94.9 ; 189.8 ; 2.1 ;2;6;179;2;0;0;2;2;0;0;0;2
2722; 20.5 ; 102.4 ; 9.1 ;5;25;11;0;5;3;2;1;4;5;0;0
2723; 108.5 ; 217.0 ; 130.8 ;2;164;119;0;2;1;1;2;0;1;0;1
2724; 17.6 ; 211.8 ; 9.3 ;12;8;216;0;12;5;7;8;4;12;0;0
2725; 37.2 ; 148.6 ; 20.4 ;4;37;197;0;4;3;1;3;1;1;2;1
2726; 22.6 ; 45.2 ; 11.4 ;2;7;89;0;2;0;2;0;2;1;1;0
2727; 30.4 ; 152.2 ; 7.8 ;5;32;158;0;5;0;5;5;0;2;3;0
2728; 42.3 ; 211.3 ; 17.6 ;5;72;1;0;5;2;3;1;4;2;1;2
2729; 19.7 ; 39.3 ; -   ;2;1;120;0;2;0;2;0;2;2;0;0
2730; 24.1 ; 1,373.1 ; 14.9 ;57;6;0;0;57;6;51;25;32;38;19;0
2731; 61.0 ; 122.0 ; 53.8 ;2;264;57;0;2;0;2;2;0;1;0;1
2732; 38.0 ; 76.1 ; 19.4 ;2;46;275;0;2;1;1;1;1;1;0;1
2733; 42.5 ; 127.5 ; 7.8 ;3;101;209;0;3;1;2;3;0;0;3;0
2734; 19.7 ; 39.3 ; -   ;2;87;209;0;2;0;2;2;0;2;0;0
2735; 82.3 ; 329.3 ; 43.7 ;4;86;45;1;3;1;3;3;1;0;0;4
2736; 31.2 ; 717.7 ; 13.7 ;23;12;14;0;23;6;17;3;20;8;15;0
2737; 16.7 ; 83.3 ; 4.4 ;5;22;5;0;5;2;3;0;5;5;0;0
2738; 61.9 ; 866.2 ; 52.5 ;14;28;57;0;14;4;10;7;7;5;0;9
2739; 22.4 ; 583.4 ; 10.6 ;26;11;2;0;26;9;17;13;13;17;9;0
2740; 39.0 ; 195.2 ; 8.3 ;5;86;16;0;5;1;4;1;4;0;5;0
2741; 34.6 ; 623.0 ; 19.0 ;18;15;6;0;18;4;14;12;6;6;12;0
2742; 24.7 ; 74.1 ; 9.1 ;3;5;273;0;3;1;2;1;2;2;1;0
2743; 38.4 ; 76.7 ; 12.6 ;2;69;220;0;2;0;2;2;0;1;1;0
2744; 46.8 ; 140.3 ; -   ;3;61;174;0;3;2;1;1;2;0;3;0
2745; 35.8 ; 286.5 ; 7.2 ;8;11;5;0;8;3;5;6;2;3;5;0
2746; 31.4 ; 62.8 ; 1.8 ;2;236;5;0;2;1;1;1;1;1;1;0
2747; 27.6 ; 82.9 ; 14.9 ;3;38;332;0;3;1;2;1;2;2;1;0
2748; 32.0 ; 64.0 ; 13.2 ;2;170;11;0;2;0;2;2;0;1;1;0
2749; 21.8 ; 152.9 ; 6.4 ;7;41;19;0;7;1;6;1;6;7;0;0
2750; 50.4 ; 151.1 ; 3.2 ;3;104;99;1;2;0;3;2;1;0;3;0
2751; 40.6 ; 121.8 ; 24.0 ;3;126;0;0;3;0;3;2;1;1;1;1
2752; 143.0 ; 715.0 ; 78.0 ;5;49;99;0;5;1;4;2;3;0;0;5
2753; 21.5 ; 64.6 ; 12.0 ;3;38;218;0;3;3;0;2;1;2;1;0
2754; 43.2 ; 172.8 ; 16.2 ;4;48;53;0;4;2;2;4;0;1;2;1
2755; 44.0 ; 176.0 ; 11.4 ;4;47;80;4;0;3;1;1;3;0;3;1
2756; 26.1 ; 965.2 ; 11.4 ;37;6;15;0;37;7;30;31;6;25;12;0
2757; 15.0 ; 30.0 ; -   ;2;5;60;2;0;2;0;0;2;2;0;0
2758; 42.2 ; 84.4 ; 3.2 ;2;168;131;0;2;0;2;1;1;0;2;0
2759; 38.3 ; 153.1 ; 10.4 ;4;63;115;0;4;0;4;2;2;1;3;0
2760; 25.0 ; 100.2 ; 7.5 ;4;16;33;0;4;3;1;1;3;3;1;0
2761; 27.3 ; 136.4 ; 5.8 ;5;25;83;5;0;0;5;3;2;3;2;0
2762; 95.4 ; 190.9 ; 2.9 ;2;48;120;0;2;1;1;2;0;0;0;2
2763; 33.1 ; 165.4 ; 13.4 ;5;61;18;0;5;0;5;1;4;2;3;0
2764; 38.5 ; 76.9 ; 12.4 ;2;20;263;0;2;0;2;1;1;1;1;0
2765; 24.9 ; 49.9 ; 7.9 ;2;122;47;1;1;1;1;1;1;1;1;0
2766; 40.3 ; 241.6 ; 10.3 ;6;6;6;0;6;2;4;2;4;2;4;0
2767; 17.4 ; 487.4 ; 8.7 ;28;9;2;0;28;17;11;6;22;28;0;0
2768; 57.3 ; 114.7 ; 9.9 ;2;17;89;0;2;0;2;2;0;0;0;2
2769; 31.6 ; 63.3 ; 17.9 ;2;124;174;0;2;0;2;1;1;1;1;0
2770; 19.4 ; 58.1 ; 5.5 ;3;38;85;0;3;2;1;3;0;3;0;0
2771; 60.9 ; 243.5 ; 23.2 ;4;60;31;0;4;1;3;2;2;0;0;4
2772; 54.2 ; 108.5 ; 8.3 ;2;126;115;0;2;0;2;2;0;0;1;1
2773; 83.2 ; 166.3 ; 9.8 ;2;25;211;0;2;0;2;1;1;0;0;2
2774; 48.8 ; 97.5 ; 0.9 ;2;23;20;2;0;1;1;1;1;0;2;0
2775; 50.2 ; 351.3 ; 6.2 ;7;18;21;0;7;0;7;5;2;0;5;2
2776; 49.0 ; 490.1 ; 19.4 ;10;37;15;0;10;0;10;6;4;3;4;3
2777; 65.1 ; 130.1 ; 18.8 ;2;113;126;0;2;0;2;2;0;0;0;2
2778; 43.9 ; 131.7 ; 30.3 ;3;65;163;0;3;1;2;3;0;1;1;1
2779; 58.5 ; 526.9 ; 19.7 ;9;25;98;0;9;5;4;4;5;0;0;9
2780; 46.8 ; 140.4 ; 16.7 ;3;9;163;0;3;0;3;0;3;0;2;1
2781; 56.9 ; 113.9 ; 35.4 ;2;100;155;0;2;2;0;2;0;1;0;1
2782; 51.6 ; 258.0 ; 38.9 ;5;14;49;0;5;1;4;2;3;2;1;2
2783; 29.0 ; 145.1 ; 11.6 ;5;50;14;0;5;4;1;3;2;3;2;0
2784; 35.6 ; 71.1 ; 8.0 ;2;15;135;1;1;2;0;0;2;1;1;0
2785; 42.5 ; 212.6 ; 16.5 ;5;13;236;0;5;0;5;2;3;2;1;2
2786; 26.6 ; 79.9 ; 3.4 ;3;20;224;0;3;1;2;2;1;2;1;0
2787; 42.2 ; 674.8 ; 20.0 ;16;12;15;0;16;2;14;9;7;5;6;5
2788; 27.2 ; 81.5 ; 18.1 ;3;189;65;0;3;2;1;2;1;2;1;0
2789; 59.3 ; 237.2 ; 15.3 ;4;63;105;0;4;0;4;1;3;0;0;4
2790; 42.5 ; 85.1 ; 12.1 ;2;232;62;0;2;1;1;0;2;0;2;0
2791; 17.9 ; 107.5 ; 4.3 ;6;31;38;0;6;1;5;2;4;6;0;0
2792; 36.2 ; 181.2 ; 17.8 ;5;50;84;0;5;0;5;2;3;2;3;0
2793; 30.8 ; 61.7 ; 8.6 ;2;20;116;2;0;0;2;0;2;1;1;0
2794; 15.0 ; 30.0 ; -   ;2;40;307;0;2;2;0;0;2;2;0;0
2795; 22.6 ; 90.3 ; 9.3 ;4;25;1;0;4;0;4;2;2;3;1;0
2796; 19.3 ; 96.5 ; -   ;5;5;37;0;5;2;3;1;4;5;0;0
2797; 36.8 ; 147.3 ; 13.6 ;4;20;23;0;4;1;3;3;1;1;3;0
2798; 44.4 ; 221.8 ; 16.7 ;5;80;2;0;5;3;2;4;1;2;1;2
2799; 67.2 ; 537.7 ; 57.8 ;8;35;19;0;8;1;7;3;5;3;0;5
2800; 65.4 ; 261.7 ; 20.9 ;4;95;26;0;4;1;3;0;4;0;0;4
2801; 15.0 ; 45.0 ; -   ;3;45;13;0;3;1;2;0;3;3;0;0
2802; 20.8 ; 208.0 ; 4.4 ;10;10;152;0;10;2;8;5;5;10;0;0
2803; 48.9 ; 293.3 ; 28.1 ;6;49;15;0;6;0;6;6;0;2;2;2
2804; 31.7 ; 127.0 ; 10.4 ;4;27;5;0;4;0;4;1;3;1;3;0
2805; 20.5 ; 472.5 ; 13.1 ;23;11;15;0;23;6;17;23;0;15;8;0
2806; 16.8 ; 33.6 ; 2.7 ;2;37;154;1;1;2;0;0;2;2;0;0
2807; 49.8 ; 99.6 ; 4.6 ;2;27;239;0;2;1;1;0;2;0;2;0
2808; 25.1 ; 50.1 ; -   ;2;14;273;0;2;0;2;0;2;2;0;0
2809; 22.6 ; 45.2 ; 11.4 ;2;95;181;0;2;2;0;0;2;1;1;0
2810; 23.4 ; 140.3 ; 8.4 ;6;17;31;0;6;2;4;4;2;4;2;0
2811; 50.9 ; 560.2 ; 20.4 ;11;30;6;0;11;4;7;4;7;0;7;4
2812; 33.3 ; 66.6 ; 10.7 ;2;18;64;0;2;0;2;0;2;1;1;0
2813; 25.0 ; 125.1 ; 9.5 ;5;5;2;0;5;5;0;5;0;3;2;0
2814; 48.1 ; 818.3 ; 6.6 ;17;18;5;0;17;6;11;15;2;0;17;0
2815; 61.3 ; 122.6 ; 15.6 ;2;6;99;0;2;0;2;2;0;0;0;2
2816; 16.2 ; 857.8 ; 2.4 ;53;7;1;0;53;15;38;45;8;53;0;0
2817; 30.1 ; 120.5 ; 16.9 ;4;16;189;0;4;0;4;4;0;1;3;0
2818; 33.8 ; 67.5 ; 19.5 ;2;32;141;2;0;0;2;2;0;1;1;0
2819; 59.4 ; 356.2 ; 17.7 ;6;52;5;0;6;0;6;4;2;0;0;6
2820; 47.1 ; 94.2 ; 0.5 ;2;47;71;2;0;1;1;1;1;0;2;0
2821; 57.3 ; 1,260.9 ; 33.3 ;22;14;5;0;22;5;17;16;6;7;0;15
2822; 45.2 ; 90.3 ; 3.5 ;2;55;95;0;2;0;2;0;2;0;2;0
2823; 48.2 ; 1,350.2 ; 2.1 ;28;15;10;0;28;3;25;22;6;0;28;0
2824; 50.8 ; 253.8 ; 20.0 ;5;35;126;0;5;0;5;4;1;0;3;2
2825; 48.5 ; 242.5 ; 26.0 ;5;45;135;0;5;5;0;5;0;2;1;2
2826; 72.8 ; 291.4 ; 49.1 ;4;43;44;0;4;1;3;1;3;1;0;3
2827; 87.3 ; 262.0 ; 64.7 ;3;66;5;0;3;0;3;2;1;1;0;2
2828; 17.8 ; 89.0 ; 6.7 ;5;22;16;5;0;2;3;3;2;5;0;0
2829; 15.0 ; 30.0 ; -   ;2;3;259;0;2;2;0;2;0;2;0;0
2830; 47.1 ; 94.2 ; 0.5 ;2;259;40;0;2;2;0;1;1;0;2;0
2831; 54.1 ; 108.3 ; 11.1 ;2;8;266;0;2;1;1;2;0;0;1;1
2832; 37.9 ; 151.8 ; 22.0 ;4;44;167;0;4;1;3;4;0;1;2;1
2833; 41.7 ; 250.2 ; 25.1 ;6;52;80;0;6;1;5;1;5;2;2;2
2834; 76.1 ; 380.7 ; 34.1 ;5;77;58;0;5;0;5;5;0;0;0;5
2835; 58.8 ; 235.0 ; 32.5 ;4;96;94;0;4;1;3;2;2;1;0;3
2836; 44.6 ; 89.1 ; 5.4 ;2;32;4;1;1;1;1;2;0;0;2;0
2837; 51.7 ; 155.2 ; 23.7 ;3;11;361;0;3;2;1;0;3;1;1;1
2838; 17.8 ; 854.8 ; 6.3 ;48;7;0;0;48;8;40;27;21;48;0;0
2839; 29.8 ; 89.3 ; 15.9 ;3;40;38;0;3;1;2;2;1;2;1;0
2840; 23.5 ; 211.7 ; 12.1 ;9;9;262;0;9;4;5;5;4;6;3;0
2841; 22.6 ; 181.0 ; 13.8 ;8;14;72;0;8;6;2;2;6;5;3;0
2842; 47.4 ; 379.2 ; 19.1 ;8;16;23;0;8;4;4;5;3;3;2;3
2843; 85.5 ; 256.6 ; 14.3 ;3;144;41;0;3;0;3;3;0;0;0;3
2844; 27.1 ; 190.0 ; 10.8 ;7;23;15;0;7;0;7;3;4;5;2;0
2845; 17.5 ; 69.8 ; 3.4 ;4;15;59;4;0;3;1;2;2;4;0;0
2846; 66.8 ; 133.6 ; 7.6 ;2;5;272;0;2;0;2;2;0;0;0;2
2847; 26.1 ; 130.4 ; 2.4 ;5;57;15;0;5;0;5;3;2;5;0;0
2848; 38.8 ; 387.6 ; 14.4 ;10;20;12;10;0;10;0;3;7;3;7;0
2849; 42.4 ; 169.8 ; 12.3 ;4;117;22;0;4;0;4;2;2;0;4;0
2850; 58.4 ; 116.7 ; 7.9 ;2;44;127;2;0;0;2;2;0;0;0;2
2851; 46.9 ; 187.5 ; 25.2 ;4;22;217;0;4;3;1;3;1;1;2;1
2852; 41.0 ; 287.1 ; 4.0 ;7;22;5;0;7;5;2;7;0;0;7;0
2853; 65.0 ; 324.8 ; 42.4 ;5;74;94;0;5;0;5;5;0;2;0;3
2854; 28.2 ; 253.9 ; 14.0 ;9;22;14;9;0;9;0;9;0;6;3;0
2855; 36.2 ; 72.5 ; 31.8 ;2;21;299;0;2;1;1;0;2;1;0;1
2856; 31.4 ; 188.2 ; 13.1 ;6;16;54;0;6;2;4;3;3;2;4;0
2857; 24.5 ; 171.3 ; 15.0 ;7;30;113;0;7;5;2;0;7;5;2;0
2858; 34.9 ; 174.5 ; 14.4 ;5;35;110;0;5;2;3;2;3;2;3;0
2859; 17.4 ; 156.3 ; 3.7 ;9;12;4;7;2;5;4;8;1;9;0;0
2860; 32.2 ; 386.2 ; 11.0 ;12;18;90;1;11;6;6;10;2;4;8;0
2861; 112.3 ; 1,235.4 ; 43.0 ;11;28;10;0;11;2;9;10;1;0;0;11
2862; 56.5 ; 282.4 ; 28.9 ;5;25;11;1;4;3;2;3;2;2;0;3
2863; 40.2 ; 120.7 ; 10.3 ;3;76;36;0;3;0;3;2;1;1;2;0
2864; 54.9 ; 329.3 ; 13.9 ;6;35;1;0;6;1;5;3;3;0;4;2
2865; 32.5 ; 162.7 ; 5.6 ;5;30;281;0;5;2;3;0;5;2;3;0
2866; 31.2 ; 93.6 ; 20.4 ;3;59;168;0;3;1;2;3;0;1;2;0
2867; 18.5 ; 296.5 ; 4.6 ;16;25;20;0;16;7;9;5;11;16;0;0
2868; 17.5 ; 315.8 ; 3.9 ;18;22;47;0;18;6;12;6;12;18;0;0
2869; 21.2 ; 63.5 ; 5.0 ;3;87;219;0;3;3;0;1;2;3;0;0
2870; 20.3 ; 182.8 ; 9.7 ;9;16;1;9;0;5;4;2;7;9;0;0
2871; 51.8 ; 673.9 ; 23.8 ;13;14;10;0;13;1;12;12;1;4;5;4
2872; 17.0 ; 237.8 ; 8.2 ;14;20;35;0;14;7;7;7;7;14;0;0
2873; 59.4 ; 356.3 ; 16.8 ;6;53;80;0;6;2;4;4;2;0;0;6
2874; 20.0 ; 40.1 ; 7.6 ;2;37;274;0;2;0;2;0;2;2;0;0
2875; 32.2 ; 451.2 ; 15.0 ;14;18;20;0;14;5;9;12;2;5;9;0
2876; 41.9 ; 460.4 ; 25.0 ;11;30;5;0;11;4;7;5;6;4;3;4
2877; 31.1 ; 155.4 ; 10.0 ;5;61;26;0;5;1;4;2;3;2;3;0
2878; 29.8 ; 59.7 ; 7.8 ;2;8;273;0;2;1;1;0;2;1;1;0
2879; 26.4 ; 132.0 ; 13.9 ;5;59;17;5;0;4;1;1;4;3;2;0
2880; 49.7 ; 248.5 ; 27.5 ;5;22;147;0;5;1;4;5;0;2;1;2
2881; 40.7 ; 81.5 ; 17.3 ;2;36;59;0;2;0;2;0;2;1;0;1
2882; 61.8 ; 308.8 ; 34.7 ;5;27;44;1;4;1;4;3;2;2;0;3
2883; 17.5 ; 70.0 ; 5.3 ;4;15;20;0;4;1;3;2;2;4;0;0
2884; 30.5 ; 91.5 ; 15.6 ;3;18;277;0;3;2;1;1;2;1;2;0
2885; 37.1 ; 74.2 ; 18.0 ;2;16;179;0;2;1;1;1;1;1;0;1
2886; 58.2 ; 291.1 ; 26.6 ;5;54;128;0;5;2;3;1;4;0;0;5
2887; 37.6 ; 1,351.9 ; 13.3 ;36;11;28;0;36;23;13;10;26;12;24;0
2888; 73.0 ; 146.1 ; 36.5 ;2;41;131;0;2;1;1;2;0;0;0;2
2889; 42.0 ; 83.9 ; 7.2 ;2;97;191;0;2;2;0;2;0;0;2;0
2890; 46.5 ; 139.4 ; 17.1 ;3;83;36;0;3;1;2;1;2;1;1;1
2891; 27.1 ; 244.3 ; 14.5 ;9;32;58;0;9;3;6;7;2;6;3;0
2892; 39.2 ; 157.0 ; 16.7 ;4;27;91;0;4;1;3;3;1;1;2;1
2893; 59.8 ; 837.4 ; 37.3 ;14;15;5;14;0;2;12;6;8;5;0;9
2894; 18.7 ; 392.7 ; 5.8 ;21;16;5;0;21;4;17;14;7;21;0;0
2895; 30.0 ; 60.1 ; 22.5 ;2;1;257;0;2;0;2;0;2;1;1;0
2896; 25.1 ; 75.2 ; -   ;3;65;77;0;3;2;1;1;2;3;0;0
2897; 17.6 ; 193.3 ; 5.2 ;11;19;0;0;11;5;6;2;9;11;0;0
2898; 50.9 ; 101.7 ; 1.1 ;2;5;173;0;2;0;2;2;0;0;2;0
2899; 77.3 ; 154.5 ; 7.5 ;2;142;160;0;2;1;1;1;1;0;0;2
2900; 30.3 ; 91.0 ; 16.8 ;3;54;239;0;3;2;1;3;0;1;2;0
2901; 46.4 ; 232.2 ; 5.3 ;5;51;42;0;5;2;3;5;0;0;5;0
2902; 43.1 ; 215.4 ; 13.5 ;5;27;240;0;5;1;4;4;1;2;1;2
2903; 15.0 ; 30.0 ; -   ;2;83;59;0;2;2;0;0;2;2;0;0
2904; 53.2 ; 159.7 ; 10.2 ;3;123;59;0;3;1;2;3;0;0;2;1
2905; 48.8 ; 293.0 ; 31.0 ;6;39;76;0;6;4;2;0;6;2;2;2
2906; 27.5 ; 137.4 ; 13.4 ;5;43;83;0;5;1;4;5;0;3;2;0
2907; 24.7 ; 123.7 ; 9.9 ;5;26;39;0;5;1;4;4;1;3;2;0
2908; 41.3 ; 165.2 ; 19.8 ;4;33;78;0;4;0;4;4;0;1;2;1
2909; 94.1 ; 282.4 ; 1.1 ;3;67;177;0;3;1;2;3;0;0;0;3
2910; 36.6 ; 219.4 ; 12.2 ;6;23;57;0;6;0;6;6;0;2;4;0
2911; 79.2 ; 158.5 ; 19.7 ;2;100;89;0;2;0;2;1;1;0;0;2
2912; 52.1 ; 104.2 ; 8.0 ;2;50;255;0;2;2;0;0;2;0;1;1
2913; 47.8 ; 95.7 ; 0.5 ;2;66;4;0;2;1;1;0;2;0;2;0
2914; 40.7 ; 285.0 ; 6.3 ;7;19;53;7;0;2;5;3;4;0;7;0
2915; 50.5 ; 100.9 ; 20.8 ;2;17;260;0;2;2;0;0;2;1;0;1
2916; 61.9 ; 680.7 ; 22.4 ;11;32;38;4;7;1;10;11;0;0;0;11
2917; 26.5 ; 159.2 ; 2.6 ;6;47;57;0;6;0;6;4;2;6;0;0
2918; 23.1 ; 46.2 ; 3.0 ;2;56;95;2;0;0;2;2;0;2;0;0
2919; 34.2 ; 1,777.3 ; 8.4 ;52;5;5;0;52;32;20;22;30;17;35;0
2920; 17.3 ; 172.7 ; 1.9 ;10;23;163;0;10;0;10;10;0;10;0;0
2921; 58.9 ; 176.7 ; 49.8 ;3;134;68;0;3;1;2;2;1;1;0;2
2922; 38.4 ; 76.7 ; 35.0 ;2;24;149;1;1;2;0;0;2;1;0;1
2923; 22.5 ; 89.8 ; 6.6 ;4;14;128;0;4;3;1;1;3;4;0;0
2924; 42.5 ; 127.6 ; 12.1 ;3;34;189;0;3;2;1;3;0;0;3;0
2925; 40.1 ; 200.3 ; 11.3 ;5;53;5;0;5;2;3;5;0;2;3;0
2926; 28.9 ; 751.2 ; 10.5 ;26;13;0;0;26;1;25;17;9;17;9;0
2927; 31.1 ; 683.3 ; 16.3 ;22;12;58;0;22;7;15;5;17;7;15;0
2928; 43.1 ; 473.7 ; 10.7 ;11;27;8;0;11;6;5;8;3;0;11;0
2929; 32.1 ; 64.1 ; 10.5 ;2;5;352;0;2;0;2;2;0;1;1;0
2930; 35.9 ; 71.8 ; 16.2 ;2;100;189;1;1;0;2;2;0;1;1;0
2931; 70.1 ; 140.3 ; 35.0 ;2;19;183;1;1;0;2;1;1;0;0;2
2932; 20.0 ; 40.1 ; 7.6 ;2;209;84;0;2;0;2;1;1;2;0;0
2933; 72.1 ; 504.4 ; 23.3 ;7;37;1;0;7;0;7;5;2;0;0;7
2934; 28.5 ; 142.5 ; 9.8 ;5;49;72;0;5;1;4;1;4;3;2;0
2935; 108.7 ; 434.8 ; 33.5 ;4;47;32;0;4;2;2;1;3;0;0;4
2936; 23.0 ; 529.8 ; 8.2 ;23;15;1;0;23;14;9;17;6;15;8;0
2937; 42.1 ; 379.2 ; 22.1 ;9;37;32;0;9;3;6;5;4;3;3;3
2938; 47.8 ; 95.7 ; 0.5 ;2;44;16;0;2;0;2;0;2;0;2;0
2939; 25.1 ; 577.9 ; 8.9 ;23;11;5;0;23;11;12;12;11;15;8;0
2940; 19.7 ; 39.3 ; -   ;2;81;38;0;2;1;1;2;0;2;0;0
2941; 20.7 ; 82.9 ; 5.4 ;4;48;94;0;4;0;4;2;2;4;0;0
2942; 52.8 ; 158.3 ; 14.1 ;3;111;5;0;3;1;2;1;2;0;2;1
2943; 48.8 ; 195.4 ; 4.9 ;4;70;78;0;4;0;4;3;1;0;4;0
2944; 51.0 ; 102.1 ; 6.4 ;2;40;194;0;2;1;1;2;0;0;1;1
2945; 32.7 ; 98.0 ; 9.0 ;3;32;95;3;0;2;1;1;2;1;2;0
2946; 54.5 ; 108.9 ; 11.2 ;2;7;261;0;2;1;1;0;2;0;1;1
2947; 66.5 ; 132.9 ; 23.1 ;2;50;72;0;2;2;0;0;2;0;0;2
2948; 81.3 ; 650.1 ; 12.7 ;8;28;10;0;8;0;8;8;0;0;0;8
2949; 100.7 ; 201.4 ; 9.6 ;2;43;199;0;2;0;2;2;0;0;0;2
2950; 53.7 ; 161.0 ; 8.0 ;3;91;110;0;3;0;3;3;0;0;2;1
2951; 51.4 ; 102.7 ; 31.7 ;2;25;99;0;2;0;2;0;2;1;0;1
2952; 54.9 ; 109.9 ; 3.9 ;2;38;278;0;2;0;2;2;0;0;1;1
2953; 125.9 ; 251.8 ; 109.9 ;2;347;104;0;2;0;2;1;1;1;0;1
2954; 32.1 ; 160.4 ; 15.1 ;5;31;16;0;5;1;4;2;3;2;3;0
2955; 113.0 ; 339.1 ; 19.4 ;3;18;215;0;3;0;3;3;0;0;0;3
2956; 29.0 ; 1,246.4 ; 15.8 ;43;8;0;0;43;26;17;24;19;29;14;0
2957; 49.3 ; 147.9 ; 3.1 ;3;48;119;0;3;2;1;2;1;0;3;0
2958; 20.4 ; 61.2 ; 0.6 ;3;40;151;0;3;3;0;3;0;3;0;0
2959; 37.1 ; 185.3 ; 12.1 ;5;34;26;0;5;1;4;2;3;2;3;0
2960; 32.7 ; 65.3 ; 21.1 ;2;95;169;0;2;1;1;1;1;1;1;0
2961; 20.6 ; 164.9 ; 13.0 ;8;32;76;0;8;3;5;2;6;5;3;0
2962; 15.0 ; 45.0 ; -   ;3;32;97;0;3;1;2;1;2;3;0;0
2963; 77.2 ; 926.5 ; 25.4 ;12;27;26;0;12;1;11;8;4;0;0;12
2964; 38.2 ; 76.4 ; 7.0 ;2;117;228;0;2;1;1;2;0;0;2;0
2965; 42.2 ; 126.6 ; 28.0 ;3;5;258;0;3;1;2;3;0;1;1;1
2966; 49.4 ; 98.8 ; 13.4 ;2;19;115;0;2;0;2;1;1;0;1;1
2967; 35.9 ; 71.8 ; 16.2 ;2;132;167;0;2;0;2;1;1;1;1;0
2968; 41.7 ; 83.4 ; 17.3 ;2;68;42;0;2;0;2;2;0;1;0;1
2969; 31.6 ; 63.1 ; -   ;2;16;2;0;2;1;1;0;2;0;2;0
2970; 26.3 ; 131.4 ; 6.8 ;5;63;12;0;5;3;2;2;3;3;2;0
2971; 23.5 ; 46.9 ; 2.4 ;2;6;136;1;1;0;2;1;1;2;0;0
2972; 48.1 ; 96.2 ; 0.9 ;2;214;99;0;2;0;2;1;1;0;2;0
2973; 47.4 ; 142.1 ; 1.1 ;3;13;173;0;3;0;3;2;1;0;3;0
2974; 68.1 ; 544.5 ; 24.5 ;8;15;221;0;8;0;8;5;3;0;0;8
2975; 27.5 ; 220.3 ; 14.0 ;8;23;199;0;8;0;8;8;0;5;3;0
2976; 42.1 ; 84.3 ; 8.3 ;2;25;275;0;2;2;0;0;2;0;2;0
2977; 47.1 ; 612.9 ; 11.1 ;13;23;5;0;13;0;13;12;1;0;9;4
2978; 30.0 ; 59.9 ; -   ;2;212;84;1;1;0;2;1;1;2;0;0
2979; 47.5 ; 142.4 ; 0.8 ;3;148;24;1;2;2;1;2;1;0;3;0
2980; 72.2 ; 216.7 ; 27.3 ;3;4;257;0;3;1;2;3;0;0;0;3
2981; 41.4 ; 82.8 ; 16.8 ;2;391;52;0;2;0;2;1;1;1;0;1
2982; 110.0 ; 220.0 ; 20.5 ;2;32;119;2;0;2;0;0;2;0;0;2
2983; 47.0 ; 141.0 ; 0.4 ;3;36;101;1;2;2;1;1;2;0;3;0
2984; 46.8 ; 93.5 ; -   ;2;23;231;0;2;0;2;2;0;0;2;0
2985; 37.6 ; 301.0 ; 19.7 ;8;23;55;8;0;3;5;3;5;3;2;3
2986; 17.5 ; 280.0 ; 5.2 ;16;22;10;0;16;2;14;6;10;16;0;0
2987; 65.2 ; 130.3 ; 11.5 ;2;81;137;1;1;0;2;1;1;0;0;2
2988; 51.6 ; 515.8 ; 7.5 ;10;24;10;10;0;0;10;10;0;0;7;3
2989; 40.1 ; 120.2 ; 14.6 ;3;40;133;0;3;1;2;3;0;1;2;0
2990; 74.9 ; 299.4 ; 48.9 ;4;45;209;0;4;1;3;4;0;1;0;3
2991; 29.8 ; 89.3 ; 3.6 ;3;72;110;0;3;0;3;3;0;2;1;0
2992; 28.9 ; 144.6 ; 13.0 ;5;18;26;0;5;3;2;3;2;3;2;0
2993; 35.5 ; 71.0 ; 1.6 ;2;218;120;0;2;1;1;2;0;0;2;0
2994; 22.6 ; 45.2 ; 11.4 ;2;48;234;0;2;2;0;2;0;1;1;0
2995; 38.4 ; 76.7 ; 12.6 ;2;2;260;0;2;2;0;1;1;1;1;0
2996; 26.5 ; 212.1 ; 10.0 ;8;46;23;0;8;4;4;6;2;5;3;0
2997; 34.4 ; 68.9 ; 6.7 ;2;126;156;0;2;1;1;0;2;1;1;0
2998; 30.4 ; 60.9 ; 0.7 ;2;225;8;2;0;2;0;2;0;1;1;0
2999; 34.4 ; 309.7 ; 24.9 ;9;26;70;0;9;4;5;5;4;3;3;3
3000; 42.8 ; 684.6 ; 14.9 ;16;19;104;0;16;2;14;10;6;5;6;5
3001; 36.4 ; 72.8 ; 3.6 ;2;20;255;0;2;2;0;1;1;0;2;0
3002; 22.4 ; 560.2 ; 8.5 ;25;13;2;0;25;7;18;18;7;17;8;0
3003; 74.2 ; 1,335.7 ; 14.5 ;18;24;22;0;18;8;10;9;9;0;0;18
3004; 37.7 ; 188.7 ; 17.9 ;5;66;11;0;5;0;5;4;1;2;1;2
3005; 48.4 ; 290.4 ; 27.7 ;6;49;74;0;6;1;5;1;5;2;2;2
3006; 19.3 ; 57.8 ; 5.5 ;3;63;182;0;3;2;1;1;2;3;0;0
3007; 35.9 ; 71.8 ; 16.2 ;2;22;259;0;2;1;1;1;1;1;1;0
3008; 20.4 ; 224.3 ; 8.5 ;11;23;5;0;11;4;7;3;8;11;0;0
3009; 46.0 ; 229.8 ; 9.1 ;5;22;194;0;5;0;5;3;2;0;3;2
3010; 58.2 ; 116.5 ; 7.5 ;2;75;101;0;2;2;0;0;2;0;0;2
3011; 30.0 ; 149.8 ; -   ;5;19;27;0;5;2;3;5;0;5;0;0
3012; 70.3 ; 140.6 ; 34.7 ;2;99;180;0;2;1;1;1;1;0;0;2
3013; 59.5 ; 595.3 ; 18.1 ;10;16;252;0;10;1;9;4;6;0;0;10
3014; 56.0 ; 112.1 ; 1.1 ;2;28;230;0;2;1;1;2;0;0;0;2
3015; 54.8 ; 273.9 ; 10.2 ;5;50;78;0;5;3;2;2;3;0;3;2
3016; 58.3 ; 174.9 ; 18.9 ;3;77;97;0;3;1;2;1;2;0;0;3
3017; 42.6 ; 85.3 ; 9.1 ;2;110;138;0;2;1;1;2;0;0;2;0
3018; 54.7 ; 327.9 ; 40.7 ;6;35;110;0;6;1;5;5;1;2;2;2
3019; 22.4 ; 134.3 ; 6.4 ;6;4;260;0;6;3;3;4;2;6;0;0
3020; 47.1 ; 235.3 ; 13.0 ;5;74;93;1;4;1;4;1;4;0;3;2
3021; 58.8 ; 411.9 ; 12.6 ;7;19;5;6;1;3;4;4;3;0;0;7
3022; 20.1 ; 100.3 ; 8.3 ;5;26;79;0;5;2;3;4;1;5;0;0
3023; 39.8 ; 119.4 ; 26.4 ;3;113;80;0;3;1;2;1;2;1;1;1
3024; 53.9 ; 107.8 ; 2.1 ;2;24;241;0;2;0;2;2;0;0;1;1
3025; 40.5 ; 121.5 ; 5.6 ;3;50;220;0;3;1;2;1;2;0;3;0
3026; 45.8 ; 183.2 ; 6.7 ;4;64;17;0;4;1;3;3;1;0;4;0
3027; 58.2 ; 465.3 ; 23.8 ;8;49;26;0;8;1;7;2;6;0;0;8
3028; 41.8 ; 83.6 ; 15.4 ;2;22;160;0;2;1;1;2;0;1;0;1
3029; 32.6 ; 228.2 ; 30.6 ;7;36;85;0;7;2;5;3;4;2;3;2
3030; 22.7 ; 136.0 ; 6.7 ;6;16;278;0;6;1;5;2;4;6;0;0
3031; 28.8 ; 259.5 ; 26.3 ;9;27;14;0;9;2;7;7;2;6;0;3
3032; 62.2 ; 435.4 ; 24.3 ;7;47;0;0;7;0;7;6;1;0;0;7
3033; 27.6 ; 110.5 ; 3.1 ;4;46;27;4;0;1;3;1;3;3;1;0
3034; 26.8 ; 107.3 ; 9.3 ;4;14;8;0;4;1;3;2;2;3;1;0
3035; 22.7 ; 136.4 ; 9.8 ;6;14;243;0;6;5;1;4;2;4;2;0
3036; 49.0 ; 636.7 ; 19.1 ;13;17;14;13;0;10;3;1;12;4;5;4
3037; 81.5 ; 407.4 ; 15.5 ;5;83;35;0;5;1;4;1;4;0;0;5
3038; 55.2 ; 220.7 ; 26.8 ;4;133;66;0;4;1;3;3;1;1;0;3
3039; 24.6 ; 786.6 ; 6.2 ;32;10;23;0;32;16;16;18;14;21;11;0
3040; 67.5 ; 202.6 ; 14.9 ;3;92;176;0;3;2;1;3;0;0;0;3
3041; 47.5 ; 94.9 ; -   ;2;51;57;0;2;0;2;2;0;0;2;0
3042; 103.0 ; 1,030.0 ; 69.8 ;10;25;4;0;10;6;4;1;9;0;0;10
3043; 23.8 ; 47.5 ; 1.1 ;2;31;135;0;2;2;0;0;2;2;0;0
3044; 43.4 ; 130.1 ; 39.0 ;3;165;34;0;3;3;0;3;0;1;1;1
3045; 35.0 ; 140.0 ; 3.4 ;4;54;141;0;4;1;3;1;3;0;4;0
3046; 59.4 ; 178.2 ; 36.5 ;3;21;133;0;3;2;1;1;2;1;0;2
3047; 28.4 ; 198.8 ; 4.5 ;7;20;40;1;6;4;3;3;4;5;2;0
3048; 35.6 ; 71.1 ; 8.0 ;2;101;89;1;1;0;2;1;1;1;1;0
3049; 39.6 ; 237.4 ; 11.9 ;6;9;218;0;6;2;4;5;1;2;4;0
3050; 19.8 ; 59.3 ; 6.4 ;3;97;223;0;3;3;0;3;0;3;0;0
3051; 15.0 ; 59.9 ; -   ;4;16;244;0;4;1;3;4;0;4;0;0
3052; 39.3 ; 78.6 ; 27.2 ;2;75;230;0;2;0;2;1;1;1;0;1
3053; 30.9 ; 61.7 ; 23.8 ;2;6;266;0;2;2;0;0;2;1;1;0
3054; 36.6 ; 329.3 ; -   ;9;40;5;0;9;4;5;1;8;0;9;0
3055; 44.4 ; 133.2 ; 31.2 ;3;88;68;0;3;1;2;1;2;1;1;1
3056; 17.3 ; 502.6 ; 4.9 ;29;11;16;0;29;0;29;29;0;29;0;0
3057; 34.2 ; 171.0 ; 16.1 ;5;14;233;0;5;4;1;2;3;2;3;0
3058; 50.9 ; 101.8 ; 31.3 ;2;37;29;0;2;2;0;2;0;1;0;1
3059; 42.6 ; 170.5 ; 25.7 ;4;29;206;0;4;1;3;2;2;1;2;1
3060; 53.5 ; 374.7 ; 4.9 ;7;12;31;0;7;0;7;6;1;0;5;2
3061; 50.5 ; 403.8 ; 40.9 ;8;23;73;0;8;0;8;6;2;3;2;3
3062; 15.8 ; 31.7 ; -   ;2;1;134;0;2;2;0;1;1;2;0;0
3063; 20.0 ; 40.1 ; 7.6 ;2;167;126;0;2;1;1;1;1;2;0;0
3064; 26.1 ; 601.2 ; 11.6 ;23;18;22;0;23;17;6;11;12;15;8;0
3065; 47.1 ; 94.2 ; 0.5 ;2;221;76;0;2;2;0;0;2;0;2;0
3066; 70.1 ; 140.3 ; 35.0 ;2;38;246;0;2;0;2;2;0;0;0;2
3067; 58.9 ; 117.8 ; 3.2 ;2;13;169;0;2;0;2;1;1;0;0;2
3068; 69.1 ; 760.6 ; 22.4 ;11;17;59;0;11;3;8;4;7;0;0;11
3069; 15.0 ; 59.9 ; -   ;4;18;137;0;4;0;4;1;3;4;0;0
3070; 34.4 ; 172.1 ; 20.2 ;5;51;101;0;5;1;4;0;5;2;3;0
3071; 20.2 ; 40.4 ; 0.3 ;2;13;108;0;2;2;0;2;0;2;0;0
3072; 24.1 ; 869.0 ; 9.4 ;36;8;4;0;36;27;9;10;26;24;12;0
3073; 41.7 ; 83.4 ; 7.6 ;2;137;121;0;2;0;2;2;0;0;2;0
3074; 61.5 ; 123.0 ; 21.0 ;2;7;62;0;2;0;2;0;2;0;0;2
3075; 17.5 ; 122.6 ; 4.9 ;7;5;0;0;7;1;6;3;4;7;0;0
3076; 40.7 ; 2,887.1 ; 33.5 ;71;4;2;0;71;33;38;47;24;24;23;24
3077; 30.2 ; 60.4 ; -   ;2;45;93;0;2;1;1;2;0;0;2;0
3078; 18.6 ; 37.2 ; -   ;2;11;365;0;2;2;0;2;0;2;0;0
3079; 55.4 ; 166.1 ; 7.8 ;3;31;215;0;3;0;3;2;1;0;0;3
3080; 53.4 ; 106.8 ; 1.4 ;2;126;245;0;2;1;1;2;0;0;2;0
3081; 39.2 ; 196.0 ; 8.6 ;5;33;124;0;5;2;3;3;2;0;5;0
3082; 36.3 ; 362.7 ; 11.0 ;10;22;53;0;10;0;10;10;0;3;7;0
3083; 44.5 ; 178.1 ; 12.6 ;4;21;63;0;4;0;4;3;1;0;3;1
3084; 60.2 ; 120.4 ; 20.2 ;2;146;180;0;2;2;0;1;1;0;0;2
3085; 53.9 ; 107.8 ; 2.1 ;2;15;146;0;2;1;1;2;0;0;1;1
3086; 44.9 ; 89.8 ; 2.7 ;2;68;92;2;0;2;0;2;0;0;2;0
3087; 28.4 ; 85.3 ; 18.9 ;3;83;41;0;3;2;1;1;2;2;1;0
3088; 35.9 ; 466.4 ; 16.7 ;13;23;2;0;13;5;8;4;9;4;9;0
3089; 38.6 ; 347.8 ; 11.4 ;9;24;2;0;9;1;8;7;2;3;6;0
3090; 42.9 ; 85.9 ; 8.6 ;2;12;27;0;2;0;2;1;1;0;2;0
3091; 41.9 ; 418.6 ; 16.2 ;10;6;83;0;10;5;5;5;5;3;4;3
3092; 37.7 ; 75.4 ; 0.8 ;2;203;3;0;2;1;1;2;0;0;2;0
3093; 42.0 ; 83.9 ; 7.2 ;2;8;368;0;2;1;1;2;0;0;2;0
3094; 18.8 ; 357.2 ; 9.8 ;19;13;12;0;19;16;3;8;11;19;0;0
3095; 54.6 ; 109.2 ; 10.7 ;2;201;99;0;2;0;2;2;0;0;1;1
3096; 37.3 ; 186.3 ; 10.9 ;5;23;5;0;5;2;3;2;3;2;3;0
3097; 38.4 ; 76.9 ; 13.5 ;2;62;104;0;2;2;0;0;2;1;1;0
3098; 30.5 ; 152.6 ; 18.7 ;5;64;5;0;5;1;4;2;3;2;3;0
3099; 34.5 ; 172.5 ; 15.9 ;5;69;5;0;5;0;5;0;5;2;3;0
3100; 46.8 ; 140.3 ; -   ;3;72;205;0;3;1;2;3;0;0;3;0
3101; 95.7 ; 191.4 ; 70.4 ;2;158;161;0;2;2;0;2;0;1;0;1
3102; 17.1 ; 34.2 ; 3.2 ;2;108;71;0;2;2;0;1;1;2;0;0
3103; 48.4 ; 145.1 ; 18.7 ;3;132;47;0;3;0;3;3;0;1;1;1
3104; 74.0 ; 592.1 ; 70.7 ;8;25;31;0;8;0;8;8;0;3;0;5
3105; 32.6 ; 65.3 ; 22.2 ;2;232;28;0;2;1;1;0;2;1;1;0
3106; 44.4 ; 133.1 ; 6.5 ;3;178;64;0;3;0;3;1;2;0;3;0
3107; 44.2 ; 88.4 ; 21.0 ;2;53;59;0;2;1;1;2;0;1;0;1
3108; 46.6 ; 186.4 ; 0.2 ;4;12;370;0;4;4;0;1;3;0;4;0
3109; 16.6 ; 33.1 ; 1.8 ;2;1;184;0;2;0;2;2;0;2;0;0
3110; 19.3 ; 38.6 ; -   ;2;5;341;0;2;1;1;2;0;2;0;0
3111; 50.5 ; 100.9 ; 2.8 ;2;11;108;2;0;2;0;0;2;0;2;0
3112; 60.3 ; 120.5 ; 20.2 ;2;35;220;0;2;1;1;1;1;0;0;2
3113; 21.5 ; 344.6 ; 12.4 ;16;13;26;0;16;3;13;6;10;11;5;0
3114; 38.8 ; 155.2 ; 43.6 ;4;54;14;3;1;4;0;2;2;1;2;1
3115; 25.8 ; 51.6 ; 16.2 ;2;52;206;0;2;2;0;1;1;1;1;0
3116; 77.9 ; 545.4 ; 77.0 ;7;31;62;0;7;0;7;7;0;2;0;5
3117; 64.7 ; 129.3 ; 10.7 ;2;13;262;0;2;0;2;2;0;0;0;2
3118; 23.3 ; 93.2 ; 17.6 ;4;2;5;0;4;0;4;1;3;3;1;0
3119; 33.2 ; 66.4 ; 14.5 ;2;73;148;0;2;1;1;1;1;1;1;0
3120; 21.8 ; 43.7 ; 4.9 ;2;2;299;0;2;1;1;0;2;2;0;0
3121; 22.3 ; 44.5 ; 3.3 ;2;22;208;0;2;1;1;0;2;2;0;0
3122; 15.0 ; 45.0 ; -   ;3;14;85;0;3;2;1;1;2;3;0;0
3123; 24.4 ; 121.9 ; 15.0 ;5;48;22;0;5;2;3;3;2;3;2;0
3124; 24.8 ; 49.6 ; 14.7 ;2;19;149;2;0;2;0;0;2;1;1;0
3125; 23.6 ; 70.9 ; 6.9 ;3;49;55;0;3;1;2;2;1;2;1;0
3126; 37.9 ; 530.5 ; 18.3 ;14;19;76;0;14;9;5;6;8;5;4;5
3127; 19.5 ; 214.3 ; 6.8 ;11;21;158;0;11;9;2;8;3;11;0;0
3128; 38.0 ; 152.1 ; 30.7 ;4;54;46;4;0;4;0;1;3;1;2;1
3129; 40.4 ; 202.0 ; 9.9 ;5;62;5;1;4;2;3;1;4;0;5;0
3130; 31.9 ; 319.2 ; 22.7 ;10;36;83;0;10;5;5;5;5;3;7;0
3131; 22.3 ; 111.3 ; 7.5 ;5;14;57;0;5;1;4;3;2;5;0;0
3132; 29.6 ; 59.3 ; 6.8 ;2;56;56;0;2;2;0;1;1;1;1;0
3133; 38.1 ; 763.0 ; 25.9 ;20;14;47;0;20;11;9;15;5;7;6;7
3134; 32.4 ; 97.1 ; 13.2 ;3;40;191;0;3;2;1;1;2;1;2;0
3135; 34.3 ; 171.7 ; 9.9 ;5;23;64;0;5;1;4;1;4;2;3;0
3136; 40.2 ; 80.5 ; 20.5 ;2;30;2;0;2;1;1;1;1;1;0;1
3137; 21.4 ; 42.7 ; 4.2 ;2;61;82;2;0;2;0;2;0;2;0;0
3138; 22.0 ; 88.0 ; 7.3 ;4;48;217;0;4;2;2;2;2;4;0;0
3139; 43.8 ; 263.0 ; 15.4 ;6;23;157;0;6;4;2;1;5;2;2;2
3140; 29.8 ; 89.3 ; 21.5 ;3;64;29;0;3;2;1;2;1;2;1;0
3141; 30.2 ; 150.8 ; 16.9 ;5;64;7;0;5;1;4;5;0;2;3;0
3142; 55.0 ; 165.0 ; 50.3 ;3;56;120;0;3;1;2;2;1;1;0;2
3143; 21.4 ; 85.6 ; 8.1 ;4;46;71;0;4;1;3;2;2;4;0;0
3144; 56.8 ; 170.3 ; 34.1 ;3;11;80;0;3;0;3;0;3;1;0;2
3145; 24.0 ; 95.9 ; 3.1 ;4;29;65;0;4;1;3;2;2;4;0;0
3146; 25.7 ; 128.4 ; 1.4 ;5;74;26;0;5;1;4;3;2;5;0;0
3147; 26.6 ; 399.3 ; 11.1 ;15;5;11;0;15;3;12;7;8;10;5;0
3148; 30.6 ; 61.2 ; 0.9 ;2;221;10;0;2;0;2;2;0;1;1;0
3149; 46.8 ; 93.5 ; -   ;2;32;174;0;2;1;1;0;2;0;2;0
3150; 32.5 ; 162.4 ; 33.3 ;5;75;26;0;5;1;4;3;2;2;1;2
3151; 60.3 ; 422.3 ; 26.1 ;7;20;36;0;7;2;5;5;2;0;0;7
3152; 38.1 ; 228.8 ; 19.4 ;6;41;83;0;6;0;6;3;3;2;2;2
3153; 40.5 ; 81.0 ; 15.8 ;2;12;254;0;2;2;0;2;0;1;0;1
3154; 32.4 ; 97.2 ; 8.5 ;3;77;155;0;3;1;2;1;2;1;2;0
3155; 48.1 ; 577.7 ; 9.8 ;12;26;15;0;12;2;10;9;3;0;8;4
3156; 33.7 ; 134.7 ; 8.2 ;4;75;92;0;4;1;3;2;2;1;3;0
3157; 38.5 ; 76.9 ; 12.4 ;2;299;26;0;2;1;1;2;0;1;1;0
3158; 37.6 ; 225.6 ; 9.8 ;6;39;15;0;6;2;4;6;0;2;4;0
3159; 20.0 ; 40.1 ; 7.6 ;2;50;74;0;2;0;2;2;0;2;0;0
3160; 19.3 ; 57.9 ; 6.1 ;3;25;232;0;3;1;2;2;1;3;0;0
3161; 60.9 ; 548.5 ; 17.1 ;9;14;33;0;9;1;8;8;1;0;0;9
3162; 35.5 ; 248.4 ; 26.9 ;7;32;99;0;7;0;7;7;0;2;3;2
3163; 31.0 ; 1,054.0 ; 7.0 ;34;10;51;0;34;19;15;5;29;11;23;0
3164; 42.9 ; 85.7 ; -   ;2;86;273;0;2;1;1;2;0;0;2;0
3165; 43.8 ; 306.9 ; 12.1 ;7;51;11;0;7;5;2;1;6;0;5;2
3166; 43.1 ; 86.2 ; 3.5 ;2;55;38;0;2;0;2;0;2;0;2;0
3167; 21.4 ; 471.1 ; 10.9 ;22;10;8;0;22;5;17;9;13;15;7;0
3168; 22.5 ; 44.9 ; 11.2 ;2;2;264;0;2;2;0;1;1;1;1;0
3169; 57.1 ; 114.3 ; 15.5 ;2;64;120;0;2;0;2;0;2;0;0;2
3170; 35.6 ; 178.0 ; 9.0 ;5;46;77;0;5;0;5;4;1;2;3;0
3171; 15.0 ; 59.9 ; -   ;4;2;149;0;4;3;1;4;0;4;0;0
3172; 58.2 ; 116.3 ; 4.5 ;2;232;95;0;2;0;2;1;1;0;0;2
3173; 64.2 ; 577.8 ; 29.6 ;9;41;32;0;9;1;8;7;2;0;0;9
3174; 43.6 ; 261.6 ; 22.1 ;6;16;289;0;6;0;6;4;2;2;2;2
3175; 27.4 ; 109.7 ; 10.4 ;4;6;209;0;4;0;4;4;0;3;1;0
3176; 15.0 ; 30.0 ; -   ;2;6;278;0;2;0;2;1;1;2;0;0
3177; 18.0 ; 36.1 ; 4.6 ;2;47;86;0;2;2;0;0;2;2;0;0
3178; 35.4 ; 318.2 ; 19.0 ;9;44;5;0;9;0;9;7;2;3;6;0
3179; 33.7 ; 67.5 ; 5.7 ;2;89;224;0;2;1;1;1;1;1;1;0
3180; 18.7 ; 93.7 ; 6.2 ;5;44;119;0;5;3;2;5;0;5;0;0
3181; 26.9 ; 134.7 ; 3.2 ;5;23;31;0;5;0;5;4;1;3;2;0
3182; 19.5 ; 58.6 ; 5.4 ;3;119;5;0;3;1;2;0;3;3;0;0
3183; 34.8 ; 139.2 ; 11.1 ;4;2;270;0;4;4;0;0;4;1;3;0
3184; 36.6 ; 73.2 ; -   ;2;18;125;0;2;1;1;2;0;0;2;0
3185; 46.4 ; 92.7 ; 14.6 ;2;151;173;0;2;0;2;1;1;0;1;1
3186; 56.9 ; 1,307.9 ; 29.1 ;23;19;5;0;23;4;19;16;7;8;0;15
3187; 70.5 ; 1,057.7 ; 18.8 ;15;22;36;0;15;5;10;3;12;0;0;15
3188; 40.2 ; 482.6 ; 17.1 ;12;34;5;0;12;4;8;9;3;4;4;4
3189; 28.1 ; 84.3 ; 18.7 ;3;133;17;0;3;1;2;0;3;2;1;0
3190; 29.3 ; 146.4 ; 15.9 ;5;27;161;0;5;1;4;4;1;3;2;0
3191; 20.7 ; 62.2 ; 4.0 ;3;59;62;0;3;3;0;3;0;3;0;0
3192; 61.3 ; 183.9 ; 13.8 ;3;34;116;0;3;1;2;2;1;0;0;3
3193; 32.2 ; 64.3 ; 22.9 ;2;24;53;0;2;0;2;1;1;1;0;1
3194; 24.1 ; 48.2 ; 9.1 ;2;56;38;0;2;0;2;2;0;1;1;0
3195; 37.5 ; 112.4 ; 20.6 ;3;92;9;0;3;1;2;3;0;1;1;1
3196; 15.0 ; 30.0 ; -   ;2;1;173;0;2;0;2;0;2;2;0;0
3197; 22.5 ; 44.9 ; 11.2 ;2;7;263;0;2;0;2;0;2;1;1;0
3198; 27.6 ; 138.1 ; 3.0 ;5;58;2;0;5;2;3;4;1;3;2;0
3199; 30.2 ; 60.4 ; -   ;2;18;376;0;2;2;0;2;0;0;2;0
3200; 18.3 ; 55.0 ; 6.2 ;3;14;380;0;3;2;1;3;0;3;0;0
3201; 15.0 ; 30.0 ; -   ;2;5;57;2;0;0;2;2;0;2;0;0
3202; 25.6 ; 281.4 ; 20.6 ;11;41;11;0;11;4;7;7;4;7;4;0
3203; 35.5 ; 177.6 ; 11.1 ;5;72;78;0;5;0;5;1;4;2;3;0
3204; 32.5 ; 130.2 ; 6.5 ;4;39;24;0;4;3;1;4;0;1;3;0
3205; 26.6 ; 691.5 ; 13.1 ;26;9;5;0;26;10;16;13;13;17;9;0
3206; 38.7 ; 542.0 ; 21.0 ;14;23;5;0;14;2;12;9;5;5;4;5
3207; 20.7 ; 82.7 ; 7.0 ;4;7;254;0;4;1;3;4;0;4;0;0
3208; 31.4 ; 157.0 ; 13.2 ;5;23;116;0;5;3;2;3;2;2;3;0
3209; 46.7 ; 420.1 ; 3.8 ;9;23;22;0;9;1;8;2;7;0;9;0
3210; 42.3 ; 381.0 ; 9.2 ;9;35;16;0;9;2;7;3;6;0;9;0
3211; 23.7 ; 212.9 ; 17.6 ;9;22;78;0;9;0;9;5;4;6;3;0
3212; 24.4 ; 97.5 ; 4.6 ;4;78;14;4;0;1;3;3;1;4;0;0
3213; 31.3 ; 281.4 ; 10.1 ;9;14;7;0;9;3;6;3;6;3;6;0
3214; 48.9 ; 146.7 ; 4.0 ;3;7;99;3;0;0;3;1;2;0;3;0
3215; 37.2 ; 148.8 ; 14.8 ;4;16;17;0;4;2;2;0;4;1;3;0
3216; 78.1 ; 546.7 ; 53.8 ;7;29;127;0;7;4;3;3;4;2;0;5
3217; 36.4 ; 181.9 ; 20.6 ;5;52;46;5;0;2;3;2;3;2;1;2
3218; 74.5 ; 149.0 ; 56.8 ;2;1;215;2;0;1;1;0;2;1;0;1
3219; 86.4 ; 172.7 ; 21.8 ;2;90;160;0;2;1;1;2;0;0;0;2
3220; 38.5 ; 76.9 ; 12.4 ;2;49;132;0;2;0;2;2;0;1;1;0
3221; 16.9 ; 84.7 ; 4.6 ;5;32;239;0;5;4;1;5;0;5;0;0
3222; 56.0 ; 280.2 ; -   ;5;22;26;5;0;1;4;4;1;0;0;5
3223; 52.5 ; 105.0 ; -   ;2;248;120;0;2;0;2;2;0;0;2;0
3224; 23.2 ; 162.2 ; 10.6 ;7;62;6;0;7;4;3;1;6;5;2;0
3225; 22.6 ; 45.2 ; 11.4 ;2;188;71;0;2;2;0;0;2;1;1;0
3226; 30.6 ; 214.3 ; 12.1 ;7;39;41;0;7;1;6;5;2;2;5;0
3227; 34.0 ; 67.9 ; 13.3 ;2;39;235;0;2;1;1;1;1;1;1;0
3228; 72.2 ; 144.4 ; 29.4 ;2;5;206;0;2;0;2;2;0;0;0;2
3229; 51.5 ; 257.7 ; 4.2 ;5;68;26;0;5;0;5;5;0;0;3;2
3230; 51.1 ; 102.2 ; 17.4 ;2;17;279;0;2;0;2;0;2;0;1;1
3231; 32.7 ; 65.4 ; 18.3 ;2;315;5;0;2;0;2;2;0;1;1;0
3232; 49.9 ; 899.0 ; 7.7 ;18;16;26;0;18;0;18;14;4;0;12;6
3233; 18.6 ; 37.2 ; -   ;2;40;257;0;2;0;2;0;2;2;0;0
3234; 48.4 ; 96.9 ; 0.4 ;2;71;5;0;2;1;1;0;2;0;2;0
3235; 53.6 ; 697.4 ; 7.6 ;13;23;15;0;13;1;12;12;1;0;9;4
3236; 50.5 ; 201.9 ; 4.3 ;4;40;31;0;4;0;4;2;2;0;4;0
3237; 41.6 ; 166.5 ; 8.8 ;4;104;101;0;4;2;2;2;2;0;4;0
3238; 60.2 ; 120.4 ; 11.0 ;2;31;116;0;2;0;2;0;2;0;0;2
3239; 32.7 ; 360.2 ; 23.4 ;11;21;15;0;11;7;4;3;8;4;3;4
3240; 31.6 ; 158.1 ; 19.9 ;5;35;57;0;5;2;3;4;1;2;3;0
3241; 59.6 ; 119.3 ; 18.2 ;2;65;88;0;2;1;1;1;1;0;0;2
3242; 55.4 ; 110.9 ; 9.1 ;2;95;84;1;1;0;2;0;2;0;0;2
3243; 26.1 ; 52.3 ; -   ;2;30;170;0;2;1;1;1;1;2;0;0
3244; 111.0 ; 333.0 ; 45.6 ;3;85;88;0;3;1;2;2;1;0;0;3
3245; 36.4 ; 72.9 ; 15.4 ;2;5;194;0;2;1;1;1;1;1;1;0
3246; 73.4 ; 220.2 ; 6.1 ;3;41;152;3;0;1;2;1;2;0;0;3
3247; 41.4 ; 82.7 ; 16.7 ;2;27;93;0;2;1;1;2;0;1;0;1
3248; 34.9 ; 104.8 ; 15.2 ;3;230;5;0;3;0;3;3;0;1;2;0
3249; 51.9 ; 103.9 ; 13.6 ;2;109;112;0;2;2;0;1;1;0;1;1
3250; 69.9 ; 209.8 ; 23.7 ;3;25;15;0;3;1;2;2;1;0;0;3
3251; 41.7 ; 83.4 ; 7.6 ;2;31;163;0;2;0;2;1;1;0;2;0
3252; 27.6 ; 55.3 ; 3.8 ;2;5;74;2;0;0;2;0;2;1;1;0
3253; 28.1 ; 112.5 ; 21.3 ;4;48;47;0;4;0;4;4;0;3;1;0
3254; 26.2 ; 104.9 ; 7.9 ;4;6;32;0;4;1;3;4;0;3;1;0
3255; 45.6 ; 136.9 ; 28.2 ;3;101;99;0;3;0;3;3;0;1;1;1
3256; 51.1 ; 204.4 ; 5.4 ;4;72;92;0;4;2;2;4;0;0;3;1
3257; 19.0 ; 171.1 ; 8.2 ;9;32;108;0;9;5;4;3;6;9;0;0
3258; 47.2 ; 141.7 ; 0.9 ;3;153;0;0;3;1;2;3;0;0;3;0
3259; 66.0 ; 131.9 ; 3.8 ;2;187;168;0;2;0;2;0;2;0;0;2
3260; 29.8 ; 208.9 ; 11.9 ;7;47;17;0;7;5;2;4;3;5;2;0
3261; 15.0 ; 30.0 ; -   ;2;142;26;0;2;1;1;0;2;2;0;0
3262; 16.5 ; 82.7 ; 4.0 ;5;37;232;0;5;1;4;2;3;5;0;0
3263; 46.8 ; 140.3 ; -   ;3;5;246;0;3;1;2;3;0;0;3;0
3264; 35.2 ; 317.1 ; 7.9 ;9;41;14;0;9;4;5;6;3;3;6;0
3265; 24.1 ; 96.4 ; 6.8 ;4;66;86;0;4;1;3;2;2;3;1;0
3266; 19.4 ; 426.9 ; 4.7 ;22;5;9;0;22;11;11;8;14;22;0;0
3267; 20.0 ; 40.1 ; 7.6 ;2;14;223;0;2;2;0;1;1;2;0;0
3268; 30.5 ; 426.7 ; 9.0 ;14;14;81;0;14;6;8;8;6;5;9;0
3269; 47.6 ; 1,093.8 ; 4.4 ;23;14;11;0;23;2;21;20;3;0;23;0
3270; 20.0 ; 40.1 ; 7.6 ;2;3;281;0;2;1;1;0;2;2;0;0
3271; 27.8 ; 166.9 ; 6.0 ;6;8;5;0;6;3;3;0;6;4;2;0
3272; 23.5 ; 47.0 ; 0.7 ;2;41;22;0;2;0;2;2;0;2;0;0
3273; 58.2 ; 291.0 ; 18.8 ;5;37;165;0;5;2;3;3;2;0;0;5
3274; 22.8 ; 113.9 ; 6.0 ;5;14;36;0;5;2;3;3;2;5;0;0
3275; 37.7 ; 263.6 ; 29.3 ;7;29;59;0;7;6;1;5;2;2;3;2
3276; 32.9 ; 197.7 ; 36.2 ;6;30;96;0;6;6;0;6;0;2;2;2
3277; 52.4 ; 314.7 ; 4.5 ;6;47;15;0;6;1;5;4;2;0;4;2
3278; 17.9 ; 410.7 ; 7.0 ;23;10;116;0;23;8;15;19;4;23;0;0
3279; 65.8 ; 394.7 ; 25.4 ;6;43;2;0;6;1;5;4;2;0;0;6
3280; 48.2 ; 144.6 ; -   ;3;7;1;3;0;1;2;1;2;0;3;0
3281; 73.3 ; 146.5 ; 64.5 ;2;17;74;0;2;0;2;2;0;1;0;1
3282; 37.7 ; 113.0 ; 15.8 ;3;132;110;0;3;1;2;1;2;1;2;0
3283; 41.2 ; 123.7 ; 10.1 ;3;14;254;0;3;2;1;3;0;0;3;0
3284; 46.8 ; 233.8 ; -   ;5;40;114;0;5;2;3;4;1;0;5;0
3285; 50.2 ; 100.4 ; 2.3 ;2;13;100;0;2;0;2;2;0;0;2;0
3286; 42.4 ; 169.4 ; 12.3 ;4;19;74;0;4;0;4;2;2;0;4;0
3287; 21.3 ; 106.6 ; 5.5 ;5;36;5;0;5;2;3;3;2;5;0;0
3288; 48.4 ; 96.8 ; 1.4 ;2;5;57;0;2;0;2;1;1;0;2;0
3289; 22.6 ; 112.8 ; 7.5 ;5;41;3;0;5;2;3;3;2;3;2;0
3290; 32.0 ; 64.0 ; 12.7 ;2;69;152;0;2;0;2;2;0;1;1;0
3291; 40.4 ; 767.6 ; 17.6 ;19;15;38;0;19;8;11;7;12;6;7;6
3292; 29.9 ; 418.6 ; 5.5 ;14;32;15;0;14;3;11;7;7;9;5;0
3293; 35.5 ; 71.0 ; 15.6 ;2;78;131;2;0;1;1;0;2;1;1;0
3294; 22.6 ; 45.2 ; 11.4 ;2;28;287;0;2;1;1;1;1;1;1;0
3295; 51.4 ; 102.7 ; 31.7 ;2;77;82;2;0;1;1;2;0;1;0;1
3296; 54.9 ; 768.4 ; 30.3 ;14;17;1;0;14;5;9;12;2;5;4;5
3297; 30.9 ; 61.7 ; 23.8 ;2;187;42;0;2;0;2;0;2;1;1;0
3298; 21.5 ; 193.2 ; 11.1 ;9;34;33;0;9;2;7;5;4;6;3;0
3299; 22.2 ; 44.4 ; 2.7 ;2;2;215;0;2;1;1;1;1;2;0;0
3300; 43.5 ; 217.7 ; 11.0 ;5;11;194;0;5;1;4;4;1;0;5;0
3301; 79.5 ; 159.0 ; 38.2 ;2;168;22;2;0;0;2;2;0;0;0;2
3302; 27.3 ; 136.4 ; 12.3 ;5;76;0;0;5;0;5;3;2;3;2;0
3303; 36.2 ; 72.5 ; 31.8 ;2;64;95;0;2;1;1;0;2;1;0;1
3304; 18.6 ; 223.7 ; 4.9 ;12;17;170;0;12;10;2;3;9;12;0;0
3305; 46.9 ; 234.5 ; 6.1 ;5;54;27;0;5;2;3;5;0;0;5;0
3306; 38.5 ; 269.8 ; 13.2 ;7;32;20;0;7;2;5;7;0;2;5;0
3307; 32.2 ; 96.6 ; 13.9 ;3;22;131;0;3;0;3;2;1;1;2;0
3308; 64.9 ; 259.8 ; 13.6 ;4;18;63;0;4;1;3;1;3;0;0;4
3309; 35.2 ; 422.4 ; 10.7 ;12;22;3;0;12;8;4;5;7;4;8;0
3310; 19.1 ; 229.7 ; 7.7 ;12;21;2;0;12;5;7;2;10;12;0;0
3311; 43.4 ; 86.8 ; 42.6 ;2;12;147;0;2;0;2;0;2;1;0;1
3312; 32.9 ; 460.4 ; 14.2 ;14;14;218;0;14;6;8;3;11;5;9;0
3313; 20.9 ; 62.8 ; 3.9 ;3;95;13;0;3;2;1;1;2;3;0;0
3314; 49.4 ; 98.8 ; 36.5 ;2;2;40;0;2;1;1;1;1;1;0;1
3315; 17.2 ; 86.1 ; 3.7 ;5;70;11;0;5;4;1;5;0;5;0;0
3316; 56.7 ; 283.5 ; 20.8 ;5;38;32;0;5;1;4;2;3;0;0;5
3317; 39.8 ; 119.3 ; 13.5 ;3;45;50;0;3;1;2;3;0;1;2;0
3318; 38.5 ; 76.9 ; 12.4 ;2;35;248;0;2;0;2;2;0;1;1;0
3319; 36.2 ; 180.9 ; 8.8 ;5;59;69;0;5;2;3;2;3;2;3;0
3320; 34.6 ; 103.7 ; 11.7 ;3;113;5;0;3;0;3;2;1;1;2;0
3321; 20.7 ; 41.4 ; 2.1 ;2;95;107;0;2;2;0;0;2;2;0;0
3322; 53.4 ; 213.5 ; 10.4 ;4;44;152;0;4;1;3;1;3;0;3;1
3323; 39.8 ; 318.0 ; 14.0 ;8;44;31;0;8;0;8;3;5;3;5;0
3324; 22.2 ; 155.7 ; 12.8 ;7;40;68;0;7;2;5;3;4;5;2;0
3325; 25.1 ; 100.5 ; 7.8 ;4;5;269;0;4;2;2;2;2;3;1;0
3326; 38.9 ; 194.3 ; 19.0 ;5;32;83;0;5;1;4;4;1;2;1;2
3327; 50.2 ; 401.5 ; 15.0 ;8;55;52;0;8;1;7;4;4;0;5;3
3328; 33.3 ; 533.4 ; 22.4 ;16;11;86;0;16;2;14;6;10;5;6;5
3329; 15.9 ; 47.8 ; 1.7 ;3;61;104;1;2;2;1;1;2;3;0;0
3330; 44.0 ; 176.1 ; 23.6 ;4;27;304;0;4;1;3;4;0;1;2;1
3331; 22.6 ; 45.2 ; 11.4 ;2;186;104;0;2;2;0;1;1;1;1;0
3332; 23.0 ; 91.9 ; 5.6 ;4;5;163;0;4;3;1;3;1;4;0;0
3333; 15.0 ; 30.0 ; -   ;2;68;5;0;2;0;2;2;0;2;0;0
3334; 46.6 ; 93.2 ; 0.2 ;2;44;363;0;2;0;2;0;2;0;2;0
3335; 66.1 ; 330.4 ; 22.3 ;5;64;41;0;5;1;4;5;0;0;0;5
3336; 31.1 ; 217.8 ; 13.8 ;7;16;126;0;7;2;5;5;2;2;5;0
3337; 29.9 ; 149.5 ; 15.4 ;5;42;13;5;0;5;0;2;3;3;2;0
3338; 48.5 ; 145.4 ; 9.9 ;3;124;57;0;3;1;2;1;2;0;2;1
3339; 37.8 ; 453.4 ; 21.8 ;12;23;26;0;12;0;12;12;0;4;4;4
3340; 46.8 ; 93.5 ; -   ;2;88;141;2;0;0;2;1;1;0;2;0
3341; 25.1 ; 50.1 ; -   ;2;93;281;0;2;1;1;0;2;2;0;0
3342; 47.5 ; 94.9 ; -   ;2;36;69;0;2;0;2;1;1;0;2;0
3343; 47.5 ; 94.9 ; -   ;2;13;59;2;0;2;0;2;0;0;2;0
3344; 46.2 ; 231.1 ; 31.5 ;5;29;251;0;5;1;4;1;4;2;1;2
3345; 47.7 ; 95.5 ; 1.5 ;2;59;76;0;2;1;1;2;0;0;2;0
3346; 31.2 ; 62.5 ; 24.3 ;2;25;38;0;2;0;2;1;1;1;0;1
3347; 52.9 ; 211.4 ; 20.6 ;4;71;41;0;4;0;4;4;0;0;3;1
3348; 51.3 ; 153.8 ; 11.5 ;3;50;164;0;3;0;3;1;2;0;2;1
3349; 19.0 ; 57.0 ; 1.7 ;3;40;153;0;3;0;3;3;0;3;0;0
3350; 46.3 ; 370.4 ; 11.3 ;8;23;10;3;5;3;5;5;3;0;5;3
3351; 42.4 ; 636.1 ; 17.9 ;15;6;127;1;14;8;7;5;10;5;5;5
3352; 17.1 ; 34.2 ; 3.2 ;2;47;313;0;2;1;1;2;0;2;0;0
3353; 49.6 ; 148.7 ; 2.6 ;3;74;158;1;2;2;1;1;2;0;3;0
3354; 45.7 ; 91.3 ; 2.7 ;2;30;15;2;0;1;1;2;0;0;2;0
3355; 34.8 ; 278.1 ; 17.2 ;8;30;1;0;8;1;7;2;6;3;5;0
3356; 58.1 ; 871.7 ; 22.4 ;15;20;5;0;15;4;11;7;8;0;0;15
3357; 21.5 ; 107.6 ; 10.8 ;5;45;4;0;5;4;1;3;2;3;2;0
3358; 39.0 ; 156.0 ; 14.5 ;4;86;47;0;4;0;4;2;2;1;3;0
3359; 18.9 ; 75.8 ; 0.4 ;4;33;165;0;4;2;2;1;3;4;0;0
3360; 24.5 ; 122.3 ; 8.2 ;5;9;1;5;0;4;1;5;0;3;2;0
3361; 17.9 ; 71.5 ; 3.6 ;4;75;23;3;1;1;3;1;3;4;0;0
3362; 17.1 ; 34.3 ; 3.2 ;2;21;170;0;2;2;0;0;2;2;0;0
3363; 28.4 ; 398.1 ; 12.3 ;14;20;39;0;14;8;6;6;8;9;5;0
3364; 42.5 ; 127.6 ; 19.6 ;3;38;20;0;3;0;3;0;3;1;1;1
3365; 22.9 ; 91.8 ; 6.2 ;4;46;89;0;4;0;4;3;1;4;0;0
3366; 102.1 ; 204.3 ; 33.2 ;2;263;53;0;2;0;2;2;0;0;0;2
3367; 30.2 ; 181.3 ; 9.1 ;6;59;84;0;6;0;6;2;4;2;4;0
3368; 57.3 ; 286.4 ; 11.5 ;5;11;230;0;5;2;3;1;4;0;0;5
3369; 32.5 ; 65.1 ; 26.3 ;2;225;8;1;1;2;0;1;1;1;0;1
3370; 33.4 ; 100.3 ; 15.3 ;3;2;209;0;3;2;1;2;1;1;2;0
3371; 27.1 ; 298.4 ; 15.1 ;11;24;8;0;11;5;6;7;4;7;4;0
3372; 22.9 ; 45.8 ; 4.9 ;2;38;230;0;2;0;2;1;1;2;0;0
3373; 45.9 ; 137.8 ; 2.2 ;3;64;41;3;0;0;3;1;2;0;3;0
3374; 51.8 ; 103.7 ; 7.6 ;2;44;146;0;2;0;2;1;1;0;1;1
3375; 93.9 ; 657.1 ; 24.3 ;7;44;89;0;7;0;7;7;0;0;0;7
3376; 36.6 ; 73.2 ; -   ;2;32;104;0;2;0;2;2;0;0;2;0
3377; 54.4 ; 544.3 ; 26.9 ;10;22;11;0;10;2;8;4;6;3;4;3
3378; 64.7 ; 129.5 ; 26.9 ;2;54;170;0;2;1;1;0;2;0;0;2
3379; 25.1 ; 50.1 ; -   ;2;17;263;0;2;0;2;0;2;2;0;0
3380; 35.7 ; 71.3 ; 1.4 ;2;10;104;0;2;1;1;2;0;0;2;0
3381; 47.1 ; 94.2 ; 0.5 ;2;226;78;0;2;0;2;2;0;0;2;0
3382; 69.4 ; 624.2 ; 19.4 ;9;27;20;0;9;3;6;1;8;0;0;9
3383; 27.5 ; 55.0 ; 3.7 ;2;80;211;0;2;0;2;0;2;1;1;0
3384; 32.3 ; 96.9 ; 13.3 ;3;11;244;0;3;1;2;3;0;1;2;0
3385; 22.7 ; 68.0 ; 14.1 ;3;9;310;0;3;0;3;3;0;2;1;0
3386; 25.6 ; 179.2 ; 11.2 ;7;46;36;0;7;4;3;7;0;5;2;0
3387; 49.6 ; 148.7 ; 2.6 ;3;21;243;0;3;2;1;2;1;0;3;0
3388; 29.2 ; 145.8 ; 2.4 ;5;40;6;0;5;4;1;1;4;3;2;0
3389; 46.5 ; 92.9 ; 4.3 ;2;50;17;1;1;1;1;1;1;0;2;0
3390; 60.1 ; 420.5 ; 18.3 ;7;27;121;0;7;3;4;2;5;0;0;7
3391; 30.8 ; 61.7 ; 8.6 ;2;1;73;0;2;0;2;1;1;1;1;0
3392; 55.2 ; 110.4 ; 10.5 ;2;38;5;0;2;0;2;2;0;0;0;2
3393; 22.5 ; 44.9 ; 11.2 ;2;61;310;0;2;0;2;2;0;1;1;0
3394; 35.1 ; 105.2 ; 9.0 ;3;178;38;0;3;2;1;1;2;1;2;0
3395; 58.3 ; 116.6 ; 41.5 ;2;23;246;0;2;1;1;0;2;1;0;1
3396; 36.8 ; 73.7 ; 17.6 ;2;49;194;0;2;0;2;2;0;1;1;0
3397; 22.8 ; 318.6 ; 6.8 ;14;21;0;1;13;6;8;7;7;14;0;0
3398; 28.4 ; 341.3 ; 9.7 ;12;38;3;0;12;4;8;3;9;8;4;0
3399; 27.6 ; 110.5 ; 3.1 ;4;6;291;0;4;4;0;3;1;3;1;0
3400; 88.1 ; 176.2 ; 55.5 ;2;100;195;0;2;0;2;1;1;0;0;2
3401; 62.6 ; 125.1 ; 8.7 ;2;75;21;0;2;0;2;0;2;0;0;2
3402; 57.8 ; 231.0 ; 5.9 ;4;35;5;0;4;1;3;3;1;0;0;4
3403; 23.6 ; 118.2 ; 15.3 ;5;61;73;0;5;0;5;3;2;3;2;0
3404; 47.7 ; 143.1 ; 0.4 ;3;40;19;3;0;2;1;3;0;0;3;0
3405; 36.0 ; 179.9 ; 22.2 ;5;12;5;0;5;0;5;4;1;2;1;2
3406; 77.6 ; 155.2 ; -   ;2;5;272;0;2;0;2;2;0;0;0;2
3407; 25.1 ; 50.1 ; -   ;2;5;105;0;2;0;2;0;2;2;0;0
3408; 22.9 ; 45.8 ; 3.2 ;2;167;114;0;2;1;1;0;2;2;0;0
3409; 55.6 ; 611.6 ; 7.5 ;11;28;6;0;11;2;9;4;7;0;0;11
3410; 31.2 ; 62.5 ; 24.3 ;2;295;31;0;2;0;2;2;0;1;0;1
3411; 32.6 ; 65.1 ; 11.2 ;2;6;20;2;0;0;2;0;2;1;1;0
3412; 49.0 ; 538.7 ; 27.8 ;11;13;2;0;11;3;8;7;4;4;3;4
3413; 30.9 ; 61.7 ; 23.8 ;2;8;272;0;2;1;1;2;0;1;1;0
3414; 20.2 ; 262.4 ; 9.8 ;13;26;14;8;5;6;7;7;6;9;4;0
3415; 51.4 ; 102.7 ; 16.3 ;2;14;5;0;2;1;1;2;0;0;1;1
3416; 27.4 ; 191.9 ; 11.6 ;7;26;241;0;7;5;2;5;2;5;2;0
3417; 25.5 ; 127.4 ; 11.2 ;5;77;52;0;5;2;3;2;3;3;2;0
3418; 60.4 ; 120.7 ; 11.2 ;2;103;160;0;2;1;1;2;0;0;0;2
3419; 25.1 ; 50.1 ; -   ;2;13;283;0;2;0;2;2;0;2;0;0
3420; 42.0 ; 210.1 ; 20.6 ;5;29;153;0;5;0;5;5;0;2;1;2
3421; 31.8 ; 190.5 ; 12.0 ;6;9;2;0;6;5;1;6;0;2;4;0
3422; 21.8 ; 109.1 ; 4.2 ;5;17;8;2;3;4;1;1;4;5;0;0
3423; 42.6 ; 255.3 ; 24.6 ;6;39;8;1;5;5;1;3;3;2;2;2
3424; 15.0 ; 30.0 ; -   ;2;19;23;0;2;2;0;2;0;2;0;0
3425; 47.5 ; 427.6 ; 16.5 ;9;13;300;0;9;2;7;4;5;0;6;3
3426; 42.5 ; 212.6 ; 18.5 ;5;30;120;0;5;3;2;3;2;2;1;2
3427; 65.9 ; 329.6 ; 45.0 ;5;85;104;0;5;0;5;4;1;2;0;3
3428; 23.0 ; 207.2 ; 12.6 ;9;21;34;0;9;7;2;3;6;6;3;0
3429; 58.0 ; 347.8 ; 96.1 ;6;11;104;0;6;5;1;4;2;2;0;4
3430; 30.0 ; 120.0 ; 14.3 ;4;29;5;0;4;2;2;1;3;3;1;0
3431; 40.6 ; 121.9 ; 7.4 ;3;52;5;0;3;1;2;2;1;0;3;0
3432; 43.5 ; 173.9 ; 16.7 ;4;86;183;0;4;1;3;2;2;1;2;1
3433; 38.1 ; 114.2 ; 12.7 ;3;13;107;0;3;2;1;1;2;1;2;0
3434; 41.1 ; 82.1 ; 4.2 ;2;137;5;0;2;1;1;0;2;0;2;0
3435; 19.7 ; 118.4 ; 6.4 ;6;20;173;0;6;3;3;4;2;6;0;0
3436; 18.0 ; 89.9 ; 7.1 ;5;49;85;0;5;3;2;3;2;5;0;0
3437; 17.9 ; 35.8 ; 0.2 ;2;146;94;0;2;0;2;0;2;2;0;0
3438; 47.3 ; 94.6 ; 5.6 ;2;62;75;0;2;2;0;1;1;0;2;0
3439; 47.1 ; 94.2 ; 0.5 ;2;99;100;0;2;0;2;1;1;0;2;0
3440; 106.9 ; 534.5 ; 41.9 ;5;47;183;0;5;0;5;5;0;0;0;5
3441; 15.0 ; 30.0 ; -   ;2;122;2;1;1;1;1;0;2;2;0;0
3442; 55.7 ; 389.8 ; 25.1 ;7;24;156;0;7;5;2;1;6;0;0;7
3443; 42.9 ; 171.6 ; 45.2 ;4;41;6;0;4;1;3;4;0;1;2;1
3444; 43.6 ; 87.2 ; 4.0 ;2;5;40;0;2;2;0;1;1;0;2;0
3445; 36.1 ; 72.1 ; 22.4 ;2;170;15;0;2;0;2;1;1;1;0;1
3446; 43.6 ; 1,090.1 ; 16.9 ;25;16;5;0;25;15;10;15;10;8;9;8
3447; 38.8 ; 271.4 ; 25.1 ;7;47;2;0;7;3;4;0;7;2;3;2
3448; 38.5 ; 269.2 ; 16.9 ;7;27;31;0;7;1;6;6;1;2;3;2
3449; 46.8 ; 93.5 ; -   ;2;6;262;0;2;0;2;1;1;0;2;0
3450; 42.6 ; 170.4 ; 8.8 ;4;78;146;0;4;1;3;2;2;0;4;0
3451; 38.8 ; 271.5 ; 13.6 ;7;48;47;0;7;0;7;6;1;2;5;0
3452; 53.5 ; 267.7 ; 29.7 ;5;11;236;0;5;1;4;5;0;2;1;2
3453; 47.5 ; 94.9 ; -   ;2;4;83;2;0;1;1;1;1;0;2;0
3454; 37.6 ; 413.3 ; 14.8 ;11;24;57;0;11;0;11;11;0;4;7;0
3455; 68.1 ; 408.7 ; 27.8 ;6;45;42;0;6;0;6;5;1;0;0;6
3456; 31.7 ; 380.4 ; 13.0 ;12;26;12;0;12;5;7;8;4;4;8;0
3457; 15.7 ; 78.5 ; 1.9 ;5;61;11;0;5;0;5;5;0;5;0;0
3458; 25.7 ; 282.9 ; 15.0 ;11;24;59;0;11;5;6;5;6;7;4;0
3459; 41.5 ; 1,037.6 ; 11.4 ;25;9;0;0;25;11;14;7;18;0;25;0
3460; 54.9 ; 109.8 ; 27.4 ;2;4;44;0;2;1;1;0;2;1;0;1
3461; 25.3 ; 126.4 ; 3.6 ;5;8;72;0;5;5;0;0;5;5;0;0
3462; 22.7 ; 90.9 ; 6.9 ;4;4;124;0;4;4;0;1;3;4;0;0
3463; 23.7 ; 71.2 ; 2.4 ;3;34;67;0;3;2;1;1;2;3;0;0
3464; 16.8 ; 33.6 ; 2.7 ;2;5;78;0;2;1;1;2;0;2;0;0
3465; 20.6 ; 41.1 ; 0.8 ;2;7;106;0;2;1;1;1;1;2;0;0
3466; 73.9 ; 221.7 ; 27.0 ;3;167;107;0;3;3;0;2;1;0;0;3
3467; 44.4 ; 133.3 ; 19.4 ;3;18;251;0;3;2;1;1;2;1;1;1
3468; 34.4 ; 68.7 ; 23.6 ;2;18;47;2;0;0;2;2;0;1;0;1
3469; 47.0 ; 141.0 ; 0.4 ;3;194;41;0;3;0;3;3;0;0;3;0
3470; 30.7 ; 61.4 ; 0.7 ;2;36;170;0;2;1;1;2;0;1;1;0
3471; 31.6 ; 158.2 ; 24.4 ;5;61;15;0;5;1;4;4;1;2;1;2
3472; 22.0 ; 131.9 ; 10.2 ;6;61;29;0;6;5;1;3;3;4;2;0
3473; 43.4 ; 86.9 ; 7.8 ;2;25;173;0;2;0;2;1;1;0;2;0
3474; 18.4 ; 258.0 ; 6.6 ;14;13;15;0;14;4;10;6;8;14;0;0
3475; 15.0 ; 30.0 ; -   ;2;1;425;0;2;0;2;0;2;2;0;0
3476; 67.4 ; 337.1 ; 12.4 ;5;77;22;0;5;3;2;1;4;0;0;5
3477; 33.9 ; 135.5 ; 6.8 ;4;52;28;0;4;2;2;4;0;1;3;0
3478; 17.3 ; 86.4 ; 4.7 ;5;34;41;0;5;0;5;5;0;5;0;0
3479; 39.6 ; 356.4 ; 14.4 ;9;31;12;0;9;2;7;5;4;3;6;0
3480; 46.3 ; 231.5 ; 20.5 ;5;34;152;0;5;1;4;4;1;2;1;2
3481; 21.5 ; 64.6 ; 8.1 ;3;28;130;1;2;2;1;1;2;3;0;0
3482; 56.4 ; 225.6 ; 12.2 ;4;44;309;0;4;0;4;3;1;0;0;4
3483; 38.5 ; 76.9 ; 12.4 ;2;14;284;0;2;1;1;0;2;1;1;0
3484; 58.2 ; 291.0 ; 13.7 ;5;70;86;0;5;2;3;1;4;0;0;5
3485; 27.0 ; 54.0 ; 4.5 ;2;14;272;0;2;1;1;0;2;1;1;0
3486; 25.1 ; 376.8 ; 12.9 ;15;11;6;0;15;10;5;3;12;10;5;0
3487; 21.7 ; 130.0 ; 9.5 ;6;9;108;0;6;4;2;0;6;4;2;0
3488; 46.8 ; 93.5 ; -   ;2;14;350;0;2;1;1;1;1;0;2;0
3489; 30.2 ; 60.4 ; -   ;2;91;95;0;2;1;1;1;1;0;2;0
3490; 26.5 ; 53.0 ; 2.1 ;2;86;202;0;2;1;1;0;2;2;0;0
3491; 15.0 ; 30.0 ; -   ;2;133;1;0;2;1;1;0;2;2;0;0
3492; 17.5 ; 122.6 ; 4.9 ;7;20;15;0;7;1;6;5;2;7;0;0
3493; 38.4 ; 76.7 ; 12.6 ;2;113;253;0;2;0;2;2;0;1;1;0
3494; 46.3 ; 231.7 ; 15.5 ;5;65;20;0;5;0;5;3;2;0;3;2
3495; 22.9 ; 45.8 ; 3.2 ;2;1;270;0;2;2;0;0;2;2;0;0
3496; 34.9 ; 139.4 ; 16.4 ;4;5;99;0;4;0;4;3;1;1;3;0
3497; 39.4 ; 78.9 ; 13.9 ;2;92;173;0;2;1;1;2;0;1;1;0
3498; 34.3 ; 171.6 ; 6.4 ;5;12;204;0;5;0;5;4;1;2;3;0
3499; 54.3 ; 217.3 ; 23.1 ;4;31;173;0;4;1;3;3;1;0;3;1
3500; 52.9 ; 211.5 ; 0.4 ;4;44;31;0;4;0;4;2;2;0;4;0
3501; 32.9 ; 164.7 ; 7.2 ;5;36;75;0;5;1;4;1;4;2;3;0
3502; 26.5 ; 106.0 ; -   ;4;35;5;0;4;0;4;0;4;4;0;0
3503; 22.4 ; 44.7 ; 4.0 ;2;7;263;0;2;1;1;0;2;2;0;0
3504; 16.0 ; 48.0 ; 1.9 ;3;20;51;0;3;1;2;0;3;3;0;0
3505; 48.5 ; 97.0 ; 2.6 ;2;215;99;0;2;0;2;1;1;0;2;0
3506; 22.6 ; 45.2 ; 11.4 ;2;128;257;0;2;1;1;1;1;1;1;0
3507; 33.9 ; 746.7 ; 12.3 ;22;15;34;0;22;11;11;11;11;7;15;0
3508; 41.4 ; 82.8 ; 5.3 ;2;125;89;0;2;1;1;1;1;0;2;0
3509; 29.6 ; 59.3 ; 6.8 ;2;13;163;0;2;0;2;2;0;1;1;0
3510; 46.8 ; 93.5 ; -   ;2;64;152;0;2;0;2;2;0;0;2;0
3511; 29.6 ; 59.3 ; 0.5 ;2;83;49;0;2;2;0;2;0;1;1;0
3512; 48.1 ; 144.3 ; 1.1 ;3;12;79;0;3;0;3;3;0;0;3;0
3513; 41.0 ; 779.1 ; 3.7 ;19;17;20;0;19;5;14;7;12;0;19;0
3514; 64.5 ; 129.0 ; 13.8 ;2;134;26;0;2;1;1;1;1;0;0;2
3515; 24.5 ; 49.0 ; 7.6 ;2;10;260;0;2;2;0;1;1;1;1;0
3516; 49.9 ; 99.7 ; 1.7 ;2;109;74;0;2;1;1;2;0;0;2;0
3517; 38.5 ; 76.9 ; 12.4 ;2;7;301;0;2;2;0;2;0;1;1;0
3518; 42.8 ; 257.0 ; 22.0 ;6;18;157;0;6;0;6;2;4;2;2;2
3519; 25.8 ; 51.6 ; 16.2 ;2;20;246;0;2;0;2;1;1;1;1;0
3520; 57.1 ; 171.2 ; 18.2 ;3;167;101;0;3;1;2;0;3;0;0;3
3521; 53.9 ; 161.8 ; 2.6 ;3;4;163;0;3;1;2;3;0;0;2;1
3522; 17.1 ; 85.7 ; 2.1 ;5;35;155;0;5;5;0;1;4;5;0;0
3523; 27.9 ; 83.8 ; 12.8 ;3;50;141;0;3;0;3;3;0;2;1;0
3524; 27.2 ; 81.5 ; 16.5 ;3;31;152;0;3;2;1;3;0;2;1;0
3525; 32.0 ; 95.9 ; 13.1 ;3;4;283;0;3;0;3;2;1;1;2;0
3526; 31.7 ; 63.3 ; 20.8 ;2;25;194;0;2;0;2;1;1;1;1;0
3527; 50.6 ; 252.8 ; 29.6 ;5;78;5;0;5;1;4;4;1;2;1;2
3528; 47.8 ; 238.9 ; 8.6 ;5;41;84;0;5;1;4;2;3;0;3;2
3529; 46.8 ; 93.5 ; -   ;2;6;215;2;0;0;2;1;1;0;2;0
3530; 52.1 ; 104.2 ; 8.0 ;2;20;245;0;2;1;1;2;0;0;1;1
3531; 22.8 ; 68.4 ; 6.5 ;3;50;131;0;3;1;2;0;3;3;0;0
3532; 41.6 ; 124.7 ; 25.6 ;3;38;32;0;3;0;3;1;2;1;1;1
3533; 91.4 ; 182.8 ; 99.3 ;2;146;245;0;2;1;1;1;1;1;0;1
3534; 54.8 ; 329.1 ; 16.7 ;6;54;2;0;6;2;4;6;0;0;4;2
3535; 84.6 ; 169.2 ; 10.5 ;2;65;218;0;2;1;1;1;1;0;0;2
3536; 38.5 ; 76.9 ; 12.4 ;2;175;116;1;1;0;2;1;1;1;1;0
3537; 28.2 ; 282.2 ; 6.2 ;10;37;47;0;10;1;9;5;5;7;3;0
3538; 31.1 ; 435.8 ; 12.0 ;14;14;230;0;14;7;7;8;6;5;9;0
3539; 17.5 ; 174.6 ; 0.4 ;10;5;2;0;10;9;1;2;8;10;0;0
3540; 20.3 ; 81.1 ; 6.8 ;4;5;56;0;4;3;1;1;3;4;0;0
3541; 84.8 ; 508.5 ; 27.3 ;6;11;0;1;5;1;5;5;1;0;0;6
3542; 32.3 ; 64.6 ; 3.5 ;2;9;21;0;2;1;1;0;2;1;1;0
3543; 62.3 ; 124.6 ; 6.2 ;2;8;47;2;0;1;1;1;1;0;0;2
3544; 32.6 ; 65.1 ; 11.2 ;2;93;127;0;2;0;2;0;2;1;1;0
3545; 81.4 ; 814.0 ; 20.5 ;10;12;31;0;10;0;10;8;2;0;0;10
3546; 45.9 ; 91.8 ; 31.2 ;2;168;59;0;2;0;2;2;0;1;0;1
3547; 15.0 ; 30.0 ; -   ;2;1;46;0;2;1;1;2;0;2;0;0
3548; 23.3 ; 140.1 ; 10.7 ;6;43;86;0;6;3;3;2;4;4;2;0
3549; 27.9 ; 55.9 ; 12.9 ;2;6;173;0;2;0;2;1;1;1;1;0
3550; 43.6 ; 218.2 ; 1.8 ;5;46;115;0;5;1;4;4;1;0;5;0
3551; 46.9 ; 140.6 ; 4.3 ;3;70;261;0;3;1;2;1;2;0;3;0
3552; 64.8 ; 129.7 ; 27.1 ;2;3;206;0;2;2;0;1;1;0;0;2
3553; 46.5 ; 186.1 ; 7.2 ;4;32;57;0;4;1;3;2;2;0;4;0
3554; 61.9 ; 185.8 ; 15.0 ;3;6;262;0;3;1;2;0;3;0;0;3
3555; 61.8 ; 185.4 ; 27.2 ;3;203;59;1;2;1;2;0;3;0;0;3
3556; 36.6 ; 842.2 ; 16.6 ;23;18;5;1;22;4;19;18;5;8;15;0
3557; 40.3 ; 80.5 ; 13.9 ;2;82;74;0;2;0;2;1;1;1;1;0
3558; 37.8 ; 75.6 ; 4.6 ;2;47;76;0;2;1;1;0;2;0;2;0
3559; 39.4 ; 157.8 ; 38.7 ;4;46;152;0;4;1;3;4;0;1;2;1
3560; 18.2 ; 90.8 ; 3.2 ;5;40;2;0;5;2;3;4;1;5;0;0
3561; 46.4 ; 324.8 ; 12.2 ;7;23;6;0;7;1;6;7;0;0;5;2
3562; 15.0 ; 104.9 ; -   ;7;12;8;0;7;3;4;5;2;7;0;0
3563; 43.6 ; 305.2 ; 28.2 ;7;12;210;0;7;2;5;3;4;2;3;2
3564; 34.9 ; 104.6 ; 18.3 ;3;28;274;0;3;1;2;2;1;1;2;0
3565; 57.3 ; 172.0 ; 40.6 ;3;38;258;0;3;0;3;2;1;1;0;2
3566; 17.5 ; 34.9 ; 2.7 ;2;76;207;0;2;2;0;2;0;2;0;0
3567; 85.7 ; 171.4 ; 73.6 ;2;140;36;0;2;0;2;2;0;1;0;1
3568; 43.2 ; 86.3 ; 19.4 ;2;41;200;0;2;1;1;1;1;1;0;1
3569; 25.1 ; 50.1 ; -   ;2;29;22;0;2;0;2;0;2;2;0;0
3570; 38.0 ; 152.0 ; 13.4 ;4;8;33;4;0;4;0;4;0;1;3;0
3571; 56.2 ; 112.4 ; 11.2 ;2;13;23;0;2;2;0;2;0;0;0;2
3572; 55.6 ; 945.8 ; 33.1 ;17;13;0;0;17;15;2;3;14;6;0;11
3573; 91.8 ; 183.7 ; 32.7 ;2;49;65;2;0;1;1;2;0;0;0;2
3574; 35.1 ; 70.2 ; 2.3 ;2;77;223;0;2;2;0;2;0;0;2;0
3575; 72.1 ; 144.3 ; 36.9 ;2;42;63;2;0;0;2;2;0;0;0;2
3576; 29.6 ; 88.9 ; 18.3 ;3;3;227;0;3;1;2;2;1;2;1;0
3577; 63.8 ; 319.2 ; 47.6 ;5;16;5;5;0;1;4;2;3;2;0;3
3578; 49.8 ; 199.0 ; 18.8 ;4;73;33;3;1;1;3;2;2;0;3;1
3579; 15.0 ; 45.0 ; -   ;3;22;16;3;0;0;3;3;0;3;0;0
3580; 15.0 ; 89.9 ; -   ;6;23;40;6;0;1;5;1;5;6;0;0
3581; 18.6 ; 55.8 ; 3.4 ;3;72;116;0;3;0;3;2;1;3;0;0
3582; 70.7 ; 212.1 ; 24.8 ;3;41;277;0;3;1;2;3;0;0;0;3
3583; 20.5 ; 143.7 ; 6.6 ;7;46;0;0;7;4;3;1;6;7;0;0
3584; 60.9 ; 121.8 ; 16.6 ;2;59;55;2;0;1;1;2;0;0;0;2
3585; 74.0 ; 370.2 ; 22.0 ;5;60;10;0;5;0;5;4;1;0;0;5
3586; 36.3 ; 72.5 ; 16.8 ;2;42;57;2;0;1;1;1;1;1;1;0
3587; 58.7 ; 293.6 ; 18.8 ;5;26;207;0;5;1;4;4;1;0;0;5
3588; 40.9 ; 327.0 ; 18.0 ;8;49;0;0;8;0;8;7;1;3;2;3
3589; 39.2 ; 313.6 ; 38.5 ;8;41;16;0;8;0;8;5;3;3;2;3
3590; 99.1 ; 198.2 ; -   ;2;167;23;0;2;1;1;0;2;0;0;2
3591; 46.8 ; 140.3 ; -   ;3;71;134;1;2;1;2;1;2;0;3;0
3592; 28.5 ; 313.6 ; 10.8 ;11;3;98;0;11;8;3;7;4;7;4;0
3593; 25.2 ; 125.9 ; 14.4 ;5;32;46;5;0;1;4;3;2;3;2;0
3594; 47.9 ; 143.8 ; 0.4 ;3;29;6;0;3;1;2;0;3;0;3;0
3595; 55.0 ; 109.9 ; 10.1 ;2;205;4;2;0;2;0;2;0;0;1;1
3596; 39.5 ; 197.3 ; 15.3 ;5;63;104;0;5;0;5;3;2;2;3;0
3597; 44.6 ; 223.2 ; 4.5 ;5;58;70;1;4;3;2;3;2;0;5;0
3598; 31.7 ; 285.3 ; 16.4 ;9;43;26;0;9;3;6;5;4;3;6;0
3599; 21.6 ; 583.2 ; 8.2 ;27;14;62;0;27;11;16;18;9;27;0;0
3600; 53.0 ; 106.0 ; 15.2 ;2;24;221;0;2;0;2;1;1;0;1;1
3601; 58.4 ; 467.2 ; 3.7 ;8;40;11;0;8;0;8;2;6;0;0;8
3602; 26.2 ; 288.5 ; 14.8 ;11;10;0;0;11;4;7;1;10;7;4;0
3603; 26.1 ; 52.2 ; 11.2 ;2;49;140;0;2;2;0;1;1;1;1;0
3604; 30.9 ; 92.8 ; 16.1 ;3;9;239;0;3;1;2;2;1;1;2;0
3605; 29.2 ; 350.2 ; 12.5 ;12;20;0;0;12;1;11;12;0;8;4;0
3606; 32.3 ; 484.5 ; 16.7 ;15;21;2;0;15;7;8;4;11;5;10;0
3607; 44.6 ; 89.1 ; 11.9 ;2;135;99;2;0;1;1;0;2;0;1;1
3608; 29.0 ; 173.9 ; 30.0 ;6;31;118;0;6;3;3;3;3;4;0;2
3609; 25.1 ; 75.4 ; 12.0 ;3;4;267;0;3;1;2;3;0;2;1;0
3610; 15.0 ; 74.9 ; -   ;5;28;40;0;5;1;4;3;2;5;0;0
3611; 47.4 ; 379.5 ; 1.2 ;8;38;22;0;8;0;8;7;1;0;8;0
3612; 51.8 ; 155.4 ; 11.0 ;3;112;101;0;3;3;0;3;0;0;2;1
3613; 29.5 ; 147.3 ; 12.8 ;5;26;248;0;5;1;4;3;2;3;2;0
3614; 59.6 ; 833.7 ; 24.3 ;14;16;10;0;14;6;8;5;9;0;0;14
3615; 25.6 ; 51.2 ; 0.8 ;2;10;235;0;2;2;0;1;1;2;0;0
3616; 17.0 ; 51.1 ; 3.7 ;3;56;120;0;3;1;2;1;2;3;0;0
3617; 49.1 ; 98.1 ; 2.9 ;2;21;152;0;2;0;2;2;0;0;2;0
3618; 57.7 ; 115.5 ; 13.5 ;2;17;26;0;2;0;2;2;0;0;0;2
3619; 28.9 ; 57.9 ; 20.9 ;2;120;146;0;2;0;2;1;1;1;1;0
3620; 34.6 ; 172.8 ; 12.3 ;5;55;4;0;5;2;3;3;2;2;3;0
3621; 54.9 ; 274.5 ; 11.8 ;5;22;11;0;5;0;5;1;4;0;3;2
3622; 52.4 ; 104.8 ; 1.2 ;2;5;29;0;2;2;0;0;2;0;2;0
3623; 24.9 ; 348.3 ; 9.4 ;14;22;11;0;14;4;10;7;7;9;5;0
3624; 28.0 ; 56.0 ; 4.4 ;2;5;11;0;2;0;2;2;0;1;1;0
3625; 50.4 ; 201.7 ; 23.3 ;4;42;146;0;4;1;3;2;2;1;2;1
3626; 53.9 ; 377.5 ; 30.8 ;7;21;16;0;7;0;7;4;3;2;3;2
3627; 21.0 ; 105.2 ; 5.9 ;5;16;139;0;5;5;0;3;2;5;0;0
3628; 18.7 ; 112.1 ; 8.5 ;6;32;12;0;6;4;2;4;2;6;0;0
3629; 26.7 ; 133.5 ; 11.9 ;5;32;107;0;5;1;4;5;0;3;2;0
3630; 43.5 ; 87.0 ; 7.8 ;2;257;74;0;2;0;2;0;2;0;2;0
3631; 30.2 ; 60.4 ; -   ;2;18;142;0;2;0;2;2;0;0;2;0
3632; 46.6 ; 419.1 ; 16.5 ;9;37;3;0;9;3;6;2;7;0;6;3
3633; 21.7 ; 65.1 ; 6.2 ;3;35;77;0;3;2;1;3;0;3;0;0
3634; 44.3 ; 221.5 ; 15.3 ;5;52;53;0;5;2;3;2;3;2;1;2
3635; 37.6 ; 112.7 ; 20.8 ;3;63;158;0;3;0;3;1;2;1;1;1
3636; 22.7 ; 113.7 ; 6.8 ;5;22;29;0;5;2;3;2;3;5;0;0
3637; 17.1 ; 137.0 ; 5.2 ;8;36;25;0;8;4;4;4;4;8;0;0
3638; 54.1 ; 108.3 ; 11.1 ;2;36;242;0;2;0;2;1;1;0;1;1
3639; 15.0 ; 74.9 ; -   ;5;34;7;0;5;2;3;3;2;5;0;0
3640; 27.2 ; 54.4 ; 3.2 ;2;19;73;0;2;0;2;2;0;1;1;0
3641; 77.3 ; 154.5 ; 18.1 ;2;40;155;1;1;1;1;0;2;0;0;2
3642; 24.8 ; 297.3 ; 7.2 ;12;12;8;0;12;4;8;5;7;8;4;0
3643; 65.6 ; 262.6 ; 53.6 ;4;46;73;0;4;0;4;3;1;1;0;3
3644; 65.0 ; 129.9 ; 74.9 ;2;269;39;0;2;1;1;1;1;1;0;1
3645; 52.3 ; 209.0 ; 8.4 ;4;46;32;0;4;0;4;4;0;0;3;1
3646; 46.8 ; 93.5 ; -   ;2;87;152;0;2;0;2;2;0;0;2;0
3647; 18.2 ; 91.0 ; 0.4 ;5;41;53;0;5;2;3;3;2;5;0;0
3648; 40.1 ; 200.3 ; -   ;5;30;50;0;5;5;0;1;4;0;5;0
3649; 53.1 ; 106.1 ; 9.4 ;2;12;251;0;2;0;2;2;0;0;1;1
3650; 91.4 ; 1,005.1 ; 16.3 ;11;14;20;0;11;0;11;11;0;0;0;11
3651; 72.7 ; 1,017.9 ; 47.0 ;14;13;15;0;14;1;13;14;0;5;0;9
3652; 36.4 ; 254.5 ; 14.2 ;7;34;11;0;7;3;4;4;3;2;5;0
3653; 26.7 ; 133.4 ; 7.6 ;5;32;147;0;5;2;3;3;2;3;2;0
3654; 43.5 ; 87.0 ; 7.8 ;2;3;171;0;2;1;1;0;2;0;2;0
3655; 36.9 ; 1,144.4 ; 10.0 ;31;9;47;0;31;12;19;18;13;10;21;0
3656; 55.0 ; 110.0 ; 2.6 ;2;39;82;0;2;1;1;2;0;0;0;2
3657; 62.2 ; 498.0 ; 47.7 ;8;49;26;0;8;0;8;1;7;3;0;5
3658; 49.6 ; 148.8 ; 5.2 ;3;104;104;0;3;0;3;3;0;0;3;0
3659; 22.4 ; 112.1 ; 6.1 ;5;3;107;5;0;4;1;3;2;5;0;0
3660; 20.5 ; 246.1 ; 6.1 ;12;22;86;0;12;10;2;8;4;12;0;0
3661; 73.1 ; 146.2 ; 7.6 ;2;12;320;0;2;0;2;0;2;0;0;2
3662; 50.4 ; 604.9 ; 13.7 ;12;23;58;0;12;1;11;12;0;0;8;4
3663; 44.7 ; 357.6 ; 17.7 ;8;37;10;0;8;0;8;6;2;3;2;3
3664; 15.0 ; 45.0 ; -   ;3;115;77;0;3;3;0;2;1;3;0;0
3665; 15.0 ; 45.0 ; -   ;3;41;5;1;2;1;2;3;0;3;0;0
3666; 49.3 ; 197.1 ; 28.4 ;4;100;26;0;4;2;2;1;3;1;2;1
3667; 27.4 ; 136.9 ; 8.5 ;5;39;104;0;5;0;5;3;2;3;2;0
3668; 22.0 ; 110.2 ; 4.8 ;5;45;22;1;4;1;4;1;4;5;0;0
3669; 78.8 ; 315.0 ; 23.1 ;4;101;20;0;4;0;4;4;0;0;0;4
3670; 25.3 ; 75.9 ; 8.3 ;3;45;143;0;3;2;1;2;1;2;1;0
3671; 26.1 ; 156.8 ; 10.3 ;6;43;61;0;6;3;3;1;5;4;2;0
3672; 46.4 ; 696.2 ; 26.0 ;15;14;5;0;15;9;6;4;11;5;5;5
3673; 45.9 ; 137.8 ; 8.8 ;3;95;116;0;3;0;3;2;1;0;3;0
3674; 45.6 ; 91.1 ; 4.1 ;2;16;385;0;2;1;1;2;0;0;2;0
3675; 39.7 ; 158.9 ; 3.8 ;4;42;166;0;4;2;2;4;0;0;4;0
3676; 46.8 ; 93.5 ; -   ;2;5;268;0;2;0;2;2;0;0;2;0
3677; 64.6 ; 129.2 ; 4.3 ;2;9;7;0;2;1;1;2;0;0;0;2
3678; 72.3 ; 216.9 ; 27.0 ;3;92;115;0;3;0;3;2;1;0;0;3
3679; 19.7 ; 39.5 ; -   ;2;50;310;0;2;0;2;1;1;2;0;0
3680; 25.1 ; 50.1 ; -   ;2;22;188;0;2;1;1;0;2;2;0;0
3681; 25.1 ; 50.1 ; -   ;2;144;33;0;2;1;1;0;2;2;0;0
3682; 19.1 ; 38.3 ; 0.8 ;2;4;265;0;2;1;1;2;0;2;0;0
3683; 39.0 ; 117.1 ; 2.3 ;3;82;26;3;0;1;2;2;1;0;3;0
3684; 51.6 ; 258.1 ; 9.4 ;5;14;185;0;5;0;5;0;5;0;3;2
3685; 58.9 ; 766.1 ; 18.7 ;13;14;3;0;13;8;5;9;4;0;0;13
3686; 79.5 ; 159.0 ; 40.4 ;2;278;93;0;2;1;1;2;0;0;0;2
3687; 91.1 ; 182.2 ; 28.2 ;2;257;58;0;2;0;2;2;0;0;0;2
3688; 37.9 ; 113.8 ; 15.2 ;3;17;233;0;3;2;1;1;2;1;2;0
3689; 31.4 ; 125.6 ; 13.4 ;4;41;101;0;4;1;3;3;1;1;3;0
3690; 26.9 ; 80.8 ; 6.7 ;3;21;266;0;3;2;1;1;2;2;1;0
3691; 134.0 ; 402.1 ; 73.4 ;3;22;20;0;3;0;3;1;2;0;0;3
3692; 63.9 ; 191.8 ; 17.2 ;3;22;15;0;3;0;3;3;0;0;0;3
3693; 50.5 ; 303.0 ; 18.3 ;6;49;10;0;6;0;6;6;0;0;4;2
3694; 69.6 ; 973.8 ; 28.0 ;14;23;32;0;14;3;11;5;9;0;0;14
3695; 15.0 ; 59.9 ; -   ;4;38;219;0;4;4;0;2;2;4;0;0
3696; 22.3 ; 267.5 ; 7.2 ;12;14;136;0;12;5;7;8;4;12;0;0
3697; 88.5 ; 531.2 ; 54.8 ;6;13;336;0;6;1;5;5;1;0;0;6
3698; 23.4 ; 70.2 ; 8.2 ;3;116;0;0;3;0;3;2;1;2;1;0
3699; 28.5 ; 370.0 ; 20.4 ;13;14;125;0;13;2;11;3;10;9;4;0
3700; 22.9 ; 45.8 ; 10.9 ;2;51;158;0;2;1;1;1;1;1;1;0
3701; 28.6 ; 143.1 ; 13.7 ;5;70;17;0;5;1;4;0;5;3;2;0
3702; 43.0 ; 86.1 ; 17.4 ;2;302;36;0;2;1;1;1;1;1;0;1
3703; 52.5 ; 210.1 ; 4.3 ;4;127;38;0;4;2;2;2;2;0;3;1
3704; 61.3 ; 981.2 ; 28.8 ;16;11;2;0;16;2;14;13;3;0;0;16
3705; 15.0 ; 45.0 ; -   ;3;5;120;0;3;2;1;1;2;3;0;0
3706; 59.6 ; 119.3 ; 34.5 ;2;6;110;0;2;0;2;2;0;1;0;1
3707; 38.2 ; 267.5 ; 14.1 ;7;44;15;1;6;0;7;5;2;2;5;0
3708; 21.0 ; 63.0 ; 2.9 ;3;86;126;0;3;1;2;2;1;3;0;0
3709; 112.9 ; 225.8 ; 14.6 ;2;50;15;0;2;0;2;2;0;0;0;2
3710; 22.9 ; 344.1 ; 10.6 ;15;19;22;0;15;1;14;11;4;10;5;0
3711; 74.3 ; 148.5 ; 8.2 ;2;6;230;0;2;0;2;1;1;0;0;2
3712; 70.8 ; 353.9 ; 52.7 ;5;68;20;0;5;1;4;5;0;2;0;3
3713; 51.0 ; 102.0 ; -   ;2;1;191;0;2;2;0;0;2;0;2;0
3714; 15.0 ; 45.0 ; -   ;3;59;44;0;3;1;2;1;2;3;0;0
3715; 23.4 ; 304.5 ; 9.6 ;13;14;110;0;13;6;7;6;7;9;4;0
3716; 40.5 ; 121.6 ; 13.2 ;3;110;90;0;3;1;2;3;0;1;2;0
3717; 48.1 ; 96.1 ; 0.9 ;2;72;99;0;2;1;1;0;2;0;2;0
3718; 63.2 ; 126.4 ; 4.3 ;2;6;121;0;2;0;2;2;0;0;0;2
3719; 29.9 ; 59.7 ; 7.2 ;2;15;150;0;2;1;1;0;2;1;1;0
3720; 16.4 ; 32.8 ; 2.1 ;2;144;187;0;2;2;0;2;0;2;0;0
3721; 23.4 ; 70.2 ; 8.2 ;3;92;221;0;3;2;1;1;2;2;1;0
3722; 30.2 ; 60.4 ; -   ;2;94;168;0;2;0;2;0;2;0;2;0
3723; 97.9 ; 293.8 ; 82.0 ;3;138;53;0;3;1;2;2;1;1;0;2
3724; 97.9 ; 293.8 ; 88.6 ;3;14;292;0;3;2;1;2;1;1;0;2
3725; 15.0 ; 104.9 ; -   ;7;16;110;0;7;5;2;0;7;7;0;0
3726; 44.7 ; 178.6 ; 48.7 ;4;135;8;0;4;2;2;1;3;1;2;1
3727; 15.7 ; 62.8 ; 1.5 ;4;49;95;0;4;0;4;2;2;4;0;0
3728; 50.5 ; 252.5 ; 15.1 ;5;50;26;0;5;0;5;4;1;0;3;2
3729; 38.8 ; 77.6 ; 20.5 ;2;65;146;2;0;1;1;0;2;1;0;1
3730; 15.0 ; 30.0 ; -   ;2;1;102;0;2;2;0;0;2;2;0;0
3731; 41.6 ; 207.9 ; 9.9 ;5;22;11;0;5;3;2;2;3;0;5;0
3732; 62.3 ; 124.6 ; 8.0 ;2;2;273;0;2;1;1;0;2;0;0;2
3733; 24.0 ; 455.4 ; 12.5 ;19;14;77;0;19;8;11;6;13;13;6;0
3734; 20.0 ; 59.9 ; 9.2 ;3;20;319;0;3;1;2;1;2;3;0;0
3735; 27.8 ; 306.3 ; 6.9 ;11;33;6;1;10;0;11;3;8;7;4;0
3736; 37.4 ; 298.9 ; 25.6 ;8;12;32;0;8;3;5;3;5;3;2;3
3737; 48.6 ; 291.6 ; 22.8 ;6;14;299;0;6;1;5;3;3;2;2;2
3738; 44.4 ; 266.7 ; 25.9 ;6;3;285;0;6;3;3;4;2;2;2;2
3739; 20.3 ; 40.6 ; 1.2 ;2;1;252;0;2;0;2;0;2;2;0;0
3740; 19.2 ; 95.8 ; 7.0 ;5;38;110;0;5;0;5;2;3;5;0;0
3741; 44.7 ; 89.4 ; 13.0 ;2;25;164;0;2;0;2;0;2;0;1;1
3742; 67.4 ; 202.3 ; 7.3 ;3;75;42;0;3;1;2;2;1;0;0;3
3743; 25.1 ; 50.1 ; -   ;2;20;83;0;2;0;2;2;0;2;0;0
3744; 91.6 ; 1,556.4 ; 47.0 ;17;12;83;0;17;3;14;14;3;0;0;17
3745; 55.7 ; 334.5 ; 27.5 ;6;50;0;0;6;0;6;3;3;2;0;4
3746; 23.8 ; 95.3 ; 6.7 ;4;62;141;0;4;3;1;2;2;3;1;0
3747; 20.7 ; 248.4 ; 7.3 ;12;4;260;0;12;5;7;3;9;12;0;0
3748; 18.3 ; 55.0 ; 6.2 ;3;43;40;0;3;3;0;3;0;3;0;0
3749; 40.8 ; 326.5 ; 19.0 ;8;11;131;0;8;1;7;4;4;3;2;3
3750; 33.1 ; 264.9 ; 9.2 ;8;30;17;0;8;6;2;2;6;3;5;0
3751; 40.6 ; 202.9 ; 15.0 ;5;49;11;0;5;0;5;5;0;2;1;2
3752; 26.7 ; 106.9 ; 16.0 ;4;79;92;0;4;4;0;2;2;3;1;0
3753; 31.8 ; 95.4 ; 8.3 ;3;45;40;0;3;2;1;1;2;1;2;0
3754; 29.6 ; 148.2 ; 25.4 ;5;54;52;0;5;0;5;2;3;3;0;2
3755; 38.4 ; 76.7 ; 35.0 ;2;203;89;0;2;1;1;0;2;1;0;1
3756; 26.2 ; 235.8 ; 5.5 ;9;35;11;0;9;6;3;1;8;6;3;0
3757; 35.4 ; 177.1 ; 9.4 ;5;75;28;0;5;1;4;2;3;2;3;0
3758; 102.1 ; 306.2 ; 32.7 ;3;25;110;0;3;0;3;3;0;0;0;3
3759; 20.9 ; 397.3 ; 4.7 ;19;12;2;0;19;5;14;10;9;19;0;0
3760; 33.2 ; 431.5 ; 11.4 ;13;32;23;0;13;4;9;3;10;4;9;0
3761; 68.4 ; 136.9 ; 31.4 ;2;16;85;0;2;0;2;2;0;0;0;2
3762; 27.8 ; 139.2 ; 10.7 ;5;49;236;0;5;3;2;1;4;3;2;0
3763; 19.8 ; 98.8 ; 6.6 ;5;22;191;0;5;5;0;2;3;5;0;0
3764; 51.4 ; 205.7 ; 3.3 ;4;88;68;0;4;0;4;4;0;0;4;0
3765; 36.4 ; 109.1 ; 11.9 ;3;18;42;0;3;0;3;0;3;1;2;0
3766; 21.5 ; 86.2 ; 6.4 ;4;23;2;0;4;1;3;2;2;4;0;0
3767; 18.6 ; 37.2 ; -   ;2;9;264;0;2;2;0;2;0;2;0;0
3768; 22.5 ; 44.9 ; 11.2 ;2;7;177;0;2;1;1;2;0;1;1;0
3769; 78.6 ; 393.2 ; 43.7 ;5;77;142;0;5;1;4;4;1;0;0;5
3770; 28.3 ; 56.7 ; 2.7 ;2;77;35;0;2;1;1;1;1;1;1;0
3771; 59.1 ; 295.5 ; 15.1 ;5;88;74;0;5;0;5;1;4;0;0;5
3772; 66.9 ; 334.5 ; 42.4 ;5;76;15;0;5;0;5;3;2;2;0;3
3773; 33.4 ; 401.4 ; 21.6 ;12;15;32;0;12;0;12;9;3;4;4;4
3774; 35.3 ; 282.5 ; 4.1 ;8;16;23;1;7;4;4;2;6;0;8;0
3775; 84.6 ; 422.9 ; 21.9 ;5;45;5;0;5;0;5;5;0;0;0;5
3776; 28.7 ; 603.0 ; 10.1 ;21;14;0;0;21;6;15;5;16;14;7;0
3777; 49.6 ; 247.8 ; 8.7 ;5;54;11;0;5;0;5;0;5;0;3;2
3778; 41.2 ; 370.9 ; 43.6 ;9;14;243;0;9;6;3;3;6;3;3;3
3779; 46.1 ; 138.2 ; 14.6 ;3;59;42;3;0;2;1;1;2;0;2;1
3780; 36.1 ; 72.3 ; 26.8 ;2;106;0;2;0;0;2;2;0;1;0;1
3781; 15.0 ; 30.0 ; -   ;2;1;38;0;2;2;0;1;1;2;0;0
3782; 18.9 ; 37.9 ; 5.9 ;2;1;1;0;2;1;1;1;1;2;0;0
3783; 28.5 ; 170.7 ; 15.2 ;6;19;64;0;6;0;6;4;2;4;2;0
3784; 48.7 ; 97.4 ; -   ;2;113;104;0;2;0;2;0;2;0;2;0
3785; 28.1 ; 337.1 ; 12.9 ;12;19;11;0;12;8;4;8;4;8;4;0
3786; 48.7 ; 97.3 ; 0.1 ;2;13;251;0;2;0;2;0;2;0;2;0
3787; 52.3 ; 470.6 ; 3.3 ;9;22;22;0;9;0;9;9;0;0;6;3
3788; 36.5 ; 73.0 ; 9.5 ;2;19;346;0;2;0;2;2;0;1;1;0
3789; 53.8 ; 268.8 ; 28.0 ;5;31;94;0;5;3;2;2;3;2;1;2
3790; 34.3 ; 171.7 ; 18.8 ;5;64;52;0;5;1;4;1;4;2;3;0
3791; 47.3 ; 94.5 ; 25.9 ;2;6;211;0;2;0;2;2;0;1;0;1
3792; 24.0 ; 95.8 ; 4.6 ;4;16;209;0;4;2;2;3;1;4;0;0
3793; 54.7 ; 109.4 ; 8.0 ;2;25;26;0;2;0;2;2;0;0;1;1
3794; 25.8 ; 103.2 ; 13.2 ;4;68;96;0;4;3;1;0;4;3;1;0
3795; 19.5 ; 156.0 ; 7.7 ;8;20;53;0;8;6;2;5;3;8;0;0
3796; 29.8 ; 59.5 ; 7.0 ;2;18;69;0;2;0;2;0;2;1;1;0
3797; 17.7 ; 177.1 ; 6.4 ;10;16;73;0;10;0;10;3;7;10;0;0
3798; 60.1 ; 660.7 ; 33.9 ;11;36;65;0;11;3;8;1;10;4;0;7
3799; 77.2 ; 385.9 ; 12.4 ;5;54;152;0;5;1;4;1;4;0;0;5
3800; 39.5 ; 118.6 ; 13.3 ;3;74;128;0;3;1;2;3;0;1;2;0
3801; 28.7 ; 229.4 ; 7.6 ;8;22;31;0;8;4;4;8;0;5;3;0
3802; 45.2 ; 135.6 ; 15.8 ;3;117;38;0;3;0;3;3;0;1;1;1
3803; 61.7 ; 123.5 ; -   ;2;18;209;0;2;0;2;2;0;0;0;2
3804; 60.3 ; 361.9 ; 43.1 ;6;25;96;0;6;3;3;3;3;2;0;4
3805; 15.0 ; 59.9 ; -   ;4;14;104;4;0;3;1;1;3;4;0;0
3806; 50.3 ; 151.0 ; 6.6 ;3;41;110;0;3;0;3;2;1;0;2;1
3807; 50.9 ; 356.0 ; 27.5 ;7;44;2;0;7;6;1;1;6;2;3;2
3808; 61.3 ; 245.1 ; 26.8 ;4;14;246;0;4;1;3;2;2;0;0;4
3809; 25.8 ; 51.6 ; 16.2 ;2;28;39;0;2;1;1;2;0;1;1;0
3810; 40.3 ; 80.5 ; 16.1 ;2;2;258;0;2;1;1;1;1;1;0;1
3811; 42.5 ; 594.4 ; 19.1 ;14;13;32;0;14;5;9;7;7;5;4;5
3812; 46.8 ; 93.5 ; -   ;2;155;143;0;2;1;1;0;2;0;2;0
3813; 47.1 ; 659.1 ; 11.9 ;14;21;28;0;14;3;11;6;8;0;9;5
3814; 51.3 ; 154.0 ; 14.7 ;3;13;62;0;3;0;3;2;1;0;2;1
3815; 49.6 ; 99.3 ; 4.3 ;2;275;152;0;2;1;1;2;0;0;2;0
3816; 38.3 ; 76.6 ; 15.6 ;2;111;132;0;2;0;2;2;0;1;1;0
3817; 49.5 ; 1,138.4 ; 30.6 ;23;19;4;0;23;12;11;4;19;8;7;8
3818; 15.5 ; 263.1 ; 1.6 ;17;21;36;0;17;3;14;10;7;17;0;0
3819; 47.0 ; 141.0 ; 0.4 ;3;124;40;0;3;1;2;1;2;0;3;0
3820; 34.6 ; 103.8 ; 16.8 ;3;182;58;0;3;0;3;1;2;1;2;0
3821; 52.5 ; 157.5 ; -   ;3;59;267;0;3;1;2;3;0;0;3;0
3822; 27.2 ; 81.7 ; 8.8 ;3;39;155;2;1;1;2;3;0;2;1;0
3823; 136.2 ; 2,997.4 ; 40.0 ;22;16;0;0;22;0;22;22;0;0;0;22
3824; 16.7 ; 83.3 ; 4.4 ;5;40;20;0;5;1;4;2;3;5;0;0
3825; 42.4 ; 127.1 ; 16.2 ;3;72;25;0;3;3;0;3;0;1;1;1
3826; 138.3 ; 691.7 ; 43.7 ;5;49;6;1;4;1;4;3;2;0;0;5
3827; 29.6 ; 59.1 ; 7.3 ;2;163;20;0;2;0;2;1;1;1;1;0
3828; 43.8 ; 87.7 ; 20.4 ;2;50;167;2;0;0;2;2;0;1;0;1
3829; 36.0 ; 108.0 ; 1.9 ;3;76;57;0;3;0;3;3;0;0;3;0
3830; 49.1 ; 98.3 ; 18.8 ;2;24;257;0;2;0;2;2;0;0;1;1
3831; 25.1 ; 50.1 ; -   ;2;6;304;0;2;0;2;1;1;2;0;0
3832; 61.0 ; 244.2 ; 53.2 ;4;76;73;0;4;0;4;1;3;1;0;3
3833; 19.8 ; 316.9 ; 7.2 ;16;10;23;0;16;8;8;3;13;16;0;0
3834; 52.7 ; 684.7 ; 9.9 ;13;23;20;0;13;1;12;10;3;0;9;4
3835; 30.0 ; 59.9 ; -   ;2;6;161;0;2;2;0;0;2;2;0;0
3836; 71.0 ; 283.9 ; 20.2 ;4;33;226;0;4;0;4;2;2;0;0;4
3837; 47.7 ; 95.5 ; 1.5 ;2;88;216;0;2;1;1;1;1;0;2;0
3838; 27.3 ; 81.8 ; 11.8 ;3;8;261;0;3;3;0;1;2;2;1;0
3839; 60.8 ; 303.9 ; 11.6 ;5;57;63;0;5;0;5;0;5;0;0;5
3840; 15.9 ; 47.8 ; 1.7 ;3;40;209;0;3;2;1;1;2;3;0;0
3841; 54.7 ; 109.5 ; 1.9 ;2;56;99;0;2;0;2;2;0;0;1;1
3842; 25.7 ; 77.2 ; 9.2 ;3;14;86;0;3;1;2;1;2;2;1;0
3843; 22.3 ; 89.3 ; 9.8 ;4;46;278;0;4;2;2;2;2;3;1;0
3844; 54.1 ; 108.2 ; 11.0 ;2;133;152;0;2;0;2;2;0;0;1;1
3845; 45.9 ; 229.4 ; 5.6 ;5;52;72;0;5;2;3;3;2;0;5;0
3846; 51.8 ; 362.9 ; 26.4 ;7;31;155;0;7;0;7;5;2;2;3;2
3847; 31.5 ; 472.6 ; 11.5 ;15;18;8;0;15;9;6;15;0;5;10;0
3848; 15.0 ; 45.0 ; -   ;3;13;263;0;3;0;3;2;1;3;0;0
3849; 30.0 ; 89.9 ; 15.9 ;3;70;178;0;3;1;2;0;3;2;1;0
3850; 52.5 ; 105.0 ; -   ;2;38;155;2;0;2;0;2;0;0;2;0
3851; 52.2 ; 313.0 ; 11.6 ;6;38;8;0;6;2;4;2;4;0;4;2
3852; 29.6 ; 59.3 ; 6.8 ;2;80;163;0;2;1;1;0;2;1;1;0
3853; 30.2 ; 60.4 ; -   ;2;14;135;2;0;1;1;0;2;0;2;0
3854; 28.7 ; 401.6 ; 12.8 ;14;11;42;0;14;4;10;9;5;9;5;0
3855; 33.2 ; 66.5 ; 20.3 ;2;3;90;0;2;1;1;1;1;1;1;0
3856; 35.6 ; 284.4 ; 11.4 ;8;48;37;1;7;2;6;4;4;3;5;0
3857; 18.6 ; 55.7 ; -   ;3;41;107;0;3;3;0;1;2;3;0;0
3858; 49.2 ; 491.8 ; 21.3 ;10;27;52;0;10;0;10;8;2;3;4;3
3859; 18.8 ; 93.8 ; 4.4 ;5;11;241;0;5;2;3;2;3;5;0;0
3860; 75.2 ; 150.3 ; 79.1 ;2;234;78;0;2;0;2;1;1;1;0;1
3861; 46.6 ; 233.0 ; 12.4 ;5;57;78;0;5;1;4;4;1;0;3;2
3862; 43.1 ; 215.7 ; 11.2 ;5;37;11;0;5;1;4;2;3;0;5;0
3863; 65.7 ; 197.2 ; 29.5 ;3;122;53;0;3;2;1;2;1;0;0;3
3864; 50.2 ; 100.4 ; 11.0 ;2;51;99;0;2;0;2;1;1;0;1;1
3865; 76.8 ; 153.5 ; 22.0 ;2;11;253;0;2;0;2;2;0;0;0;2
3866; 86.9 ; 781.8 ; 48.0 ;9;20;85;0;9;0;9;9;0;0;0;9
3867; 32.7 ; 850.6 ; 14.5 ;26;9;5;0;26;0;26;22;4;9;17;0
3868; 49.0 ; 147.0 ; 18.4 ;3;16;86;3;0;2;1;1;2;0;2;1
3869; 34.2 ; 171.1 ; 20.6 ;5;79;6;0;5;0;5;3;2;2;3;0
3870; 66.6 ; 665.7 ; 45.1 ;10;36;5;0;10;3;7;7;3;3;0;7
3871; 36.8 ; 73.6 ; 16.0 ;2;2;94;0;2;1;1;0;2;1;1;0
3872; 16.3 ; 342.4 ; 3.7 ;21;14;6;0;21;12;9;9;12;21;0;0
3873; 20.9 ; 104.3 ; 6.7 ;5;21;0;0;5;3;2;3;2;5;0;0
3874; 23.4 ; 117.1 ; 14.2 ;5;43;25;0;5;2;3;3;2;3;2;0
3875; 69.4 ; 347.1 ; 32.8 ;5;8;69;0;5;1;4;4;1;0;0;5
3876; 27.9 ; 55.8 ; 13.9 ;2;4;273;0;2;1;1;2;0;1;1;0
3877; 48.9 ; 293.4 ; 14.1 ;6;50;20;0;6;0;6;3;3;0;4;2
3878; 23.1 ; 69.3 ; 6.4 ;3;60;176;0;3;2;1;2;1;3;0;0
3879; 49.7 ; 447.6 ; 14.4 ;9;30;137;0;9;3;6;6;3;0;6;3
3880; 32.2 ; 225.4 ; 17.2 ;7;40;2;0;7;3;4;4;3;2;5;0
3881; 15.3 ; 153.1 ; 1.2 ;10;17;77;10;0;10;0;10;0;10;0;0
3882; 36.3 ; 1,053.3 ; 14.2 ;29;3;321;0;29;17;12;11;18;10;19;0
3883; 33.7 ; 134.7 ; 19.6 ;4;60;105;0;4;2;2;3;1;1;3;0
3884; 54.8 ; 657.9 ; 18.9 ;12;19;12;0;12;6;6;10;2;0;8;4
3885; 43.2 ; 86.4 ; 0.5 ;2;107;73;0;2;0;2;2;0;0;2;0
3886; 30.6 ; 91.9 ; 16.8 ;3;11;251;0;3;1;2;3;0;1;2;0
3887; 32.5 ; 195.0 ; 11.4 ;6;46;43;0;6;0;6;3;3;2;4;0
3888; 66.2 ; 1,390.3 ; 27.5 ;21;17;7;2;19;2;19;12;9;0;0;21
3889; 77.8 ; 155.5 ; 46.4 ;2;5;346;0;2;1;1;0;2;0;0;2
3890; 20.6 ; 144.5 ; 6.0 ;7;16;9;0;7;6;1;3;4;7;0;0
3891; 47.6 ; 381.1 ; 4.7 ;8;25;24;0;8;0;8;7;1;0;8;0
3892; 51.5 ; 205.8 ; 13.1 ;4;59;26;0;4;2;2;2;2;0;3;1
3893; 15.0 ; 30.0 ; -   ;2;33;141;0;2;0;2;0;2;2;0;0
3894; 28.0 ; 475.8 ; 11.7 ;17;22;6;0;17;4;13;14;3;11;6;0
3895; 21.6 ; 108.1 ; 15.7 ;5;26;5;0;5;4;1;4;1;3;2;0
3896; 17.9 ; 89.3 ; 2.8 ;5;13;268;0;5;2;3;3;2;5;0;0
3897; 48.5 ; 145.4 ; 26.7 ;3;89;93;0;3;1;2;3;0;1;1;1
3898; 61.1 ; 977.6 ; 20.9 ;16;21;10;0;16;0;16;14;2;0;0;16
3899; 34.0 ; 136.1 ; 26.3 ;4;2;102;0;4;3;1;0;4;1;2;1
3900; 41.2 ; 329.7 ; 13.1 ;8;43;95;0;8;0;8;3;5;3;5;0
3901; 43.4 ; 216.9 ; 11.2 ;5;68;57;0;5;0;5;3;2;0;5;0
3902; 40.8 ; 163.1 ; 18.3 ;4;30;8;0;4;1;3;1;3;1;2;1
3903; 52.7 ; 158.1 ; 37.5 ;3;82;26;3;0;1;2;2;1;1;1;1
3904; 39.6 ; 356.3 ; 8.8 ;9;29;170;0;9;3;6;5;4;0;9;0
3905; 28.7 ; 143.4 ; 14.3 ;5;4;1;0;5;3;2;2;3;3;2;0
3906; 54.5 ; 327.3 ; 18.3 ;6;66;26;0;6;0;6;6;0;0;4;2
3907; 56.6 ; 226.5 ; 26.3 ;4;49;36;1;3;0;4;4;0;0;0;4
3908; 35.3 ; 176.6 ; 16.2 ;5;77;15;0;5;2;3;2;3;2;3;0
3909; 31.7 ; 126.7 ; 25.8 ;4;6;11;0;4;2;2;4;0;1;2;1
3910; 15.7 ; 47.0 ; 1.3 ;3;2;110;0;3;2;1;2;1;3;0;0
3911; 30.9 ; 61.7 ; 23.8 ;2;23;163;0;2;0;2;1;1;1;1;0
3912; 24.6 ; 73.8 ; 0.6 ;3;160;1;0;3;2;1;1;2;3;0;0
3913; 89.2 ; 446.1 ; 25.1 ;5;59;31;0;5;0;5;3;2;0;0;5
3914; 46.8 ; 187.0 ; 15.8 ;4;68;5;1;3;3;1;1;3;0;3;1
3915; 29.6 ; 207.4 ; 15.2 ;7;16;168;0;7;0;7;5;2;5;2;0
3916; 37.6 ; 263.5 ; 14.3 ;7;37;26;0;7;0;7;5;2;2;5;0
3917; 27.2 ; 54.5 ; 10.8 ;2;86;68;1;1;1;1;2;0;1;1;0
3918; 48.1 ; 192.3 ; 24.8 ;4;73;190;0;4;1;3;1;3;1;2;1
3919; 63.1 ; 505.2 ; 20.6 ;8;14;262;0;8;3;5;4;4;0;0;8
3920; 35.7 ; 1,035.8 ; 11.6 ;29;9;0;18;11;0;29;10;19;10;19;0
3921; 20.7 ; 683.0 ; 7.4 ;33;7;1;0;33;21;12;32;1;33;0;0
3922; 15.0 ; 89.9 ; -   ;6;23;103;0;6;3;3;2;4;6;0;0
3923; 49.6 ; 248.2 ; 16.8 ;5;34;115;0;5;1;4;0;5;0;3;2
3924; 65.4 ; 261.4 ; 22.8 ;4;28;121;1;3;2;2;3;1;0;0;4
3925; 37.6 ; 375.5 ; 33.3 ;10;45;22;0;10;2;8;4;6;3;4;3
3926; 40.1 ; 80.1 ; -   ;2;38;246;0;2;0;2;0;2;0;2;0
3927; 36.4 ; 72.9 ; 15.4 ;2;29;242;0;2;1;1;1;1;1;1;0
3928; 16.7 ; 83.3 ; 4.4 ;5;32;2;0;5;3;2;5;0;5;0;0
3929; 36.8 ; 110.5 ; 17.0 ;3;44;2;0;3;3;0;3;0;1;2;0
3930; 26.0 ; 130.0 ; 4.1 ;5;3;141;0;5;2;3;3;2;3;2;0
3931; 25.1 ; 50.1 ; -   ;2;68;231;0;2;1;1;1;1;2;0;0
3932; 22.5 ; 44.9 ; 11.2 ;2;7;90;0;2;1;1;2;0;1;1;0
3933; 28.8 ; 605.3 ; 12.6 ;21;4;2;0;21;8;13;7;14;14;7;0
3934; 46.8 ; 93.5 ; -   ;2;24;242;0;2;0;2;1;1;0;2;0
3935; 19.6 ; 39.3 ; 7.0 ;2;20;195;0;2;1;1;1;1;2;0;0
3936; 39.9 ; 359.4 ; 8.5 ;9;31;57;0;9;4;5;4;5;0;9;0
3937; 53.8 ; 376.3 ; 13.7 ;7;26;5;0;7;1;6;4;3;0;5;2
3938; 15.0 ; 74.9 ; -   ;5;58;1;0;5;2;3;5;0;5;0;0
3939; 35.8 ; 358.1 ; 21.0 ;10;19;22;0;10;3;7;6;4;3;4;3
3940; 25.7 ; 179.6 ; 24.2 ;7;48;5;0;7;2;5;7;0;5;2;0
3941; 35.7 ; 250.0 ; 6.5 ;7;23;31;0;7;2;5;4;3;2;5;0
3942; 60.1 ; 300.7 ; 21.4 ;5;23;45;0;5;2;3;3;2;0;0;5
3943; 18.4 ; 91.9 ; 1.9 ;5;52;73;0;5;0;5;5;0;5;0;0
3944; 56.4 ; 112.8 ; 12.3 ;2;2;2;0;2;2;0;1;1;0;0;2
3945; 47.1 ; 94.2 ; 0.5 ;2;240;73;0;2;0;2;0;2;0;2;0
3946; 46.8 ; 93.5 ; -   ;2;26;246;0;2;0;2;1;1;0;2;0
3947; 46.2 ; 369.4 ; 19.3 ;8;29;1;1;7;2;6;4;4;3;2;3
3948; 44.1 ; 220.7 ; 25.5 ;5;34;23;0;5;4;1;4;1;2;1;2
3949; 23.1 ; 69.4 ; 14.1 ;3;76;23;0;3;2;1;2;1;2;1;0
3950; 18.3 ; 55.0 ; 6.2 ;3;18;78;0;3;1;2;1;2;3;0;0
3951; 52.9 ; 264.4 ; 9.0 ;5;30;20;0;5;1;4;3;2;0;3;2
3952; 62.7 ; 188.2 ; 9.4 ;3;76;26;0;3;1;2;3;0;0;0;3
3953; 34.7 ; 866.4 ; 3.6 ;25;16;0;0;25;4;21;10;15;0;25;0
3954; 31.4 ; 282.7 ; 17.1 ;9;31;68;2;7;3;6;2;7;3;6;0
3955; 49.3 ; 591.6 ; 17.2 ;12;35;17;0;12;7;5;5;7;0;8;4
3956; 49.7 ; 199.0 ; 5.1 ;4;126;32;2;2;0;4;4;0;0;4;0
3957; 54.4 ; 163.3 ; 7.8 ;3;126;5;0;3;1;2;0;3;0;2;1
3958; 55.0 ; 219.9 ; 18.8 ;4;44;159;0;4;2;2;3;1;0;3;1
3959; 46.8 ; 93.5 ; -   ;2;53;110;0;2;1;1;0;2;0;2;0
3960; 43.1 ; 129.4 ; 9.2 ;3;24;34;0;3;2;1;2;1;0;3;0
3961; 43.4 ; 173.7 ; 17.9 ;4;30;245;0;4;2;2;2;2;1;2;1
3962; 58.7 ; 352.4 ; 25.3 ;6;33;94;0;6;0;6;2;4;0;0;6
3963; 48.9 ; 97.8 ; 3.2 ;2;176;162;0;2;0;2;2;0;0;2;0
3964; 36.3 ; 653.3 ; 12.2 ;18;23;9;18;0;15;3;13;5;6;12;0
3965; 22.1 ; 110.6 ; 2.4 ;5;66;20;0;5;3;2;1;4;5;0;0
3966; 31.5 ; 94.4 ; 5.4 ;3;68;158;0;3;2;1;1;2;1;2;0
3967; 39.3 ; 196.6 ; 20.7 ;5;25;92;0;5;1;4;2;3;2;1;2
3968; 52.2 ; 104.4 ; 1.0 ;2;1;278;0;2;0;2;0;2;0;2;0
3969; 42.1 ; 1,051.7 ; 34.9 ;25;7;33;0;25;15;10;9;16;8;9;8
3970; 28.9 ; 57.9 ; 20.9 ;2;74;241;0;2;1;1;0;2;1;1;0
3971; 74.2 ; 148.5 ; 1.8 ;2;60;194;0;2;1;1;2;0;0;0;2
3972; 25.1 ; 50.1 ; -   ;2;23;109;0;2;2;0;0;2;2;0;0
3973; 26.2 ; 78.7 ; 20.6 ;3;47;15;0;3;0;3;0;3;2;1;0
3974; 24.0 ; 167.9 ; 7.4 ;7;14;79;0;7;4;3;3;4;5;2;0
3975; 50.5 ; 151.6 ; 24.1 ;3;174;22;1;2;1;2;2;1;1;1;1
3976; 70.8 ; 354.1 ; 30.3 ;5;70;69;0;5;1;4;3;2;0;0;5
3977; 31.5 ; 157.5 ; 12.8 ;5;37;230;0;5;3;2;2;3;2;3;0
3978; 47.0 ; 235.0 ; 10.2 ;5;51;8;4;1;0;5;2;3;0;3;2
3979; 39.2 ; 156.9 ; 12.6 ;4;10;254;0;4;4;0;1;3;1;3;0
3980; 45.3 ; 90.7 ; 2.6 ;2;142;41;0;2;1;1;2;0;0;2;0
3981; 67.6 ; 135.1 ; 30.9 ;2;134;162;0;2;0;2;2;0;0;0;2
3982; 61.4 ; 675.4 ; 30.4 ;11;23;42;0;11;2;9;9;2;0;0;11
3983; 53.0 ; 159.0 ; 0.9 ;3;95;20;0;3;0;3;2;1;0;3;0
3984; 67.7 ; 135.4 ; 15.5 ;2;12;194;2;0;0;2;2;0;0;0;2
3985; 44.6 ; 89.2 ; 0.3 ;2;10;240;0;2;2;0;2;0;0;2;0
3986; 82.9 ; 580.1 ; 30.3 ;7;44;32;0;7;0;7;5;2;0;0;7
3987; 77.7 ; 777.0 ; 14.3 ;10;13;15;0;10;0;10;10;0;0;0;10
3988; 42.6 ; 85.3 ; 9.1 ;2;3;250;0;2;1;1;1;1;0;2;0
3989; 60.3 ; 120.6 ; 20.1 ;2;10;333;0;2;1;1;1;1;0;0;2
3990; 39.7 ; 158.8 ; 17.5 ;4;115;5;0;4;0;4;4;0;1;2;1
3991; 17.8 ; 88.8 ; 6.6 ;5;7;18;0;5;4;1;1;4;5;0;0
3992; 70.7 ; 282.8 ; 13.1 ;4;83;68;0;4;2;2;3;1;0;0;4
3993; 27.4 ; 136.8 ; 12.5 ;5;7;280;0;5;3;2;4;1;3;2;0
3994; 18.6 ; 260.0 ; 4.2 ;14;8;32;0;14;11;3;4;10;14;0;0
3995; 15.0 ; 45.0 ; -   ;3;108;71;1;2;1;2;1;2;3;0;0
3996; 19.7 ; 59.2 ; -   ;3;59;124;3;0;3;0;3;0;3;0;0
3997; 52.8 ; 105.7 ; 7.0 ;2;87;20;1;1;1;1;1;1;0;1;1
3998; 14.7 ; 29.4 ; -   ;2;11;263;0;2;0;2;1;1;2;0;0
3999; 158.9 ; 317.9 ; 76.5 ;2;37;141;0;2;0;2;2;0;0;0;2
4000; 64.7 ; 323.3 ; 23.9 ;5;24;65;5;0;5;0;4;1;0;0;5
4001; 32.9 ; 230.4 ; 15.8 ;7;21;274;0;7;2;5;5;2;2;5;0
4002; 15.7 ; 63.0 ; 1.6 ;4;14;120;0;4;1;3;2;2;4;0;0
4003; 78.7 ; 393.5 ; 81.9 ;5;29;62;0;5;3;2;3;2;2;0;3
4004; 20.9 ; 271.1 ; 9.2 ;13;19;99;0;13;2;11;7;6;9;4;0
4005; 37.4 ; 112.1 ; 13.2 ;3;72;65;0;3;1;2;2;1;1;2;0
4006; 38.7 ; 77.4 ; 3.2 ;2;176;136;0;2;0;2;2;0;0;2;0
4007; 45.4 ; 272.4 ; 4.1 ;6;39;95;0;6;0;6;5;1;0;6;0
4008; 56.0 ; 168.0 ; 32.3 ;3;85;10;0;3;0;3;2;1;1;0;2
4009; 42.7 ; 981.8 ; 17.7 ;23;14;26;0;23;5;18;11;12;8;7;8
4010; 33.3 ; 166.4 ; 3.8 ;5;24;168;0;5;0;5;2;3;2;3;0
4011; 37.1 ; 74.1 ; 24.2 ;2;21;38;0;2;2;0;1;1;1;0;1
4012; 27.8 ; 555.7 ; 25.6 ;20;16;4;0;20;8;12;7;13;13;7;0
4013; 29.3 ; 87.9 ; 17.4 ;3;9;47;0;3;0;3;1;2;2;1;0
4014; 70.5 ; 352.7 ; 19.0 ;5;43;42;0;5;0;5;3;2;0;0;5
4015; 15.0 ; 45.0 ; -   ;3;72;230;0;3;0;3;3;0;3;0;0
4016; 32.2 ; 193.5 ; 13.7 ;6;53;5;0;6;0;6;4;2;2;4;0
4017; 32.8 ; 131.2 ; 4.7 ;4;8;201;0;4;3;1;2;2;1;3;0
4018; 33.0 ; 297.0 ; 7.9 ;9;36;5;1;8;3;6;6;3;3;6;0
4019; 23.1 ; 46.2 ; 3.0 ;2;6;65;0;2;2;0;0;2;2;0;0
4020; 52.6 ; 263.0 ; 6.1 ;5;35;25;0;5;2;3;2;3;0;3;2
4021; 60.3 ; 1,084.9 ; 41.1 ;18;16;0;0;18;6;12;16;2;6;0;12
4022; 55.8 ; 1,004.0 ; 27.3 ;18;16;5;0;18;0;18;17;1;6;0;12
4023; 23.7 ; 166.1 ; 13.5 ;7;19;108;0;7;1;6;1;6;5;2;0
4024; 17.5 ; 245.5 ; 3.8 ;14;14;3;0;14;11;3;14;0;14;0;0
4025; 89.7 ; 179.4 ; 19.7 ;2;8;303;0;2;1;1;0;2;0;0;2
4026; 53.5 ; 1,122.8 ; 29.1 ;21;11;98;0;21;6;15;18;3;7;7;7
4027; 16.4 ; 311.9 ; 4.8 ;19;6;5;1;18;6;13;7;12;19;0;0
4028; 25.1 ; 50.1 ; -   ;2;58;170;0;2;2;0;0;2;2;0;0
4029; 63.3 ; 189.9 ; 5.2 ;3;22;110;0;3;0;3;2;1;0;0;3
4030; 47.7 ; 95.4 ; 1.4 ;2;68;126;0;2;0;2;2;0;0;2;0
4031; 24.0 ; 95.9 ; 7.4 ;4;44;78;0;4;0;4;2;2;3;1;0
4032; 25.1 ; 50.1 ; -   ;2;95;204;0;2;0;2;1;1;2;0;0
4033; 74.9 ; 149.8 ; 41.0 ;2;62;0;0;2;0;2;2;0;0;0;2
4034; 41.5 ; 207.7 ; 18.6 ;5;95;5;0;5;1;4;3;2;2;1;2
4035; 20.6 ; 61.9 ; 5.9 ;3;3;235;0;3;2;1;3;0;3;0;0
4036; 89.7 ; 448.3 ; 6.1 ;5;48;114;0;5;3;2;5;0;0;0;5
4037; 43.4 ; 651.0 ; 14.1 ;15;12;233;0;15;2;13;11;4;5;5;5
4038; 49.6 ; 99.1 ; -   ;2;107;127;0;2;1;1;0;2;0;2;0
4039; 64.1 ; 128.1 ; 19.6 ;2;15;255;0;2;1;1;1;1;0;0;2
4040; 38.1 ; 76.3 ; 28.0 ;2;52;47;2;0;1;1;0;2;1;0;1
4041; 64.8 ; 323.9 ; 10.0 ;5;35;21;0;5;3;2;2;3;0;0;5
4042; 36.2 ; 108.5 ; 19.4 ;3;88;257;0;3;1;2;2;1;1;1;1
4043; 38.6 ; 425.1 ; 18.3 ;11;39;10;0;11;1;10;9;2;4;3;4
4044; 27.5 ; 220.3 ; 2.5 ;8;36;6;0;8;3;5;1;7;5;3;0
4045; 45.9 ; 137.7 ; 13.5 ;3;8;40;0;3;2;1;2;1;0;2;1
4046; 32.8 ; 65.6 ; 5.7 ;2;9;322;0;2;1;1;2;0;1;1;0
4047; 30.0 ; 60.1 ; 0.5 ;2;9;360;0;2;1;1;0;2;1;1;0
4048; 49.7 ; 795.5 ; 6.6 ;16;19;12;0;16;12;4;2;14;0;11;5
4049; 22.5 ; 89.8 ; 6.7 ;4;13;241;0;4;0;4;4;0;4;0;0
4050; 53.3 ; 480.1 ; 14.6 ;9;18;247;0;9;2;7;4;5;0;6;3
4051; 31.6 ; 94.9 ; 12.0 ;3;29;220;0;3;1;2;1;2;1;2;0
4052; 19.0 ; 95.1 ; 5.9 ;5;19;288;0;5;0;5;5;0;5;0;0
4053; 34.2 ; 68.4 ; 6.0 ;2;32;121;0;2;0;2;0;2;1;1;0
4054; 45.6 ; 91.1 ; 11.5 ;2;34;15;0;2;1;1;0;2;0;1;1
4055; 27.3 ; 109.2 ; 16.5 ;4;95;6;0;4;1;3;3;1;3;1;0
4056; 27.5 ; 247.4 ; 7.8 ;9;20;151;1;8;6;3;9;0;6;3;0
4057; 17.6 ; 35.2 ; 3.9 ;2;105;177;0;2;2;0;2;0;2;0;0
4058; 15.8 ; 79.2 ; 2.0 ;5;15;53;5;0;2;3;2;3;5;0;0
4059; 41.6 ; 541.2 ; 15.9 ;13;19;62;0;13;2;11;10;3;4;5;4
4060; 81.5 ; 570.4 ; 71.8 ;7;49;16;0;7;0;7;2;5;2;0;5
4061; 38.0 ; 456.5 ; 24.7 ;12;19;202;0;12;4;8;8;4;4;4;4
4062; 26.1 ; 104.4 ; 10.6 ;4;34;26;0;4;1;3;2;2;3;1;0
4063; 62.1 ; 124.2 ; 0.5 ;2;103;14;0;2;1;1;2;0;0;0;2
4064; 44.2 ; 132.5 ; 2.4 ;3;34;204;0;3;2;1;2;1;0;3;0
4065; 20.0 ; 40.1 ; 7.6 ;2;10;128;0;2;1;1;0;2;2;0;0
4066; 27.1 ; 81.3 ; 3.7 ;3;13;242;0;3;1;2;1;2;2;1;0
4067; 47.7 ; 190.6 ; 0.7 ;4;57;5;0;4;0;4;2;2;0;4;0
4068; 46.8 ; 93.5 ; -   ;2;24;200;0;2;0;2;0;2;0;2;0
4069; 52.0 ; 104.0 ; 0.4 ;2;23;99;0;2;1;1;1;1;0;2;0
4070; 49.5 ; 99.0 ; 24.4 ;2;308;5;0;2;0;2;2;0;1;0;1
4071; 71.8 ; 215.4 ; 13.9 ;3;13;267;0;3;0;3;1;2;0;0;3
4072; 54.7 ; 164.2 ; 60.4 ;3;131;5;0;3;0;3;2;1;1;1;1
4073; 20.4 ; 61.2 ; 0.7 ;3;7;271;0;3;2;1;0;3;3;0;0
4074; 40.9 ; 491.0 ; 11.8 ;12;23;3;0;12;10;2;2;10;4;8;0
4075; 50.9 ; 407.0 ; 8.7 ;8;27;15;0;8;3;5;7;1;0;5;3
4076; 42.2 ; 295.3 ; 8.3 ;7;14;140;0;7;1;6;5;2;0;7;0
4077; 41.1 ; 82.3 ; 11.3 ;2;154;34;1;1;1;1;0;2;1;1;0
4078; 15.3 ; 291.2 ; 1.1 ;19;15;22;0;19;4;15;11;8;19;0;0
4079; 46.5 ; 185.8 ; 9.3 ;4;126;28;0;4;3;1;2;2;0;3;1
4080; 85.9 ; 171.9 ; 32.9 ;2;38;5;0;2;0;2;2;0;0;0;2
4081; 44.8 ; 179.4 ; 14.6 ;4;32;81;4;0;2;2;2;2;0;3;1
4082; 59.5 ; 118.9 ; 16.8 ;2;23;22;0;2;0;2;2;0;0;0;2
4083; 34.8 ; 174.1 ; 14.8 ;5;49;69;0;5;0;5;2;3;2;3;0
4084; 44.8 ; 89.6 ; 2.9 ;2;204;150;1;1;1;1;0;2;0;2;0
4085; 60.8 ; 486.5 ; 14.3 ;8;37;22;0;8;0;8;8;0;0;0;8
4086; 48.7 ; 97.4 ; -   ;2;271;10;0;2;0;2;1;1;0;2;0
4087; 38.0 ; 75.9 ; 12.3 ;2;5;268;0;2;0;2;1;1;1;1;0
4088; 52.5 ; 105.0 ; -   ;2;81;282;0;2;2;0;0;2;0;2;0
4089; 78.0 ; 858.2 ; 26.8 ;11;29;5;0;11;3;8;6;5;0;0;11
4090; 32.8 ; 98.3 ; 7.8 ;3;47;167;0;3;0;3;1;2;1;2;0
4091; 108.6 ; 759.9 ; 63.8 ;7;13;40;0;7;3;4;0;7;0;0;7
4092; 34.7 ; 104.2 ; 15.0 ;3;34;69;0;3;0;3;1;2;1;2;0
4093; 34.2 ; 273.2 ; 13.6 ;8;45;51;0;8;4;4;3;5;3;5;0
4094; 26.3 ; 183.8 ; 9.1 ;7;32;20;0;7;0;7;3;4;5;2;0
4095; 22.8 ; 478.2 ; 9.7 ;21;17;22;0;21;6;15;13;8;14;7;0
4096; 29.5 ; 147.6 ; 8.2 ;5;23;68;0;5;1;4;2;3;3;2;0
4097; 24.1 ; 48.2 ; 9.1 ;2;46;170;0;2;2;0;2;0;1;1;0
4098; 30.5 ; 91.5 ; 28.4 ;3;81;125;0;3;2;1;3;0;1;1;1
4099; 75.7 ; 151.4 ; 2.9 ;2;63;62;0;2;0;2;2;0;0;0;2
4100; 53.7 ; 268.3 ; 18.0 ;5;39;52;0;5;0;5;2;3;0;3;2
4101; 43.6 ; 174.6 ; 12.9 ;4;25;0;0;4;1;3;2;2;0;3;1
4102; 35.2 ; 140.7 ; 11.4 ;4;68;76;0;4;3;1;2;2;1;3;0
4103; 68.2 ; 136.4 ; 64.6 ;2;153;141;0;2;1;1;1;1;1;0;1
4104; 17.9 ; 35.7 ; 4.3 ;2;43;230;0;2;2;0;2;0;2;0;0
4105; 48.1 ; 144.4 ; 24.8 ;3;167;32;0;3;1;2;2;1;1;1;1
4106; 23.6 ; 1,203.4 ; 21.0 ;51;6;16;0;51;26;25;19;32;34;17;0
4107; 50.9 ; 152.8 ; 2.1 ;3;59;141;0;3;0;3;3;0;0;3;0
4108; 67.1 ; 134.2 ; 8.0 ;2;55;190;1;1;0;2;0;2;0;0;2
4109; 17.4 ; 52.2 ; 4.4 ;3;146;36;0;3;2;1;2;1;3;0;0
4110; 15.0 ; 30.0 ; -   ;2;13;257;0;2;0;2;1;1;2;0;0
4111; 15.0 ; 45.0 ; -   ;3;25;15;2;1;0;3;2;1;3;0;0
4112; 35.6 ; 497.8 ; 19.2 ;14;24;115;0;14;5;9;6;8;5;9;0
4113; 44.0 ; 528.3 ; 9.1 ;12;25;0;0;12;6;6;11;1;0;12;0
4114; 22.2 ; 44.4 ; 1.6 ;2;207;32;1;1;0;2;1;1;2;0;0
4115; 17.2 ; 34.4 ; 1.2 ;2;4;27;0;2;0;2;1;1;2;0;0
4116; 38.5 ; 76.9 ; 12.7 ;2;81;104;2;0;0;2;1;1;1;1;0
4117; 50.6 ; 151.9 ; 16.2 ;3;25;226;0;3;1;2;2;1;0;2;1
4118; 23.1 ; 46.2 ; 12.1 ;2;32;242;0;2;0;2;0;2;1;1;0
4119; 30.9 ; 92.6 ; 19.2 ;3;85;57;0;3;1;2;1;2;1;2;0
4120; 22.7 ; 136.3 ; 7.8 ;6;44;173;0;6;0;6;3;3;4;2;0
4121; 21.5 ; 42.9 ; -   ;2;12;262;0;2;0;2;2;0;2;0;0
4122; 40.9 ; 1,103.9 ; 28.0 ;27;14;42;0;27;2;25;13;14;9;9;9
4123; 70.1 ; 140.3 ; 35.0 ;2;38;291;0;2;2;0;2;0;0;0;2
4124; 23.3 ; 70.0 ; 8.1 ;3;7;0;0;3;2;1;1;2;2;1;0
4125; 38.1 ; 685.6 ; 27.9 ;18;14;6;0;18;5;13;2;16;6;6;6
4126; 47.1 ; 94.2 ; 0.5 ;2;286;40;0;2;1;1;1;1;0;2;0
4127; 18.0 ; 90.1 ; 7.2 ;5;15;11;4;1;1;4;4;1;5;0;0
4128; 47.5 ; 427.6 ; 10.2 ;9;34;2;0;9;1;8;1;8;0;6;3
4129; 45.7 ; 274.3 ; 14.8 ;6;19;59;3;3;5;1;6;0;0;4;2
4130; 44.2 ; 132.6 ; 17.7 ;3;13;26;0;3;0;3;3;0;1;1;1
4131; 65.1 ; 325.3 ; 35.6 ;5;54;174;0;5;0;5;2;3;2;0;3
4132; 79.3 ; 237.8 ; 19.7 ;3;9;230;0;3;0;3;3;0;0;0;3
4133; 20.3 ; 40.6 ; 1.2 ;2;169;120;0;2;0;2;0;2;2;0;0
4134; 28.4 ; 170.5 ; 23.2 ;6;36;86;0;6;3;3;5;1;4;2;0
4135; 29.3 ; 175.8 ; 9.3 ;6;44;21;0;6;2;4;4;2;4;2;0
4136; 36.8 ; 73.7 ; 17.6 ;2;10;254;0;2;1;1;1;1;1;1;0
4137; 55.0 ; 385.2 ; 12.1 ;7;49;15;0;7;0;7;7;0;0;0;7
4138; 20.2 ; 403.9 ; 6.8 ;20;12;2;0;20;10;10;6;14;20;0;0
4139; 42.1 ; 210.5 ; 21.5 ;5;34;56;0;5;0;5;0;5;2;1;2
4140; 24.5 ; 49.1 ; 7.3 ;2;6;20;0;2;0;2;2;0;1;1;0
4141; 52.5 ; 105.0 ; -   ;2;68;311;0;2;0;2;0;2;0;2;0
4142; 55.2 ; 220.7 ; 37.4 ;4;52;37;3;1;2;2;4;0;1;0;3
4143; 42.4 ; 84.8 ; 8.7 ;2;38;10;2;0;0;2;2;0;0;2;0
4144; 29.1 ; 203.4 ; 7.2 ;7;4;263;0;7;1;6;4;3;5;2;0
4145; 53.8 ; 107.6 ; 34.2 ;2;233;15;1;1;0;2;1;1;1;0;1
4146; 64.7 ; 194.1 ; 27.7 ;3;35;89;0;3;1;2;1;2;0;0;3
4147; 51.1 ; 153.4 ; 4.4 ;3;56;47;3;0;0;3;1;2;0;2;1
4148; 42.2 ; 210.8 ; 24.8 ;5;25;176;2;3;4;1;1;4;2;1;2
4149; 56.4 ; 733.7 ; 18.6 ;13;15;0;0;13;7;6;9;4;0;0;13
4150; 28.3 ; 85.0 ; 3.0 ;3;38;271;0;3;3;0;1;2;2;1;0
4151; 63.3 ; 189.8 ; 11.8 ;3;44;185;0;3;2;1;1;2;0;0;3
4152; 25.9 ; 724.9 ; 6.9 ;28;11;1;0;28;9;19;12;16;19;9;0
4153; 21.8 ; 43.7 ; 4.9 ;2;212;73;0;2;1;1;1;1;2;0;0
4154; 56.9 ; 398.0 ; 12.1 ;7;50;14;0;7;1;6;4;3;0;0;7
4155; 107.2 ; 428.7 ; 0.9 ;4;28;11;4;0;3;1;4;0;0;0;4
4156; 30.6 ; 91.7 ; 16.8 ;3;38;174;0;3;2;1;1;2;1;2;0
4157; 28.1 ; 56.2 ; -   ;2;18;77;0;2;2;0;2;0;2;0;0
4158; 52.1 ; 104.2 ; 8.0 ;2;5;237;0;2;0;2;0;2;0;1;1
4159; 47.8 ; 95.7 ; 0.5 ;2;32;22;0;2;0;2;1;1;0;2;0
4160; 42.4 ; 254.5 ; 16.4 ;6;45;33;0;6;2;4;4;2;2;2;2
4161; 35.0 ; 70.1 ; 4.4 ;2;6;263;0;2;0;2;2;0;0;2;0
4162; 40.6 ; 202.8 ; 13.9 ;5;45;0;5;0;0;5;1;4;2;3;0
4163; 53.1 ; 106.1 ; 13.0 ;2;2;37;0;2;1;1;1;1;0;1;1
4164; 65.2 ; 195.6 ; 27.4 ;3;49;16;3;0;2;1;2;1;0;0;3
4165; 73.4 ; 220.3 ; 57.6 ;3;56;3;0;3;2;1;0;3;1;0;2
4166; 34.0 ; 204.3 ; 13.0 ;6;68;19;0;6;6;0;0;6;2;4;0
4167; 38.3 ; 1,033.4 ; 17.0 ;27;16;32;0;27;4;23;19;8;9;9;9
4168; 46.8 ; 374.7 ; 4.9 ;8;50;5;0;8;0;8;8;0;0;8;0
4169; 49.6 ; 248.2 ; 9.7 ;5;14;5;0;5;0;5;2;3;0;3;2
4170; 74.5 ; 372.6 ; 34.9 ;5;23;126;0;5;0;5;5;0;0;0;5
4171; 30.8 ; 61.7 ; 8.6 ;2;44;162;0;2;0;2;1;1;1;1;0
4172; 45.6 ; 227.9 ; 13.2 ;5;18;206;0;5;1;4;1;4;0;3;2
4173; 53.0 ; 159.0 ; 0.4 ;3;38;41;0;3;0;3;3;0;0;3;0
4174; 19.9 ; 278.1 ; 13.3 ;14;23;11;0;14;12;2;3;11;9;5;0
4175; 44.5 ; 133.6 ; 13.3 ;3;38;158;0;3;0;3;1;2;0;2;1
4176; 30.9 ; 123.6 ; 22.0 ;4;15;104;4;0;2;2;3;1;1;3;0
4177; 73.5 ; 367.4 ; 21.8 ;5;45;74;0;5;0;5;5;0;0;0;5
4178; 47.0 ; 516.9 ; 0.5 ;11;24;24;0;11;9;2;3;8;0;11;0
4179; 38.0 ; 76.1 ; 19.4 ;2;288;51;0;2;2;0;1;1;1;0;1
4180; 42.6 ; 639.4 ; 53.8 ;15;19;89;0;15;5;10;9;6;5;5;5
4181; 46.8 ; 93.5 ; -   ;2;95;145;0;2;2;0;0;2;0;2;0
4182; 16.4 ; 32.8 ; -   ;2;4;56;0;2;2;0;1;1;2;0;0
4183; 21.8 ; 43.7 ; 4.9 ;2;137;273;0;2;0;2;0;2;2;0;0
4184; 16.4 ; 196.5 ; 1.9 ;12;17;15;12;0;0;12;10;2;12;0;0
4185; 88.9 ; 266.6 ; 75.3 ;3;41;92;0;3;2;1;2;1;1;0;2
4186; 44.6 ; 89.1 ; 4.4 ;2;59;14;2;0;1;1;1;1;0;2;0
4187; 34.0 ; 203.7 ; 12.2 ;6;19;62;0;6;3;3;3;3;2;4;0
4188; 35.1 ; 70.2 ; 18.3 ;2;69;84;0;2;0;2;1;1;1;1;0
4189; 62.4 ; 249.6 ; 14.7 ;4;50;5;0;4;0;4;4;0;0;0;4
4190; 89.7 ; 179.4 ; 84.5 ;2;13;389;0;2;0;2;2;0;1;0;1
4191; 51.4 ; 205.5 ; 2.9 ;4;18;63;0;4;2;2;0;4;0;4;0
4192; 36.7 ; 550.3 ; 11.3 ;15;7;1;0;15;7;8;5;10;5;10;0
4193; 43.0 ; 258.0 ; 6.9 ;6;49;22;2;4;0;6;1;5;0;6;0
4194; 70.6 ; 211.9 ; 37.6 ;3;223;20;0;3;1;2;2;1;0;0;3
4195; 69.6 ; 1,392.3 ; 26.9 ;20;13;3;1;19;11;9;5;15;0;0;20
4196; 30.5 ; 91.6 ; 18.0 ;3;79;104;0;3;1;2;1;2;1;2;0
4197; 47.6 ; 190.3 ; 0.8 ;4;54;68;0;4;0;4;3;1;0;4;0
4198; 38.8 ; 77.7 ; 12.9 ;2;31;59;0;2;1;1;1;1;1;1;0
4199; 39.6 ; 554.8 ; 16.3 ;14;13;11;0;14;5;9;6;8;5;4;5
4200; 39.5 ; 158.1 ; 9.0 ;4;65;115;0;4;1;3;4;0;0;4;0
4201; 67.1 ; 402.8 ; 25.0 ;6;49;15;0;6;2;4;1;5;0;0;6
4202; 23.4 ; 70.2 ; 8.2 ;3;54;47;3;0;0;3;0;3;2;1;0
4203; 43.7 ; 218.7 ; 15.4 ;5;59;7;0;5;4;1;2;3;2;1;2
4204; 26.5 ; 264.9 ; 8.6 ;10;12;5;0;10;5;5;3;7;7;3;0
4205; 30.2 ; 120.7 ; -   ;4;12;284;0;4;0;4;4;0;0;4;0
4206; 21.1 ; 42.2 ; -   ;2;16;122;0;2;1;1;2;0;2;0;0
4207; 45.6 ; 774.7 ; 23.5 ;17;16;39;0;17;10;7;8;9;6;5;6
4208; 29.8 ; 148.8 ; 14.6 ;5;49;101;0;5;0;5;5;0;3;2;0
4209; 51.7 ; 362.1 ; 20.9 ;7;17;236;0;7;5;2;4;3;0;5;2
4210; 29.3 ; 87.8 ; 9.2 ;3;5;55;0;3;2;1;1;2;2;1;0
4211; 19.4 ; 58.3 ; 1.3 ;3;40;94;0;3;1;2;3;0;3;0;0
4212; 54.2 ; 108.3 ; 0.5 ;2;72;99;0;2;1;1;2;0;0;2;0
4213; 18.4 ; 55.2 ; 3.5 ;3;31;148;0;3;1;2;1;2;3;0;0
4214; 20.4 ; 61.1 ; 5.4 ;3;129;5;0;3;0;3;2;1;3;0;0
4215; 34.5 ; 68.9 ; 6.4 ;2;145;26;0;2;0;2;0;2;1;1;0
4216; 45.0 ; 179.9 ; 2.2 ;4;57;37;0;4;0;4;3;1;0;4;0
4217; 15.0 ; 30.0 ; -   ;2;5;268;0;2;0;2;2;0;2;0;0
4218; 35.6 ; 106.9 ; 10.2 ;3;122;79;0;3;0;3;1;2;1;2;0
4219; 22.5 ; 44.9 ; 11.2 ;2;127;83;0;2;1;1;0;2;1;1;0
4220; 37.1 ; 148.2 ; 10.3 ;4;22;97;0;4;3;1;2;2;1;3;0
4221; 25.8 ; 51.6 ; 16.2 ;2;24;173;0;2;0;2;2;0;1;1;0
4222; 68.0 ; 340.2 ; 34.5 ;5;93;59;0;5;2;3;3;2;0;0;5
4223; 30.8 ; 61.7 ; 8.6 ;2;256;20;0;2;2;0;0;2;1;1;0
4224; 40.1 ; 120.4 ; 10.2 ;3;91;63;0;3;0;3;1;2;1;2;0
4225; 52.4 ; 366.6 ; 15.7 ;7;45;5;0;7;0;7;2;5;0;5;2
4226; 37.1 ; 111.4 ; 20.3 ;3;225;20;0;3;2;1;2;1;1;1;1
4227; 17.7 ; 35.4 ; 4.1 ;2;52;237;0;2;1;1;0;2;2;0;0
4228; 46.8 ; 93.5 ; -   ;2;277;131;0;2;0;2;2;0;0;2;0
4229; 30.7 ; 461.0 ; 23.1 ;15;19;20;0;15;2;13;9;6;5;10;0
4230; 30.0 ; 59.9 ; -   ;2;35;245;0;2;1;1;0;2;2;0;0
4231; 22.5 ; 44.9 ; 11.2 ;2;5;0;0;2;0;2;1;1;1;1;0
4232; 34.5 ; 172.6 ; 14.5 ;5;14;50;0;5;3;2;3;2;2;3;0
4233; 36.3 ; 145.1 ; 13.8 ;4;70;36;1;3;2;2;1;3;1;3;0
4234; 55.1 ; 1,376.8 ; 25.2 ;25;17;11;0;25;3;22;10;15;8;0;17
4235; 93.5 ; 374.0 ; 40.4 ;4;62;158;0;4;2;2;3;1;0;0;4
4236; 30.4 ; 91.3 ; 0.4 ;3;41;2;0;3;3;0;2;1;1;2;0
4237; 50.7 ; 202.7 ; 18.1 ;4;117;17;0;4;0;4;3;1;0;3;1
4238; 57.1 ; 171.4 ; 19.8 ;3;90;0;0;3;1;2;3;0;0;0;3
4239; 30.6 ; 152.8 ; 10.4 ;5;25;136;5;0;0;5;5;0;2;3;0
4240; 45.4 ; 453.6 ; 20.3 ;10;25;32;0;10;5;5;4;6;3;4;3
4241; 39.2 ; 196.2 ; 16.2 ;5;33;8;0;5;2;3;1;4;2;1;2
4242; 42.6 ; 212.9 ; 8.7 ;5;54;15;0;5;0;5;4;1;0;5;0
4243; 38.7 ; 77.4 ; 13.1 ;2;285;64;0;2;1;1;0;2;1;1;0
4244; 18.3 ; 54.9 ; 3.0 ;3;4;7;0;3;3;0;1;2;3;0;0
4245; 46.6 ; 93.3 ; 38.2 ;2;119;159;0;2;1;1;1;1;1;0;1
4246; 32.5 ; 162.7 ; 5.1 ;5;15;47;0;5;0;5;1;4;2;3;0
4247; 22.5 ; 44.9 ; 11.2 ;2;6;284;0;2;0;2;1;1;1;1;0
4248; 30.8 ; 61.7 ; 8.6 ;2;27;146;0;2;1;1;2;0;1;1;0
4249; 46.8 ; 93.5 ; -   ;2;5;262;0;2;0;2;2;0;0;2;0
4250; 40.9 ; 122.8 ; 19.5 ;3;1;269;0;3;3;0;3;0;1;1;1
4251; 37.0 ; 148.0 ; 39.0 ;4;36;78;0;4;0;4;1;3;1;2;1
4252; 31.5 ; 188.9 ; 18.2 ;6;18;8;0;6;2;4;1;5;2;4;0
4253; 29.7 ; 59.4 ; 7.0 ;2;5;322;0;2;1;1;0;2;1;1;0
4254; 15.0 ; 74.9 ; -   ;5;50;40;0;5;2;3;2;3;5;0;0
4255; 31.5 ; 94.4 ; 0.7 ;3;4;173;0;3;1;2;1;2;0;3;0
4256; 32.3 ; 129.2 ; 12.4 ;4;37;8;0;4;1;3;1;3;1;3;0
4257; 71.4 ; 285.5 ; 29.7 ;4;61;5;0;4;0;4;4;0;0;0;4
4258; 63.4 ; 126.7 ; 49.7 ;2;86;38;1;1;0;2;2;0;1;0;1
4259; 56.2 ; 168.6 ; 14.5 ;3;76;83;1;2;0;3;2;1;0;0;3
4260; 32.5 ; 194.9 ; 11.0 ;6;13;5;2;4;0;6;4;2;2;4;0
4261; 50.4 ; 151.1 ; 25.8 ;3;51;2;0;3;2;1;2;1;1;1;1
4262; 25.4 ; 152.2 ; 5.7 ;6;18;142;0;6;4;2;1;5;4;2;0
4263; 81.9 ; 409.7 ; 57.5 ;5;34;173;0;5;2;3;2;3;2;0;3
4264; 46.3 ; 138.9 ; 12.0 ;3;39;27;1;2;1;2;1;2;0;2;1
4265; 60.7 ; 121.4 ; 45.7 ;2;6;74;0;2;0;2;2;0;1;0;1
4266; 30.2 ; 211.3 ; 9.3 ;7;41;36;0;7;2;5;2;5;2;5;0
4267; 38.8 ; 77.7 ; 12.9 ;2;24;100;0;2;0;2;1;1;1;1;0
4268; 15.0 ; 30.0 ; -   ;2;1;29;0;2;2;0;0;2;2;0;0
4269; 45.5 ; 91.0 ; 14.7 ;2;41;208;0;2;1;1;0;2;0;1;1
4270; 16.9 ; 101.4 ; 2.5 ;6;9;149;0;6;2;4;1;5;6;0;0
4271; 27.7 ; 553.0 ; 14.3 ;20;12;1;0;20;11;9;5;15;13;7;0
4272; 40.6 ; 121.9 ; 13.6 ;3;22;68;0;3;0;3;2;1;1;2;0
4273; 53.7 ; 214.9 ; 38.5 ;4;23;21;0;4;1;3;4;0;1;2;1
4274; 50.8 ; 203.2 ; 6.2 ;4;77;31;0;4;0;4;3;1;0;3;1
4275; 43.6 ; 87.2 ; -   ;2;7;37;0;2;0;2;0;2;0;2;0
4276; 99.3 ; 198.7 ; 109.6 ;2;5;272;0;2;0;2;2;0;1;0;1
4277; 45.3 ; 181.4 ; 14.3 ;4;50;14;0;4;4;0;1;3;0;3;1
4278; 22.5 ; 134.8 ; 7.7 ;6;17;1;0;6;0;6;3;3;4;2;0
4279; 19.9 ; 99.6 ; 3.3 ;5;48;32;0;5;2;3;1;4;5;0;0
4280; 19.7 ; 78.7 ; -   ;4;19;225;0;4;0;4;4;0;4;0;0
4281; 31.2 ; 62.5 ; 24.3 ;2;54;48;0;2;1;1;1;1;1;0;1
4282; 42.4 ; 169.4 ; 15.1 ;4;50;47;0;4;1;3;2;2;1;2;1
4283; 35.0 ; 105.0 ; 13.7 ;3;29;179;0;3;1;2;3;0;1;2;0
4284; 22.5 ; 45.0 ; 2.6 ;2;2;256;0;2;1;1;2;0;2;0;0
4285; 20.7 ; 62.2 ; 4.0 ;3;170;74;0;3;2;1;1;2;3;0;0
4286; 38.5 ; 76.9 ; 12.4 ;2;1;168;0;2;0;2;0;2;1;1;0
4287; 21.8 ; 43.7 ; 4.9 ;2;9;269;0;2;1;1;0;2;2;0;0
4288; 29.5 ; 177.2 ; 28.0 ;6;72;17;0;6;3;3;2;4;4;0;2
4289; 42.6 ; 85.3 ; 9.1 ;2;70;86;0;2;2;0;0;2;0;2;0
4290; 21.1 ; 1,689.1 ; 12.9 ;80;5;2;0;80;48;32;69;11;53;27;0
4291; 88.7 ; 177.4 ; 5.8 ;2;81;10;1;1;0;2;2;0;0;0;2
4292; 57.7 ; 403.6 ; 9.3 ;7;16;21;4;3;1;6;3;4;0;0;7
4293; 31.3 ; 500.2 ; 15.9 ;16;26;23;0;16;11;5;14;2;5;11;0
4294; 43.2 ; 259.4 ; 15.6 ;6;43;100;0;6;1;5;3;3;2;2;2
4295; 52.0 ; 416.1 ; 37.9 ;8;33;1;0;8;3;5;7;1;3;2;3
4296; 32.9 ; 98.6 ; 13.6 ;3;170;11;0;3;1;2;0;3;1;2;0
4297; 53.6 ; 214.2 ; 8.0 ;4;52;22;0;4;0;4;4;0;0;3;1
4298; 63.2 ; 126.5 ; 22.5 ;2;96;19;0;2;1;1;0;2;0;0;2
4299; 49.5 ; 198.1 ; 5.9 ;4;8;325;0;4;0;4;4;0;0;3;1
4300; 31.5 ; 157.3 ; 14.4 ;5;9;2;0;5;3;2;2;3;2;3;0
4301; 63.1 ; 126.1 ; 0.9 ;2;31;50;0;2;2;0;2;0;0;0;2
4302; 34.5 ; 172.3 ; 12.2 ;5;45;70;0;5;3;2;3;2;2;3;0
4303; 22.0 ; 197.9 ; 9.5 ;9;20;10;0;9;2;7;5;4;6;3;0
4304; 49.2 ; 147.7 ; 0.6 ;3;13;134;0;3;2;1;2;1;0;3;0
4305; 30.5 ; 60.9 ; 8.1 ;2;7;2;0;2;2;0;1;1;1;1;0
4306; 44.5 ; 89.0 ; 6.2 ;2;43;205;0;2;0;2;2;0;0;2;0
4307; 83.2 ; 166.5 ; 23.9 ;2;7;141;0;2;0;2;2;0;0;0;2
4308; 124.6 ; 249.2 ; 93.4 ;2;109;62;2;0;1;1;1;1;0;0;2
4309; 72.5 ; 362.5 ; 26.2 ;5;62;10;0;5;0;5;5;0;0;0;5
4310; 40.5 ; 202.5 ; 8.8 ;5;30;36;1;4;0;5;0;5;0;5;0
4311; 39.2 ; 469.8 ; 13.6 ;12;15;22;0;12;3;9;6;6;4;8;0
4312; 54.6 ; 109.3 ; 11.8 ;2;26;194;0;2;0;2;2;0;0;1;1
4313; 22.2 ; 66.5 ; 3.8 ;3;49;8;0;3;1;2;2;1;3;0;0
4314; 51.5 ; 103.1 ; 16.0 ;2;101;5;0;2;0;2;2;0;0;1;1
4315; 90.0 ; 180.0 ; 0.7 ;2;32;167;0;2;0;2;1;1;0;0;2
4316; 36.4 ; 72.8 ; 16.4 ;2;10;80;0;2;0;2;2;0;1;1;0
4317; 36.4 ; 109.3 ; 10.9 ;3;39;78;0;3;0;3;1;2;1;2;0
4318; 29.5 ; 206.5 ; 11.2 ;7;19;162;0;7;0;7;3;4;5;2;0
4319; 48.8 ; 293.0 ; 31.1 ;6;41;5;0;6;2;4;1;5;2;2;2
4320; 25.7 ; 102.6 ; 8.2 ;4;66;111;1;3;2;2;4;0;3;1;0
4321; 18.8 ; 75.1 ; 8.0 ;4;101;6;0;4;1;3;4;0;4;0;0
4322; 15.0 ; 30.0 ; -   ;2;13;215;0;2;0;2;2;0;2;0;0
4323; 21.4 ; 128.3 ; 11.8 ;6;7;120;0;6;0;6;2;4;4;2;0
4324; 41.2 ; 164.7 ; 10.6 ;4;81;19;0;4;1;3;4;0;0;4;0
4325; 18.0 ; 54.1 ; 3.2 ;3;137;125;0;3;1;2;0;3;3;0;0
4326; 41.3 ; 165.3 ; 11.5 ;4;6;246;0;4;0;4;4;0;1;3;0
4327; 15.0 ; 74.9 ; -   ;5;13;26;0;5;0;5;4;1;5;0;0
4328; 29.5 ; 117.9 ; 16.6 ;4;61;203;0;4;3;1;1;3;3;1;0
4329; 32.4 ; 97.2 ; 16.2 ;3;69;0;0;3;0;3;3;0;1;2;0
4330; 44.8 ; 672.1 ; 16.9 ;15;20;36;0;15;1;14;11;4;5;5;5
4331; 29.1 ; 320.5 ; 10.6 ;11;30;2;0;11;6;5;3;8;7;4;0
4332; 27.4 ; 164.4 ; 12.2 ;6;38;23;6;0;6;0;6;0;4;2;0
4333; 34.8 ; 104.5 ; 12.4 ;3;43;5;0;3;1;2;1;2;1;2;0
4334; 36.0 ; 143.9 ; 22.3 ;4;113;36;0;4;1;3;2;2;1;2;1
4335; 28.0 ; 448.1 ; 17.1 ;16;14;50;0;16;7;9;8;8;11;5;0
4336; 57.1 ; 799.2 ; 21.4 ;14;30;6;0;14;7;7;13;1;0;0;14
4337; 63.9 ; 703.4 ; 27.6 ;11;13;99;0;11;2;9;7;4;0;0;11
4338; 27.7 ; 222.0 ; 12.8 ;8;25;113;0;8;4;4;7;1;5;3;0
4339; 38.4 ; 76.7 ; 12.6 ;2;218;113;0;2;1;1;1;1;1;1;0
4340; 43.8 ; 175.0 ; 6.8 ;4;118;50;0;4;4;0;1;3;0;4;0
4341; 43.5 ; 217.3 ; 1.6 ;5;50;188;0;5;0;5;5;0;0;5;0
4342; 38.4 ; 230.3 ; 3.2 ;6;7;116;0;6;2;4;2;4;0;6;0
4343; 30.4 ; 91.3 ; 12.0 ;3;57;78;0;3;1;2;3;0;1;2;0
4344; 53.1 ; 106.3 ; 3.2 ;2;23;109;0;2;2;0;0;2;0;1;1
4345; 33.1 ; 165.4 ; 14.0 ;5;23;293;0;5;4;1;4;1;2;3;0
4346; 51.4 ; 102.7 ; 0.5 ;2;195;99;0;2;0;2;1;1;0;2;0
4347; 48.9 ; 244.5 ; 15.6 ;5;17;194;0;5;2;3;4;1;0;3;2
4348; 46.8 ; 93.5 ; -   ;2;80;111;0;2;0;2;1;1;0;2;0
4349; 45.8 ; 91.6 ; 4.4 ;2;128;8;1;1;1;1;2;0;0;2;0
4350; 50.2 ; 251.2 ; 6.4 ;5;14;147;0;5;1;4;5;0;0;3;2
4351; 17.4 ; 191.4 ; 4.5 ;11;7;3;0;11;6;5;10;1;11;0;0
4352; 25.8 ; 154.7 ; 16.4 ;6;13;59;0;6;5;1;1;5;4;2;0
4353; 49.2 ; 98.3 ; 14.1 ;2;22;7;0;2;1;1;1;1;0;1;1
4354; 48.6 ; 437.2 ; 18.5 ;9;38;57;0;9;3;6;9;0;0;6;3
4355; 15.0 ; 30.0 ; -   ;2;63;128;0;2;2;0;2;0;2;0;0
4356; 31.4 ; 94.1 ; 16.7 ;3;36;32;1;2;1;2;1;2;1;2;0
4357; 89.7 ; 179.4 ; 26.8 ;2;7;99;0;2;0;2;2;0;0;0;2
4358; 26.8 ; 214.7 ; 15.1 ;8;48;2;2;6;3;5;2;6;5;3;0
4359; 53.3 ; 266.7 ; 8.4 ;5;61;101;1;4;5;0;1;4;0;3;2
4360; 17.9 ; 35.7 ; 4.3 ;2;41;314;0;2;2;0;2;0;2;0;0
4361; 40.9 ; 163.7 ; 9.5 ;4;65;105;0;4;0;4;1;3;0;4;0
4362; 60.1 ; 300.3 ; 17.0 ;5;16;15;0;5;0;5;4;1;0;0;5
4363; 54.5 ; 109.0 ; 10.5 ;2;5;99;0;2;0;2;1;1;0;1;1
4364; 84.4 ; 422.1 ; 70.4 ;5;29;10;0;5;0;5;5;0;2;0;3
4365; 50.7 ; 152.2 ; 19.7 ;3;9;193;0;3;1;2;3;0;0;2;1
4366; 34.3 ; 789.4 ; 11.9 ;23;14;12;0;23;16;7;18;5;8;15;0
4367; 15.0 ; 30.0 ; -   ;2;4;17;0;2;0;2;0;2;2;0;0
4368; 28.1 ; 84.2 ; 2.8 ;3;52;212;0;3;2;1;1;2;2;1;0
4369; 15.0 ; 45.0 ; -   ;3;120;20;0;3;3;0;1;2;3;0;0
4370; 126.0 ; 378.0 ; 67.6 ;3;43;143;0;3;3;0;1;2;0;0;3
4371; 19.5 ; 370.5 ; 8.9 ;19;15;36;0;19;4;15;8;11;19;0;0
4372; 36.2 ; 108.6 ; 38.9 ;3;7;168;0;3;1;2;1;2;1;1;1
4373; 71.2 ; 142.4 ; 35.5 ;2;78;34;0;2;1;1;1;1;0;0;2
4374; 22.0 ; 198.4 ; 11.5 ;9;23;17;0;9;4;5;3;6;6;3;0
4375; 32.7 ; 98.0 ; 12.9 ;3;41;125;0;3;0;3;1;2;1;2;0
4376; 63.4 ; 126.9 ; 17.5 ;2;95;104;0;2;2;0;1;1;0;0;2
4377; 16.8 ; 33.6 ; 2.7 ;2;23;100;0;2;0;2;2;0;2;0;0
4378; 32.6 ; 1,628.6 ; 6.7 ;50;8;0;0;50;18;32;31;19;17;33;0
4379; 52.0 ; 364.0 ; 24.2 ;7;41;31;0;7;0;7;6;1;2;3;2
4380; 56.9 ; 113.9 ; 12.3 ;2;124;0;0;2;0;2;0;2;0;0;2
4381; 46.6 ; 373.1 ; 17.8 ;8;40;16;0;8;0;8;6;2;3;2;3
4382; 25.8 ; 129.1 ; 8.9 ;5;38;95;0;5;2;3;5;0;3;2;0
4383; 32.1 ; 96.2 ; 23.3 ;3;11;377;0;3;2;1;0;3;1;1;1
4384; 32.2 ; 161.2 ; 11.1 ;5;86;36;0;5;0;5;2;3;2;3;0
4385; 18.8 ; 75.0 ; 1.6 ;4;27;0;0;4;0;4;3;1;4;0;0
4386; 26.0 ; 78.0 ; 1.7 ;3;122;20;0;3;2;1;2;1;3;0;0
4387; 26.5 ; 106.1 ; 3.1 ;4;105;10;0;4;1;3;0;4;4;0;0
4388; 47.1 ; 282.3 ; 0.4 ;6;19;31;0;6;0;6;1;5;0;6;0
4389; 69.1 ; 345.3 ; 63.6 ;5;68;58;0;5;4;1;3;2;2;0;3
4390; 51.3 ; 358.9 ; 14.6 ;7;26;85;0;7;4;3;7;0;0;5;2
4391; 130.9 ; 392.7 ; 102.1 ;3;81;68;0;3;0;3;1;2;1;0;2
4392; 28.3 ; 141.5 ; 17.6 ;5;17;254;0;5;2;3;3;2;3;2;0
4393; 15.0 ; 30.0 ; -   ;2;136;30;2;0;2;0;2;0;2;0;0
4394; 49.7 ; 348.0 ; 7.4 ;7;64;11;0;7;1;6;6;1;0;5;2
4395; 41.3 ; 247.6 ; 12.7 ;6;23;17;0;6;0;6;0;6;2;4;0
4396; 30.6 ; 91.8 ; 11.0 ;3;30;159;0;3;2;1;3;0;1;2;0
4397; 37.3 ; 186.7 ; 17.2 ;5;48;70;0;5;4;1;3;2;2;3;0
4398; 30.2 ; 362.0 ; 20.3 ;12;35;5;0;12;4;8;6;6;4;8;0
4399; 33.9 ; 67.7 ; 0.4 ;2;26;182;2;0;1;1;2;0;0;2;0
4400; 42.6 ; 298.0 ; 22.2 ;7;42;121;0;7;4;3;5;2;2;3;2
4401; 16.8 ; 67.2 ; 2.2 ;4;8;7;0;4;4;0;0;4;4;0;0
4402; 38.7 ; 232.1 ; 7.8 ;6;24;37;0;6;0;6;4;2;0;6;0
4403; 78.8 ; 157.5 ; 10.8 ;2;24;377;0;2;0;2;2;0;0;0;2
4404; 49.3 ; 98.7 ; 18.4 ;2;267;41;0;2;1;1;0;2;0;1;1
4405; 51.0 ; 153.1 ; 4.4 ;3;68;2;0;3;2;1;3;0;0;2;1
4406; 31.0 ; 247.7 ; 7.7 ;8;7;0;0;8;5;3;1;7;3;5;0
4407; 61.2 ; 1,102.2 ; 15.6 ;18;18;0;0;18;1;17;12;6;0;0;18
4408; 32.3 ; 64.7 ; 15.7 ;2;30;258;0;2;0;2;0;2;1;1;0
4409; 37.2 ; 74.4 ; 18.2 ;2;19;52;0;2;0;2;1;1;1;0;1
4410; 86.3 ; 258.9 ; 33.0 ;3;137;41;0;3;2;1;1;2;0;0;3
4411; 38.2 ; 114.5 ; 15.0 ;3;17;70;1;2;2;1;1;2;1;2;0
4412; 21.6 ; 215.6 ; 13.7 ;10;27;3;0;10;7;3;10;0;7;3;0
4413; 22.5 ; 44.9 ; 11.2 ;2;5;241;0;2;0;2;1;1;1;1;0
4414; 43.0 ; 300.7 ; 11.4 ;7;58;31;0;7;1;6;7;0;0;7;0
4415; 45.5 ; 227.6 ; 5.3 ;5;46;59;1;4;5;0;2;3;0;5;0
4416; 53.8 ; 269.2 ; 26.9 ;5;15;78;0;5;1;4;4;1;2;1;2
4417; 54.8 ; 328.8 ; 13.3 ;6;71;64;0;6;2;4;3;3;0;4;2
4418; 21.7 ; 65.1 ; 6.2 ;3;22;264;0;3;2;1;3;0;3;0;0
4419; 15.0 ; 30.0 ; -   ;2;10;104;0;2;1;1;0;2;2;0;0
4420; 70.6 ; 141.1 ; 3.5 ;2;29;95;0;2;1;1;2;0;0;0;2
4421; 50.6 ; 101.3 ; 0.5 ;2;31;5;0;2;0;2;2;0;0;2;0
4422; 34.1 ; 170.6 ; 15.0 ;5;41;33;5;0;0;5;4;1;2;3;0
4423; 22.5 ; 584.5 ; 4.4 ;26;14;2;0;26;17;9;13;13;26;0;0
4424; 57.0 ; 114.0 ; 15.3 ;2;75;230;0;2;0;2;2;0;0;0;2
4425; 25.8 ; 180.4 ; 8.9 ;7;14;261;0;7;6;1;2;5;5;2;0
4426; 47.3 ; 661.9 ; 4.8 ;14;29;41;0;14;6;8;3;11;0;14;0
4427; 63.3 ; 822.9 ; 35.1 ;13;24;5;0;13;3;10;8;5;4;0;9
4428; 28.5 ; 171.0 ; 12.3 ;6;20;8;0;6;3;3;3;3;4;2;0
4429; 30.2 ; 695.6 ; 25.3 ;23;9;240;0;23;17;6;17;6;8;7;8
4430; 44.2 ; 88.4 ; 4.9 ;2;6;96;2;0;2;0;0;2;0;2;0
4431; 50.3 ; 201.2 ; 25.9 ;4;63;220;0;4;1;3;2;2;1;2;1
4432; 22.7 ; 136.3 ; 6.0 ;6;25;4;0;6;4;2;6;0;6;0;0
4433; 46.8 ; 93.5 ; -   ;2;63;257;0;2;0;2;1;1;0;2;0
4434; 54.8 ; 219.2 ; 17.0 ;4;26;176;0;4;3;1;2;2;0;3;1
4435; 51.5 ; 411.7 ; 34.1 ;8;44;91;0;8;4;4;8;0;3;2;3
4436; 16.4 ; 98.5 ; 4.0 ;6;31;2;0;6;1;5;3;3;6;0;0
4437; 43.9 ; 87.8 ; 20.9 ;2;26;125;0;2;0;2;0;2;1;0;1
4438; 55.6 ; 500.7 ; 9.6 ;9;21;37;0;9;3;6;6;3;0;0;9
4439; 46.0 ; 92.1 ; 31.4 ;2;39;115;0;2;0;2;1;1;1;0;1
4440; 22.7 ; 68.1 ; 7.3 ;3;2;127;0;3;0;3;2;1;3;0;0
4441; 49.6 ; 446.7 ; 3.2 ;9;17;229;0;9;6;3;7;2;0;9;0
4442; 37.2 ; 595.1 ; 13.9 ;16;20;92;0;16;8;8;13;3;5;11;0
4443; 47.1 ; 94.2 ; 0.5 ;2;121;40;0;2;1;1;2;0;0;2;0
4444; 37.0 ; 184.9 ; 16.1 ;5;29;182;0;5;5;0;3;2;2;3;0
4445; 51.1 ; 715.2 ; 6.7 ;14;12;1;0;14;4;10;2;12;0;9;5
4446; 20.8 ; 41.6 ; 0.5 ;2;126;145;0;2;2;0;0;2;2;0;0
4447; 49.1 ; 147.4 ; 32.6 ;3;6;242;0;3;0;3;1;2;1;1;1
4448; 48.9 ; 97.8 ; 3.2 ;2;46;242;0;2;1;1;1;1;0;2;0
4449; 70.1 ; 350.7 ; 17.3 ;5;50;120;0;5;1;4;3;2;0;0;5
4450; 39.3 ; 275.1 ; 10.0 ;7;19;16;1;6;4;3;7;0;2;5;0
4451; 83.6 ; 167.2 ; 31.8 ;2;5;162;0;2;0;2;1;1;0;0;2
4452; 22.7 ; 91.0 ; 6.4 ;4;19;147;4;0;2;2;2;2;4;0;0
4453; 68.3 ; 341.7 ; 26.2 ;5;37;28;0;5;2;3;0;5;0;0;5
4454; 16.6 ; 33.2 ; 2.4 ;2;98;11;0;2;1;1;2;0;2;0;0
4455; 156.3 ; 312.7 ; 94.1 ;2;2;152;2;0;1;1;2;0;0;0;2
4456; 42.0 ; 462.2 ; 14.5 ;11;29;25;0;11;5;6;10;1;4;3;4
4457; 35.9 ; 71.8 ; 8.6 ;2;17;23;2;0;1;1;1;1;1;1;0
4458; 40.6 ; 81.2 ; 9.2 ;2;106;205;0;2;0;2;2;0;0;2;0
4459; 45.4 ; 136.1 ; 8.1 ;3;41;67;0;3;2;1;2;1;0;3;0
4460; 16.2 ; 519.5 ; 6.2 ;32;12;23;0;32;3;29;10;22;32;0;0
4461; 23.1 ; 46.2 ; 3.0 ;2;94;195;0;2;0;2;0;2;2;0;0
4462; 29.7 ; 59.4 ; 10.2 ;2;16;188;0;2;1;1;0;2;1;1;0
4463; 47.1 ; 94.2 ; 0.5 ;2;13;99;2;0;0;2;2;0;0;2;0
4464; 35.7 ; 71.4 ; 5.4 ;2;272;62;0;2;0;2;0;2;0;2;0
4465; 63.0 ; 755.5 ; 20.1 ;12;25;18;0;12;4;8;6;6;0;0;12
4466; 25.1 ; 50.1 ; -   ;2;5;311;0;2;0;2;0;2;2;0;0
4467; 30.6 ; 153.1 ; 6.2 ;5;47;205;0;5;2;3;4;1;2;3;0
4468; 24.7 ; 74.0 ; 13.7 ;3;32;16;0;3;0;3;2;1;2;1;0
4469; 47.1 ; 376.5 ; 1.0 ;8;14;152;0;8;2;6;5;3;0;8;0
4470; 40.9 ; 81.8 ; 16.0 ;2;9;104;2;0;1;1;1;1;1;0;1
4471; 81.5 ; 163.1 ; 7.6 ;2;126;236;0;2;0;2;2;0;0;0;2
4472; 17.2 ; 34.4 ; 3.3 ;2;15;239;0;2;1;1;2;0;2;0;0
4473; 35.5 ; 319.3 ; 24.4 ;9;26;22;0;9;1;8;3;6;3;3;3
4474; 26.0 ; 130.1 ; 0.8 ;5;13;5;0;5;0;5;4;1;5;0;0
4475; 23.0 ; 622.2 ; 6.5 ;27;14;0;0;27;10;17;3;24;27;0;0
4476; 28.0 ; 83.9 ; 2.3 ;3;3;23;0;3;2;1;0;3;2;1;0
4477; 16.7 ; 166.9 ; 2.5 ;10;14;100;0;10;3;7;2;8;10;0;0
4478; 37.6 ; 112.9 ; 16.7 ;3;5;236;0;3;2;1;1;2;1;2;0
4479; 32.6 ; 65.1 ; 11.2 ;2;103;182;0;2;1;1;1;1;1;1;0
4480; 35.6 ; 71.1 ; 8.0 ;2;246;105;0;2;0;2;1;1;1;1;0
4481; 47.0 ; 141.0 ; 0.4 ;3;112;69;0;3;1;2;3;0;0;3;0
4482; 16.9 ; 50.6 ; 2.3 ;3;29;211;0;3;2;1;2;1;3;0;0
4483; 31.7 ; 126.7 ; 15.5 ;4;11;146;0;4;1;3;3;1;1;3;0
4484; 23.6 ; 94.6 ; 5.8 ;4;26;182;0;4;1;3;1;3;4;0;0
4485; 18.7 ; 93.3 ; 4.6 ;5;86;16;0;5;1;4;4;1;5;0;0
4486; 54.8 ; 164.4 ; 16.3 ;3;20;121;0;3;0;3;3;0;0;2;1
4487; 39.7 ; 79.5 ; 4.7 ;2;50;226;0;2;0;2;1;1;0;2;0
4488; 17.1 ; 68.2 ; 2.6 ;4;1;276;0;4;1;3;3;1;4;0;0
4489; 24.2 ; 145.1 ; 10.1 ;6;31;17;0;6;2;4;3;3;4;2;0
4490; 32.7 ; 490.4 ; 5.8 ;15;23;17;0;15;7;8;7;8;5;10;0
4491; 25.9 ; 51.8 ; 6.4 ;2;32;89;0;2;0;2;2;0;1;1;0
4492; 44.0 ; 263.9 ; 11.4 ;6;46;5;0;6;0;6;5;1;0;4;2
4493; 59.8 ; 658.0 ; 33.1 ;11;23;56;0;11;4;7;4;7;4;0;7
4494; 53.8 ; 161.5 ; 6.8 ;3;100;58;0;3;0;3;0;3;0;2;1
4495; 15.0 ; 74.9 ; -   ;5;4;246;0;5;1;4;5;0;5;0;0
4496; 45.4 ; 363.3 ; 14.5 ;8;12;38;0;8;3;5;3;5;0;5;3
4497; 49.1 ; 147.3 ; 24.2 ;3;27;170;0;3;1;2;2;1;1;1;1
4498; 26.1 ; 391.9 ; 17.0 ;15;22;0;0;15;8;7;2;13;10;5;0
4499; 30.8 ; 61.7 ; 8.6 ;2;18;158;0;2;0;2;2;0;1;1;0
4500; 34.2 ; 717.2 ; 14.5 ;21;20;57;0;21;11;10;13;8;7;14;0
4501; 38.8 ; 77.7 ; 12.9 ;2;89;47;0;2;0;2;2;0;1;1;0
4502; 50.8 ; 304.9 ; 9.8 ;6;14;105;0;6;1;5;3;3;0;4;2
4503; 64.7 ; 129.3 ; 51.6 ;2;61;97;0;2;1;1;0;2;1;0;1
4504; 17.1 ; 34.3 ; 3.2 ;2;19;14;0;2;2;0;1;1;2;0;0
4505; 48.7 ; 681.4 ; 0.2 ;14;14;93;0;14;2;12;8;6;0;14;0
4506; 38.2 ; 267.6 ; 20.8 ;7;17;79;0;7;3;4;4;3;2;3;2
4507; 56.5 ; 2,205.1 ; 22.6 ;39;6;5;0;39;8;31;11;28;0;0;39
4508; 95.1 ; 475.6 ; 66.7 ;5;43;94;0;5;0;5;4;1;2;0;3
4509; 39.5 ; 118.6 ; 13.3 ;3;29;257;0;3;0;3;1;2;1;2;0
4510; 35.3 ; 141.1 ; 7.9 ;4;81;75;0;4;1;3;4;0;1;3;0
4511; 109.6 ; 219.3 ; 91.3 ;2;13;257;0;2;0;2;1;1;1;0;1
4512; 49.7 ; 397.6 ; 35.7 ;8;33;38;0;8;1;7;6;2;3;2;3
4513; 15.5 ; 77.4 ; 1.3 ;5;14;23;0;5;4;1;0;5;5;0;0
4514; 48.4 ; 96.8 ; 13.6 ;2;5;272;0;2;0;2;2;0;0;1;1
4515; 15.0 ; 45.0 ; -   ;3;94;25;0;3;3;0;1;2;3;0;0
4516; 52.8 ; 211.1 ; 30.7 ;4;12;243;0;4;2;2;1;3;1;2;1
4517; 20.7 ; 165.5 ; 5.6 ;8;20;15;0;8;0;8;2;6;8;0;0
4518; 41.4 ; 207.1 ; 22.4 ;5;72;11;0;5;2;3;1;4;2;1;2
4519; 17.8 ; 89.0 ; 2.4 ;5;36;146;0;5;5;0;2;3;5;0;0
4520; 41.7 ; 166.8 ; 11.7 ;4;37;28;0;4;3;1;4;0;1;3;0
4521; 92.3 ; 554.0 ; 35.2 ;6;55;35;0;6;3;3;6;0;0;0;6
4522; 41.3 ; 330.7 ; 20.7 ;8;42;30;0;8;3;5;4;4;3;2;3
4523; 21.3 ; 127.7 ; 7.1 ;6;38;63;2;4;2;4;0;6;6;0;0
4524; 45.9 ; 91.8 ; 3.4 ;2;105;11;1;1;0;2;1;1;0;2;0
4525; 49.1 ; 147.3 ; 0.9 ;3;104;17;0;3;2;1;1;2;0;3;0
4526; 48.5 ; 387.7 ; 2.4 ;8;44;0;0;8;0;8;8;0;0;8;0
4527; 29.7 ; 326.7 ; 16.0 ;11;10;53;0;11;0;11;4;7;7;4;0
4528; 20.6 ; 82.2 ; 9.4 ;4;21;301;0;4;4;0;1;3;4;0;0
4529; 31.3 ; 187.5 ; 10.7 ;6;31;7;0;6;3;3;2;4;2;4;0
4530; 48.7 ; 97.5 ; 5.7 ;2;18;114;0;2;2;0;0;2;0;2;0
4531; 43.5 ; 87.0 ; 13.5 ;2;141;160;0;2;1;1;1;1;1;0;1
4532; 58.6 ; 234.4 ; 8.1 ;4;122;5;1;3;0;4;4;0;0;0;4
4533; 34.9 ; 69.7 ; 9.2 ;2;3;308;0;2;1;1;0;2;1;1;0
4534; 45.7 ; 547.8 ; 15.8 ;12;22;1;0;12;1;11;2;10;4;4;4
4535; 39.7 ; 158.8 ; 9.3 ;4;38;183;0;4;0;4;3;1;0;4;0
4536; 61.2 ; 122.3 ; 18.8 ;2;118;161;0;2;2;0;0;2;0;0;2
4537; 51.0 ; 255.0 ; 12.0 ;5;29;268;0;5;0;5;3;2;0;3;2
4538; 87.2 ; 174.3 ; 13.4 ;2;11;2;0;2;1;1;2;0;0;0;2
4539; 52.9 ; 105.8 ; 0.5 ;2;191;54;0;2;2;0;1;1;0;2;0
4540; 20.0 ; 40.1 ; 7.6 ;2;2;370;0;2;1;1;2;0;2;0;0
4541; 140.4 ; 280.9 ; 100.7 ;2;20;6;0;2;1;1;1;1;0;0;2
4542; 34.5 ; 207.1 ; 16.1 ;6;23;83;0;6;1;5;4;2;2;4;0
4543; 31.6 ; 63.2 ; 24.9 ;2;14;4;0;2;1;1;0;2;1;0;1
4544; 36.6 ; 109.9 ; 19.9 ;3;216;34;0;3;2;1;1;2;1;1;1
4545; 37.6 ; 112.8 ; 1.9 ;3;32;167;0;3;1;2;2;1;0;3;0
4546; 28.2 ; 56.3 ; 3.0 ;2;13;266;0;2;2;0;0;2;1;1;0
4547; 18.8 ; 75.3 ; 1.6 ;4;27;11;1;3;0;4;1;3;4;0;0
4548; 55.3 ; 165.9 ; 11.4 ;3;72;205;0;3;0;3;2;1;0;0;3
4549; 34.7 ; 69.4 ; 14.5 ;2;11;41;1;1;2;0;1;1;1;1;0
4550; 17.5 ; 70.0 ; 5.3 ;4;59;38;0;4;3;1;2;2;4;0;0
4551; 26.1 ; 130.7 ; 10.3 ;5;25;194;0;5;1;4;3;2;3;2;0
4552; 28.1 ; 56.3 ; 4.6 ;2;16;259;0;2;1;1;1;1;1;1;0
4553; 125.0 ; 375.1 ; 82.0 ;3;14;2;0;3;2;1;1;2;0;0;3
4554; 20.2 ; 40.3 ; 1.4 ;2;126;96;1;1;2;0;0;2;2;0;0
4555; 35.5 ; 177.7 ; 13.8 ;5;36;149;0;5;3;2;5;0;2;3;0
4556; 31.9 ; 63.8 ; 18.8 ;2;94;200;0;2;0;2;1;1;1;1;0
4557; 16.9 ; 152.5 ; 5.1 ;9;39;62;0;9;0;9;4;5;9;0;0
4558; 34.4 ; 344.2 ; 30.9 ;10;21;150;0;10;8;2;8;2;3;4;3
4559; 59.1 ; 1,004.1 ; 8.2 ;17;17;14;0;17;11;6;7;10;0;0;17
4560; 44.9 ; 763.2 ; 24.9 ;17;13;2;0;17;4;13;11;6;6;5;6
4561; 55.3 ; 608.5 ; 17.7 ;11;26;17;0;11;6;5;3;8;0;0;11
4562; 16.4 ; 98.5 ; 4.0 ;6;53;15;0;6;2;4;1;5;6;0;0
4563; 42.9 ; 343.1 ; 12.5 ;8;38;87;0;8;5;3;1;7;0;5;3
4564; 32.6 ; 163.0 ; 16.6 ;5;44;96;0;5;5;0;4;1;2;3;0
4565; 30.9 ; 61.7 ; 23.8 ;2;165;47;0;2;0;2;2;0;1;1;0
4566; 47.1 ; 94.2 ; 0.5 ;2;295;26;0;2;0;2;1;1;0;2;0
4567; 53.1 ; 106.3 ; 5.7 ;2;26;84;1;1;0;2;0;2;0;1;1
4568; 70.1 ; 140.3 ; 35.0 ;2;38;232;0;2;1;1;2;0;0;0;2
4569; 15.6 ; 77.9 ; 1.3 ;5;16;170;0;5;3;2;1;4;5;0;0
4570; 42.3 ; 1,016.3 ; 34.9 ;24;20;2;0;24;8;16;17;7;8;8;8
4571; 55.8 ; 669.6 ; 32.1 ;12;25;8;0;12;4;8;3;9;4;0;8
4572; 47.5 ; 94.9 ; -   ;2;7;35;0;2;1;1;1;1;0;2;0
4573; 27.2 ; 816.5 ; 11.3 ;30;9;0;0;30;11;19;12;18;20;10;0
4574; 16.4 ; 98.5 ; 4.0 ;6;50;32;0;6;1;5;3;3;6;0;0
4575; 15.0 ; 30.0 ; -   ;2;168;32;0;2;0;2;0;2;2;0;0
4576; 36.1 ; 288.9 ; 11.4 ;8;18;19;3;5;2;6;3;5;3;5;0
4577; 15.0 ; 30.0 ; -   ;2;153;180;0;2;2;0;0;2;2;0;0
4578; 47.9 ; 670.1 ; 22.4 ;14;14;261;0;14;6;8;9;5;5;4;5
4579; 60.6 ; 181.8 ; 20.3 ;3;4;238;0;3;3;0;1;2;0;0;3
4580; 32.7 ; 261.8 ; 14.6 ;8;26;20;0;8;4;4;6;2;3;5;0
4581; 25.4 ; 1,119.0 ; 5.4 ;44;4;4;0;44;23;21;35;9;29;15;0
4582; 28.6 ; 142.8 ; 28.1 ;5;35;217;0;5;3;2;3;2;3;0;2
4583; 30.0 ; 90.0 ; 9.2 ;3;7;1;0;3;1;2;2;1;1;2;0
4584; 15.0 ; 30.0 ; -   ;2;3;160;0;2;1;1;2;0;2;0;0
4585; 44.2 ; 88.5 ; 21.0 ;2;27;246;0;2;1;1;2;0;1;0;1
4586; 50.1 ; 150.3 ; 3.1 ;3;107;26;0;3;1;2;1;2;0;3;0
4587; 26.3 ; 131.6 ; 12.2 ;5;11;234;0;5;2;3;2;3;3;2;0
4588; 48.9 ; 244.5 ; 2.3 ;5;14;39;0;5;1;4;5;0;0;5;0
4589; 48.6 ; 194.2 ; 19.1 ;4;101;40;0;4;3;1;3;1;1;2;1
4590; 38.3 ; 76.7 ; 19.8 ;2;3;155;0;2;1;1;0;2;1;0;1
4591; 73.1 ; 219.4 ; 18.2 ;3;16;28;0;3;2;1;1;2;0;0;3
4592; 26.7 ; 347.7 ; 11.3 ;13;19;74;0;13;5;8;3;10;9;4;0
4593; 18.3 ; 55.0 ; 6.2 ;3;38;149;0;3;3;0;1;2;3;0;0
4594; 24.7 ; 49.4 ; 14.6 ;2;180;131;0;2;1;1;0;2;1;1;0
4595; 62.3 ; 187.0 ; 28.6 ;3;13;148;0;3;0;3;2;1;0;0;3
4596; 35.6 ; 142.2 ; 18.4 ;4;29;264;0;4;1;3;2;2;1;3;0
4597; 42.6 ; 298.1 ; 12.8 ;7;38;152;0;7;3;4;5;2;2;3;2
4598; 45.0 ; 225.0 ; 15.0 ;5;16;242;0;5;2;3;4;1;0;3;2
4599; 43.1 ; 86.2 ; 23.7 ;2;59;131;1;1;1;1;1;1;1;0;1
4600; 32.8 ; 459.6 ; 17.7 ;14;17;4;0;14;4;10;8;6;5;9;0
4601; 20.7 ; 62.0 ; 4.7 ;3;11;173;2;1;1;2;1;2;3;0;0
4602; 57.2 ; 286.2 ; 22.3 ;5;12;2;0;5;3;2;2;3;0;0;5
4603; 31.5 ; 471.8 ; 20.4 ;15;13;0;0;15;11;4;8;7;5;10;0
4604; 34.3 ; 240.0 ; 15.1 ;7;49;1;0;7;4;3;5;2;2;5;0
4605; 33.3 ; 200.0 ; 9.7 ;6;21;183;0;6;0;6;2;4;2;4;0
4606; 48.4 ; 145.2 ; 3.0 ;3;151;99;0;3;0;3;3;0;0;3;0
4607; 77.6 ; 232.7 ; 30.6 ;3;68;47;0;3;1;2;3;0;0;0;3
4608; 42.7 ; 213.7 ; 20.3 ;5;40;185;0;5;4;1;1;4;2;1;2
4609; 79.6 ; 159.1 ; 49.1 ;2;33;127;2;0;1;1;0;2;0;0;2
4610; 95.2 ; 190.4 ; 32.8 ;2;8;7;0;2;2;0;2;0;0;0;2
4611; 24.3 ; 218.3 ; 10.7 ;9;17;59;0;9;6;3;5;4;6;3;0
4612; 51.6 ; 206.2 ; 10.4 ;4;38;8;0;4;4;0;1;3;0;3;1
4613; 33.6 ; 67.2 ; 19.7 ;2;5;239;0;2;1;1;2;0;1;1;0
4614; 17.3 ; 34.7 ; 3.5 ;2;5;275;0;2;2;0;1;1;2;0;0
4615; 57.7 ; 288.3 ; 17.1 ;5;41;136;0;5;1;4;2;3;0;0;5
4616; 50.7 ; 760.4 ; 6.9 ;15;22;15;0;15;0;15;15;0;0;10;5
4617; 45.1 ; 135.2 ; 2.2 ;3;23;9;0;3;2;1;3;0;0;3;0
4618; 32.5 ; 162.4 ; 17.8 ;5;34;105;0;5;1;4;3;2;2;3;0
4619; 46.8 ; 93.5 ; -   ;2;90;287;0;2;1;1;1;1;0;2;0
4620; 38.6 ; 270.4 ; 26.1 ;7;17;20;0;7;0;7;2;5;2;3;2
4621; 77.4 ; 232.2 ; 44.0 ;3;23;108;0;3;1;2;2;1;0;0;3
4622; 34.3 ; 103.0 ; 17.0 ;3;79;47;0;3;0;3;2;1;1;2;0
4623; 53.2 ; 319.4 ; 8.9 ;6;51;0;0;6;1;5;4;2;0;4;2
4624; 52.9 ; 211.4 ; 22.3 ;4;57;31;0;4;0;4;3;1;0;3;1
4625; 38.9 ; 1,749.6 ; 20.8 ;45;6;16;0;45;23;22;17;28;15;15;15
4626; 52.5 ; 105.0 ; -   ;2;95;173;0;2;0;2;2;0;0;2;0
4627; 50.9 ; 152.8 ; 23.5 ;3;16;78;3;0;1;2;1;2;1;1;1
4628; 28.0 ; 56.0 ; 4.4 ;2;41;5;0;2;1;1;1;1;1;1;0
4629; 42.8 ; 256.9 ; 13.0 ;6;64;38;0;6;0;6;3;3;2;2;2
4630; 44.8 ; 89.6 ; 2.9 ;2;6;120;0;2;0;2;0;2;0;2;0
4631; 48.7 ; 97.4 ; -   ;2;12;257;0;2;0;2;0;2;0;2;0
4632; 15.6 ; 77.9 ; 0.4 ;5;40;50;0;5;4;1;5;0;5;0;0
4633; 15.0 ; 59.9 ; -   ;4;14;0;0;4;3;1;1;3;4;0;0
4634; 18.7 ; 149.7 ; 7.9 ;8;23;12;0;8;6;2;1;7;8;0;0
4635; 67.8 ; 203.5 ; 8.4 ;3;7;155;0;3;1;2;2;1;0;0;3
4636; 52.3 ; 366.2 ; 21.6 ;7;45;1;0;7;3;4;1;6;0;5;2
4637; 15.0 ; 89.9 ; -   ;6;18;2;0;6;4;2;5;1;6;0;0
4638; 50.0 ; 799.7 ; 29.4 ;16;23;20;0;16;9;7;9;7;5;6;5
4639; 20.0 ; 40.1 ; 7.6 ;2;63;26;0;2;0;2;1;1;2;0;0
4640; 18.3 ; 55.0 ; 6.2 ;3;167;61;0;3;3;0;1;2;3;0;0
4641; 36.4 ; 509.3 ; 33.6 ;14;27;3;0;14;4;10;5;9;5;4;5
4642; 30.9 ; 678.8 ; 15.9 ;22;14;0;4;18;5;17;8;14;7;15;0
4643; 53.0 ; 159.0 ; 0.4 ;3;57;47;0;3;0;3;2;1;0;3;0
4644; 50.0 ; 100.0 ; 4.9 ;2;224;93;0;2;2;0;0;2;0;2;0
4645; 52.0 ; 260.0 ; 1.7 ;5;39;89;0;5;0;5;3;2;0;5;0
4646; 15.0 ; 30.0 ; -   ;2;131;96;0;2;1;1;1;1;2;0;0
4647; 48.9 ; 586.5 ; 21.6 ;12;24;14;0;12;2;10;8;4;4;4;4
4648; 33.9 ; 746.1 ; 5.7 ;22;15;5;0;22;5;17;4;18;7;15;0
4649; 51.6 ; 206.3 ; 4.5 ;4;52;141;0;4;2;2;2;2;0;3;1
4650; 37.2 ; 74.3 ; -   ;2;23;104;2;0;2;0;2;0;0;2;0
4651; 51.1 ; 153.2 ; 6.2 ;3;122;183;0;3;0;3;1;2;0;2;1
4652; 25.1 ; 50.1 ; -   ;2;10;195;0;2;0;2;2;0;2;0;0
4653; 63.3 ; 126.6 ; 71.1 ;2;45;115;0;2;0;2;1;1;1;0;1
4654; 38.9 ; 194.7 ; 19.5 ;5;82;6;0;5;0;5;2;3;2;1;2
4655; 15.0 ; 45.0 ; -   ;3;70;16;0;3;2;1;3;0;3;0;0
4656; 61.8 ; 123.6 ; -   ;2;4;275;0;2;1;1;1;1;0;0;2
4657; 43.9 ; 307.0 ; 19.7 ;7;32;12;0;7;3;4;4;3;2;3;2
4658; 36.8 ; 73.6 ; 16.0 ;2;4;47;0;2;1;1;2;0;1;1;0
4659; 46.2 ; 138.6 ; 34.2 ;3;56;296;0;3;1;2;2;1;1;1;1
4660; 41.6 ; 124.7 ; 6.1 ;3;16;0;0;3;0;3;2;1;0;3;0
4661; 36.9 ; 184.6 ; 10.4 ;5;21;79;0;5;0;5;5;0;2;3;0
4662; 44.4 ; 177.7 ; 21.9 ;4;54;73;0;4;2;2;2;2;1;2;1
4663; 72.2 ; 144.4 ; 37.1 ;2;59;74;0;2;1;1;0;2;0;0;2
4664; 18.6 ; 74.5 ; 5.1 ;4;99;102;0;4;4;0;2;2;4;0;0
4665; 55.5 ; 499.5 ; 16.1 ;9;31;5;0;9;0;9;9;0;0;0;9
4666; 24.0 ; 168.2 ; 12.4 ;7;32;31;0;7;0;7;2;5;5;2;0
4667; 15.8 ; 31.7 ; -   ;2;12;77;2;0;2;0;2;0;2;0;0
4668; 33.4 ; 66.7 ; 20.1 ;2;130;170;0;2;1;1;1;1;1;1;0
4669; 26.3 ; 131.7 ; 9.3 ;5;53;43;0;5;3;2;3;2;3;2;0
4670; 62.7 ; 125.3 ; 26.9 ;2;166;79;0;2;1;1;1;1;0;0;2
4671; 18.9 ; 75.7 ; 1.7 ;4;4;136;4;0;2;2;1;3;4;0;0
4672; 30.5 ; 122.0 ; 11.5 ;4;28;107;0;4;3;1;2;2;1;3;0
4673; 22.6 ; 45.2 ; 11.4 ;2;106;142;0;2;0;2;2;0;1;1;0
4674; 19.0 ; 266.0 ; 8.8 ;14;21;26;0;14;4;10;11;3;14;0;0
4675; 46.5 ; 232.5 ; 25.5 ;5;30;65;0;5;2;3;4;1;2;1;2
4676; 109.2 ; 327.5 ; 112.1 ;3;86;79;0;3;1;2;1;2;1;0;2
4677; 46.6 ; 652.7 ; 27.5 ;14;20;23;0;14;6;8;4;10;5;4;5
4678; 67.4 ; 202.1 ; 58.3 ;3;20;288;0;3;0;3;2;1;1;0;2
4679; 46.7 ; 653.8 ; 3.3 ;14;24;14;1;13;6;8;8;6;0;14;0
4680; 118.3 ; 236.6 ; 107.2 ;2;70;86;2;0;2;0;1;1;1;0;1
4681; 18.8 ; 75.1 ; 8.0 ;4;85;68;0;4;1;3;2;2;4;0;0
4682; 51.5 ; 257.6 ; 12.9 ;5;83;5;0;5;1;4;2;3;0;3;2
4683; 52.8 ; 264.1 ; 22.2 ;5;68;33;0;5;2;3;2;3;0;3;2
4684; 39.6 ; 198.1 ; 15.6 ;5;19;37;0;5;2;3;5;0;2;1;2
4685; 38.2 ; 381.6 ; 11.6 ;10;25;40;0;10;4;6;7;3;3;7;0
4686; 75.3 ; 527.3 ; 7.4 ;7;36;3;1;6;1;6;7;0;0;0;7
4687; 25.1 ; 50.1 ; -   ;2;9;39;0;2;1;1;1;1;2;0;0
4688; 26.9 ; 161.5 ; 13.3 ;6;5;231;0;6;3;3;0;6;4;2;0
4689; 63.5 ; 381.0 ; 26.0 ;6;55;68;0;6;2;4;3;3;0;0;6
4690; 33.9 ; 169.4 ; 16.2 ;5;38;30;0;5;1;4;1;4;2;3;0
4691; 22.5 ; 44.9 ; 11.2 ;2;461;17;0;2;2;0;2;0;1;1;0
4692; 52.4 ; 104.9 ; 56.1 ;2;161;16;0;2;1;1;1;1;1;0;1
4693; 18.8 ; 75.1 ; 8.0 ;4;95;20;0;4;0;4;3;1;4;0;0
4694; 63.7 ; 446.0 ; 30.7 ;7;35;5;7;0;2;5;7;0;0;0;7
4695; 26.9 ; 805.5 ; 15.5 ;30;10;2;0;30;11;19;16;14;20;10;0
4696; 26.1 ; 182.6 ; 11.0 ;7;34;33;0;7;6;1;5;2;5;2;0
4697; 33.3 ; 266.7 ; 10.1 ;8;27;52;0;8;3;5;2;6;3;5;0
4698; 52.4 ; 104.8 ; 56.0 ;2;139;141;0;2;0;2;2;0;1;0;1
4699; 20.0 ; 40.1 ; 7.6 ;2;81;309;0;2;0;2;2;0;2;0;0
4700; 41.6 ; 207.8 ; 9.4 ;5;14;299;0;5;0;5;4;1;0;5;0
4701; 52.3 ; 104.7 ; 5.7 ;2;87;194;0;2;0;2;2;0;0;1;1
4702; 39.3 ; 78.7 ; 7.1 ;2;4;185;0;2;1;1;0;2;0;2;0
4703; 44.2 ; 88.4 ; 21.0 ;2;1;42;0;2;0;2;2;0;1;0;1
4704; 25.6 ; 127.8 ; 11.5 ;5;27;179;0;5;4;1;1;4;3;2;0
4705; 17.7 ; 88.6 ; 2.9 ;5;54;61;0;5;1;4;2;3;5;0;0
4706; 31.8 ; 604.7 ; 14.5 ;19;16;5;0;19;6;13;18;1;6;13;0
4707; 28.5 ; 57.1 ; 12.1 ;2;142;116;0;2;0;2;0;2;1;1;0
4708; 30.2 ; 60.4 ; -   ;2;24;152;0;2;0;2;1;1;0;2;0
4709; 58.1 ; 116.3 ; 29.2 ;2;20;52;0;2;0;2;2;0;1;0;1
4710; 55.3 ; 165.8 ; 8.3 ;3;92;10;0;3;1;2;2;1;0;0;3
4711; 47.2 ; 94.4 ; 39.6 ;2;13;245;0;2;2;0;0;2;1;0;1
4712; 71.2 ; 142.4 ; 22.5 ;2;86;2;0;2;1;1;1;1;0;0;2
4713; 19.9 ; 99.5 ; 8.7 ;5;55;34;1;4;2;3;2;3;5;0;0
4714; 114.9 ; 229.7 ; 102.0 ;2;116;160;0;2;1;1;1;1;1;0;1
4715; 32.6 ; 163.1 ; 10.2 ;5;51;5;0;5;2;3;4;1;2;3;0
4716; 59.2 ; 177.5 ; 13.7 ;3;53;68;0;3;0;3;2;1;0;0;3
4717; 67.6 ; 202.7 ; 12.7 ;3;5;347;0;3;0;3;3;0;0;0;3
4718; 35.6 ; 213.3 ; 6.6 ;6;9;167;0;6;3;3;3;3;2;4;0
4719; 27.9 ; 111.5 ; 9.7 ;4;14;237;0;4;2;2;2;2;3;1;0
4720; 45.9 ; 137.6 ; 12.0 ;3;140;39;0;3;1;2;2;1;0;2;1
4721; 40.1 ; 80.1 ; -   ;2;133;161;0;2;2;0;1;1;0;2;0
4722; 23.2 ; 116.0 ; 4.3 ;5;45;0;0;5;3;2;0;5;5;0;0
4723; 55.6 ; 278.0 ; 7.1 ;5;79;2;0;5;3;2;4;1;0;0;5
4724; 54.2 ; 108.3 ; 3.9 ;2;41;81;0;2;1;1;1;1;0;1;1
4725; 59.0 ; 177.1 ; 4.2 ;3;20;110;3;0;0;3;0;3;0;0;3
4726; 34.3 ; 68.5 ; 13.8 ;2;68;252;0;2;0;2;1;1;1;1;0
4727; 19.5 ; 39.0 ; 0.3 ;2;9;162;2;0;1;1;0;2;2;0;0
4728; 22.3 ; 133.8 ; 9.6 ;6;36;89;1;5;3;3;4;2;4;2;0
4729; 63.5 ; 126.9 ; 22.1 ;2;58;114;0;2;1;1;1;1;0;0;2
4730; 39.8 ; 119.4 ; 9.6 ;3;117;22;0;3;1;2;2;1;0;3;0
4731; 44.5 ; 578.8 ; 10.2 ;13;15;5;0;13;3;10;6;7;0;13;0
4732; 31.9 ; 191.5 ; 15.0 ;6;45;153;0;6;3;3;5;1;2;4;0
4733; 22.7 ; 339.8 ; 10.4 ;15;20;2;0;15;8;7;9;6;10;5;0
4734; 24.8 ; 74.3 ; 5.7 ;3;101;72;0;3;1;2;1;2;2;1;0
4735; 29.8 ; 119.1 ; 19.3 ;4;18;120;0;4;2;2;2;2;3;1;0
4736; 27.1 ; 217.1 ; 15.2 ;8;37;143;0;8;7;1;1;7;5;3;0
4737; 47.6 ; 142.9 ; 1.0 ;3;132;52;0;3;0;3;3;0;0;3;0
4738; 40.0 ; 120.0 ; 22.9 ;3;75;188;0;3;1;2;2;1;1;1;1
4739; 40.5 ; 81.0 ; 32.8 ;2;57;0;0;2;0;2;1;1;1;0;1
4740; 44.8 ; 134.5 ; 26.7 ;3;32;41;1;2;0;3;1;2;1;1;1
4741; 54.2 ; 650.5 ; 34.0 ;12;21;70;0;12;5;7;10;2;4;4;4
4742; 62.1 ; 124.2 ; 0.5 ;2;161;43;0;2;0;2;0;2;0;0;2
4743; 27.2 ; 380.6 ; 18.7 ;14;20;8;0;14;2;12;9;5;9;5;0
4744; 32.6 ; 65.2 ; 3.6 ;2;117;254;0;2;1;1;1;1;1;1;0
4745; 32.3 ; 64.6 ; 2.1 ;2;2;1;0;2;1;1;0;2;0;2;0
4746; 22.2 ; 66.6 ; 13.2 ;3;58;17;0;3;2;1;3;0;2;1;0
4747; 46.3 ; 92.6 ; 24.2 ;2;275;62;1;1;2;0;1;1;1;0;1
4748; 25.4 ; 407.2 ; 12.7 ;16;19;17;0;16;6;10;8;8;11;5;0
4749; 25.0 ; 50.0 ; 15.0 ;2;26;206;0;2;2;0;1;1;1;1;0
4750; 61.5 ; 123.0 ; -   ;2;7;147;2;0;0;2;1;1;0;0;2
4751; 32.2 ; 64.4 ; 10.7 ;2;74;289;0;2;0;2;2;0;1;1;0
4752; 16.5 ; 33.0 ; 2.3 ;2;1;92;0;2;2;0;1;1;2;0;0
4753; 102.0 ; 204.1 ; 65.6 ;2;237;37;0;2;1;1;1;1;0;0;2
4754; 32.4 ; 64.8 ; 11.1 ;2;14;83;0;2;0;2;1;1;1;1;0
4755; 36.5 ; 146.2 ; 6.6 ;4;77;22;0;4;1;3;3;1;1;3;0
4756; 29.6 ; 59.2 ; 0.5 ;2;5;236;0;2;0;2;0;2;1;1;0
4757; 39.2 ; 353.0 ; 9.2 ;9;37;3;1;8;1;8;9;0;3;6;0
4758; 49.5 ; 692.8 ; 13.5 ;14;20;41;0;14;3;11;10;4;0;9;5
4759; 15.0 ; 30.0 ; -   ;2;73;0;2;0;1;1;0;2;2;0;0
4760; 24.8 ; 173.3 ; 12.7 ;7;5;11;0;7;0;7;5;2;5;2;0
4761; 37.9 ; 189.3 ; 27.5 ;5;15;299;0;5;2;3;4;1;2;1;2
4762; 47.7 ; 95.5 ; 1.5 ;2;94;164;0;2;0;2;1;1;0;2;0
4763; 73.4 ; 220.1 ; 25.0 ;3;86;22;0;3;0;3;1;2;0;0;3
4764; 59.3 ; 178.0 ; 5.7 ;3;86;40;0;3;1;2;3;0;0;0;3
4765; 43.0 ; 301.3 ; 16.5 ;7;25;31;0;7;1;6;6;1;2;3;2
4766; 22.6 ; 67.7 ; 6.9 ;3;119;68;0;3;1;2;3;0;3;0;0
4767; 45.5 ; 227.5 ; 28.3 ;5;52;81;0;5;3;2;2;3;2;1;2
4768; 94.6 ; 189.2 ; 71.6 ;2;89;104;2;0;1;1;1;1;1;0;1
4769; 39.0 ; 155.8 ; 20.2 ;4;29;190;0;4;1;3;2;2;1;2;1
4770; 32.6 ; 163.0 ; 12.4 ;5;32;47;0;5;3;2;1;4;2;3;0
4771; 64.9 ; 129.8 ; 27.6 ;2;93;315;0;2;0;2;2;0;0;0;2
4772; 15.0 ; 30.0 ; -   ;2;19;247;0;2;0;2;2;0;2;0;0
4773; 30.7 ; 184.4 ; 14.1 ;6;19;195;0;6;4;2;0;6;2;4;0
4774; 15.0 ; 74.9 ; -   ;5;27;5;0;5;0;5;3;2;5;0;0
4775; 45.8 ; 275.0 ; 13.4 ;6;10;0;0;6;1;5;4;2;0;4;2
4776; 48.3 ; 96.5 ; 27.3 ;2;48;70;0;2;1;1;2;0;1;0;1
4777; 32.6 ; 326.4 ; 15.9 ;10;41;32;0;10;6;4;7;3;3;7;0
4778; 25.1 ; 75.2 ; -   ;3;173;23;0;3;2;1;0;3;3;0;0
4779; 71.4 ; 285.7 ; 28.0 ;4;59;137;1;3;0;4;4;0;0;0;4
4780; 72.5 ; 144.9 ; 17.8 ;2;50;20;2;0;0;2;2;0;0;0;2
4781; 26.7 ; 1,014.2 ; 16.0 ;38;9;6;0;38;25;13;34;4;25;13;0
4782; 43.1 ; 86.2 ; 17.8 ;2;40;169;0;2;1;1;0;2;1;0;1
4783; 16.5 ; 33.0 ; 2.3 ;2;14;104;0;2;0;2;2;0;2;0;0
4784; 49.5 ; 148.6 ; 3.5 ;3;34;102;0;3;3;0;2;1;0;3;0
4785; 27.6 ; 55.3 ; 3.8 ;2;3;194;0;2;1;1;2;0;1;1;0
4786; 32.3 ; 742.7 ; 17.1 ;23;16;14;0;23;6;17;9;14;8;15;0
4787; 17.0 ; 237.9 ; 5.9 ;14;24;1;0;14;11;3;7;7;14;0;0
4788; 100.8 ; 403.2 ; 106.4 ;4;84;95;0;4;1;3;4;0;1;0;3
4789; 21.7 ; 260.8 ; 3.8 ;12;12;111;0;12;5;7;7;5;12;0;0
4790; 41.0 ; 204.9 ; 13.8 ;5;62;57;0;5;1;4;4;1;2;3;0
4791; 30.9 ; 61.7 ; 23.8 ;2;154;120;0;2;1;1;1;1;1;1;0
4792; 43.7 ; 218.7 ; 13.6 ;5;103;47;0;5;0;5;5;0;0;3;2
4793; 19.6 ; 97.9 ; 4.9 ;5;94;70;0;5;3;2;1;4;5;0;0
4794; 20.5 ; 797.6 ; 7.6 ;39;9;52;0;39;19;20;17;22;39;0;0
4795; 83.9 ; 251.8 ; 20.0 ;3;93;128;0;3;2;1;1;2;0;0;3
4796; 37.0 ; 74.0 ; 10.5 ;2;113;5;0;2;0;2;2;0;1;1;0
4797; 30.2 ; 60.4 ; -   ;2;29;44;0;2;1;1;1;1;0;2;0
4798; 20.0 ; 40.1 ; 7.6 ;2;196;10;0;2;0;2;0;2;2;0;0
4799; 40.6 ; 81.1 ; 9.3 ;2;25;206;0;2;0;2;2;0;0;2;0
4800; 42.1 ; 84.1 ; 25.5 ;2;23;209;0;2;1;1;1;1;1;0;1
4801; 22.3 ; 491.6 ; 9.5 ;22;14;45;0;22;11;11;10;12;15;7;0
4802; 46.8 ; 234.0 ; 5.8 ;5;35;122;0;5;4;1;2;3;0;5;0
4803; 26.5 ; 424.6 ; 19.1 ;16;18;133;0;16;11;5;4;12;11;5;0
4804; 42.6 ; 85.2 ; 1.5 ;2;7;97;0;2;2;0;0;2;0;2;0
4805; 24.5 ; 98.1 ; 3.4 ;4;4;266;0;4;4;0;4;0;4;0;0
4806; 44.3 ; 265.8 ; 12.2 ;6;48;26;0;6;2;4;4;2;0;4;2
4807; 41.4 ; 82.7 ; 16.7 ;2;19;131;0;2;0;2;1;1;1;0;1
4808; 25.0 ; 900.9 ; 10.3 ;36;8;5;0;36;22;14;21;15;24;12;0
4809; 43.8 ; 87.7 ; 20.4 ;2;1;130;1;1;1;1;1;1;1;0;1
4810; 64.6 ; 129.2 ; 20.4 ;2;327;8;1;1;2;0;2;0;0;0;2
4811; 38.5 ; 76.9 ; 12.4 ;2;38;215;0;2;0;2;1;1;1;1;0
4812; 27.8 ; 389.5 ; 11.2 ;14;21;40;0;14;1;13;13;1;9;5;0
4813; 28.6 ; 57.2 ; 5.3 ;2;14;260;0;2;1;1;1;1;1;1;0
4814; 48.7 ; 97.4 ; -   ;2;27;308;0;2;1;1;1;1;0;2;0
4815; 63.6 ; 572.8 ; 27.4 ;9;31;38;0;9;4;5;2;7;0;0;9
4816; 25.7 ; 51.4 ; 16.1 ;2;74;290;0;2;0;2;0;2;1;1;0
4817; 15.0 ; 45.0 ; -   ;3;7;268;0;3;2;1;1;2;3;0;0
4818; 80.3 ; 561.8 ; 15.8 ;7;40;31;0;7;0;7;5;2;0;0;7
4819; 32.8 ; 98.3 ; 12.8 ;3;141;32;0;3;0;3;1;2;1;2;0
4820; 47.9 ; 671.2 ; 18.8 ;14;22;5;0;14;0;14;14;0;5;4;5
4821; 15.0 ; 30.0 ; -   ;2;261;132;0;2;1;1;0;2;2;0;0
4822; 18.7 ; 74.8 ; 5.3 ;4;46;160;0;4;3;1;2;2;4;0;0
4823; 48.1 ; 96.2 ; 0.9 ;2;87;26;0;2;0;2;1;1;0;2;0
4824; 68.0 ; 816.1 ; 40.2 ;12;32;20;0;12;0;12;11;1;4;0;8
4825; 36.3 ; 253.8 ; 7.8 ;7;57;23;0;7;2;5;3;4;2;5;0
4826; 24.6 ; 49.3 ; 14.5 ;2;29;150;0;2;1;1;0;2;1;1;0
4827; 17.0 ; 85.0 ; 4.8 ;5;11;36;0;5;1;4;3;2;5;0;0
4828; 26.1 ; 156.5 ; 14.9 ;6;60;50;0;6;2;4;4;2;4;2;0
4829; 25.1 ; 50.1 ; -   ;2;27;152;0;2;1;1;0;2;2;0;0
4830; 55.2 ; 220.7 ; 19.8 ;4;96;41;0;4;0;4;4;0;0;0;4
4831; 87.8 ; 351.3 ; 64.1 ;4;56;86;0;4;1;3;2;2;1;0;3
4832; 33.2 ; 99.6 ; 9.8 ;3;20;272;0;3;1;2;3;0;1;2;0
4833; 38.1 ; 190.4 ; 8.5 ;5;40;188;0;5;2;3;3;2;2;3;0
4834; 44.2 ; 132.5 ; 2.4 ;3;26;344;0;3;1;2;1;2;0;3;0
4835; 38.5 ; 76.9 ; 12.4 ;2;52;107;0;2;1;1;2;0;1;1;0
4836; 58.5 ; 234.1 ; 25.1 ;4;134;15;0;4;2;2;4;0;0;0;4
4837; 52.5 ; 105.0 ; -   ;2;30;237;0;2;0;2;0;2;0;2;0
4838; 69.9 ; 349.4 ; 24.9 ;5;39;36;0;5;3;2;1;4;0;0;5
4839; 37.7 ; 75.5 ; 0.9 ;2;188;73;0;2;1;1;2;0;0;2;0
4840; 39.1 ; 469.6 ; 15.3 ;12;18;240;0;12;5;7;10;2;4;8;0
4841; 36.1 ; 324.8 ; 20.0 ;9;36;8;0;9;7;2;7;2;3;3;3
4842; 42.7 ; 213.7 ; 34.3 ;5;51;43;0;5;1;4;2;3;2;1;2
4843; 55.0 ; 274.8 ; 4.9 ;5;32;17;1;4;0;5;3;2;0;3;2
4844; 33.2 ; 631.6 ; 11.3 ;19;14;14;0;19;16;3;7;12;6;13;0
4845; 23.8 ; 47.5 ; 7.8 ;2;18;262;0;2;0;2;2;0;1;1;0
4846; 16.7 ; 33.4 ; 1.6 ;2;4;222;0;2;1;1;1;1;2;0;0
4847; 58.5 ; 351.1 ; 33.1 ;6;7;30;6;0;3;3;4;2;2;0;4
4848; 47.2 ; 943.8 ; 7.2 ;20;14;10;0;20;13;7;5;15;0;20;0
4849; 38.0 ; 76.0 ; 17.7 ;2;230;71;0;2;1;1;0;2;1;0;1
4850; 75.5 ; 150.9 ; 35.5 ;2;48;30;2;0;2;0;0;2;0;0;2
4851; 43.1 ; 215.4 ; 18.8 ;5;68;22;0;5;0;5;4;1;2;1;2
4852; 58.1 ; 174.4 ; 19.3 ;3;54;139;0;3;1;2;3;0;0;0;3
4853; 36.3 ; 72.5 ; 16.8 ;2;68;83;0;2;0;2;1;1;1;1;0
4854; 64.7 ; 129.3 ; 10.7 ;2;7;115;0;2;0;2;2;0;0;0;2
4855; 47.5 ; 94.9 ; -   ;2;10;84;0;2;1;1;2;0;0;2;0
4856; 42.4 ; 84.8 ; 8.7 ;2;14;10;0;2;0;2;1;1;0;2;0
4857; 20.4 ; 102.0 ; 14.0 ;5;42;17;5;0;4;1;0;5;3;2;0
4858; 37.6 ; 451.4 ; 10.8 ;12;17;10;0;12;2;10;8;4;4;8;0
4859; 64.3 ; 514.1 ; 11.5 ;8;36;14;0;8;0;8;8;0;0;0;8
4860; 28.6 ; 57.2 ; 1.1 ;2;59;179;0;2;1;1;1;1;2;0;0
4861; 66.1 ; 528.8 ; 16.8 ;8;14;19;1;7;4;4;1;7;0;0;8
4862; 46.8 ; 140.3 ; -   ;3;6;253;0;3;2;1;2;1;0;3;0
4863; 18.6 ; 37.2 ; -   ;2;19;324;0;2;1;1;2;0;2;0;0
4864; 45.2 ; 135.7 ; 7.1 ;3;59;104;1;2;0;3;2;1;0;3;0
4865; 38.6 ; 231.8 ; 9.2 ;6;32;74;0;6;3;3;6;0;2;4;0
4866; 21.1 ; 105.5 ; -   ;5;61;5;0;5;1;4;4;1;5;0;0
4867; 66.2 ; 132.5 ; 2.9 ;2;42;5;0;2;0;2;2;0;0;0;2
4868; 29.7 ; 148.4 ; 14.3 ;5;45;110;0;5;0;5;4;1;3;2;0
4869; 37.6 ; 75.2 ; 18.8 ;2;3;46;0;2;1;1;1;1;1;0;1
4870; 66.0 ; 263.8 ; 16.0 ;4;58;0;0;4;2;2;2;2;0;0;4
4871; 44.4 ; 88.8 ; 28.9 ;2;48;238;0;2;1;1;1;1;1;0;1
4872; 43.7 ; 87.4 ; 14.2 ;2;3;46;0;2;2;0;0;2;1;0;1
4873; 38.3 ; 114.8 ; 14.8 ;3;5;374;0;3;0;3;0;3;1;2;0
4874; 33.9 ; 101.8 ; 12.0 ;3;79;94;0;3;0;3;3;0;1;2;0
4875; 28.1 ; 365.0 ; 3.5 ;13;11;26;0;13;1;12;9;4;9;4;0
4876; 38.5 ; 115.5 ; 12.4 ;3;89;115;0;3;2;1;1;2;1;2;0
4877; 30.5 ; 61.1 ; 0.5 ;2;20;14;2;0;1;1;0;2;0;2;0
4878; 57.9 ; 231.5 ; 6.8 ;4;76;105;0;4;1;3;3;1;0;0;4
4879; 25.4 ; 228.9 ; 14.0 ;9;22;9;9;0;8;1;9;0;6;3;0
4880; 38.4 ; 76.7 ; 12.6 ;2;21;97;0;2;2;0;0;2;1;1;0
4881; 64.4 ; 128.8 ; 58.9 ;2;2;113;2;0;1;1;2;0;1;0;1
4882; 48.5 ; 194.0 ; 21.8 ;4;96;131;0;4;1;3;3;1;1;2;1
4883; 59.2 ; 177.6 ; 11.6 ;3;110;27;0;3;0;3;1;2;0;0;3
4884; 22.3 ; 356.3 ; 4.9 ;16;17;35;0;16;5;11;5;11;16;0;0
4885; 43.6 ; 217.9 ; 13.3 ;5;12;101;5;0;5;0;1;4;0;3;2
4886; 69.5 ; 486.5 ; 12.9 ;7;35;5;0;7;0;7;7;0;0;0;7
4887; 45.7 ; 91.5 ; 39.0 ;2;309;20;1;1;0;2;2;0;1;0;1
4888; 25.4 ; 76.3 ; 5.3 ;3;9;2;0;3;3;0;1;2;2;1;0
4889; 107.2 ; 214.3 ; 3.2 ;2;41;125;0;2;1;1;2;0;0;0;2
4890; 168.3 ; 336.6 ; 180.9 ;2;60;2;0;2;1;1;1;1;1;0;1
4891; 40.5 ; 202.6 ; 10.3 ;5;33;44;0;5;3;2;2;3;0;5;0
4892; 41.9 ; 125.8 ; 10.8 ;3;15;21;0;3;1;2;3;0;0;3;0
4893; 57.2 ; 171.6 ; 2.3 ;3;20;136;0;3;2;1;2;1;0;0;3
4894; 19.2 ; 692.2 ; 7.5 ;36;10;2;0;36;19;17;30;6;36;0;0
4895; 49.0 ; 245.2 ; 25.7 ;5;50;68;0;5;1;4;1;4;2;1;2
4896; 42.6 ; 85.3 ; 9.1 ;2;101;89;0;2;0;2;0;2;0;2;0
4897; 52.5 ; 157.5 ; -   ;3;81;131;0;3;0;3;1;2;0;3;0
4898; 16.9 ; 33.7 ; -   ;2;86;30;0;2;2;0;2;0;2;0;0
4899; 33.2 ; 66.5 ; 20.2 ;2;2;269;0;2;1;1;2;0;1;1;0
4900; 59.5 ; 356.8 ; 14.5 ;6;22;1;0;6;0;6;4;2;0;0;6
4901; 43.9 ; 263.3 ; 17.1 ;6;24;15;0;6;0;6;6;0;2;2;2
4902; 41.7 ; 83.4 ; 7.6 ;2;12;288;0;2;0;2;2;0;0;2;0
4903; 23.3 ; 186.2 ; 4.4 ;8;26;20;0;8;2;6;6;2;8;0;0
4904; 29.6 ; 147.8 ; 9.7 ;5;15;143;0;5;3;2;3;2;3;2;0
4905; 61.4 ; 368.1 ; 52.4 ;6;25;257;0;6;0;6;4;2;2;0;4
4906; 27.6 ; 55.3 ; 3.8 ;2;16;171;0;2;2;0;0;2;1;1;0
4907; 46.8 ; 93.5 ; -   ;2;193;158;0;2;1;1;0;2;0;2;0
4908; 46.2 ; 2,217.5 ; 26.8 ;48;8;38;0;48;7;41;12;36;16;16;16
4909; 49.5 ; 297.0 ; 5.0 ;6;36;77;0;6;1;5;2;4;0;6;0
4910; 59.8 ; 299.2 ; 17.9 ;5;16;10;0;5;0;5;1;4;0;0;5
4911; 42.2 ; 210.8 ; 24.6 ;5;29;62;0;5;2;3;1;4;2;1;2
4912; 54.8 ; 273.9 ; 16.1 ;5;82;10;0;5;0;5;3;2;0;3;2
4913; 39.4 ; 433.7 ; 11.0 ;11;33;94;0;11;6;5;2;9;4;7;0
4914; 15.0 ; 59.9 ; -   ;4;34;165;0;4;1;3;3;1;4;0;0
4915; 31.2 ; 62.5 ; 24.3 ;2;14;68;0;2;0;2;0;2;1;0;1
4916; 37.0 ; 185.1 ; 20.1 ;5;22;57;0;5;0;5;2;3;2;1;2
4917; 26.2 ; 131.1 ; 11.2 ;5;58;136;0;5;2;3;1;4;3;2;0
4918; 53.7 ; 161.2 ; 18.6 ;3;54;10;0;3;0;3;2;1;0;2;1
4919; 64.3 ; 449.9 ; 58.1 ;7;9;233;0;7;4;3;1;6;2;0;5
4920; 55.7 ; 334.1 ; 5.5 ;6;45;40;0;6;0;6;0;6;0;0;6
4921; 47.9 ; 143.6 ; 6.4 ;3;101;57;0;3;0;3;3;0;0;3;0
4922; 29.4 ; 499.7 ; 12.1 ;17;19;62;7;10;4;13;12;5;11;6;0
4923; 46.3 ; 92.6 ; 24.5 ;2;16;236;0;2;1;1;1;1;1;0;1
4924; 39.8 ; 79.6 ; 1.9 ;2;4;152;0;2;1;1;0;2;0;2;0
4925; 42.2 ; 253.2 ; 31.7 ;6;45;67;0;6;4;2;2;4;2;2;2
4926; 35.4 ; 106.1 ; 16.8 ;3;29;12;0;3;2;1;1;2;1;2;0
4927; 38.4 ; 153.5 ; 4.4 ;4;44;83;0;4;1;3;2;2;0;4;0
4928; 27.7 ; 249.2 ; 13.7 ;9;37;28;0;9;2;7;6;3;6;3;0
4929; 48.2 ; 96.4 ; -   ;2;10;14;0;2;1;1;1;1;0;2;0
4930; 45.6 ; 228.1 ; 13.4 ;5;9;289;0;5;3;2;4;1;0;3;2
4931; 33.4 ; 66.8 ; 3.7 ;2;4;18;2;0;1;1;2;0;1;1;0
4932; 17.2 ; 34.4 ; 3.3 ;2;50;221;0;2;0;2;1;1;2;0;0
4933; 20.0 ; 40.1 ; 7.6 ;2;37;263;0;2;0;2;0;2;2;0;0
4934; 43.1 ; 86.2 ; 12.9 ;2;18;26;0;2;0;2;2;0;0;1;1
4935; 62.1 ; 248.4 ; 25.3 ;4;13;241;0;4;1;3;4;0;0;0;4
4936; 47.0 ; 329.3 ; 36.6 ;7;5;11;3;4;1;6;5;2;2;3;2
4937; 54.2 ; 162.7 ; 12.6 ;3;29;298;0;3;1;2;2;1;0;2;1
4938; 25.1 ; 75.2 ; -   ;3;20;227;0;3;2;1;1;2;3;0;0
4939; 49.6 ; 198.4 ; 27.0 ;4;46;65;4;0;3;1;4;0;1;2;1
4940; 46.8 ; 140.3 ; -   ;3;4;267;0;3;0;3;2;1;0;3;0
4941; 30.8 ; 462.4 ; 11.4 ;15;12;11;0;15;2;13;10;5;5;10;0
4942; 34.9 ; 104.7 ; 0.9 ;3;47;2;3;0;2;1;1;2;0;3;0
4943; 47.8 ; 143.5 ; 13.1 ;3;30;41;0;3;3;0;2;1;0;2;1
4944; 71.9 ; 575.0 ; 35.2 ;8;33;6;0;8;3;5;5;3;0;0;8
4945; 15.6 ; 281.7 ; 2.4 ;18;12;80;0;18;6;12;7;11;18;0;0
4946; 49.8 ; 99.6 ; 4.6 ;2;35;143;2;0;0;2;2;0;0;2;0
4947; 69.7 ; 627.0 ; 31.0 ;9;17;5;0;9;0;9;4;5;0;0;9
4948; 61.0 ; 304.9 ; 23.7 ;5;16;239;0;5;2;3;3;2;0;0;5
4949; 37.7 ; 113.0 ; 20.8 ;3;68;84;0;3;0;3;1;2;1;1;1
4950; 36.5 ; 73.0 ; 9.5 ;2;29;296;0;2;1;1;0;2;1;1;0
4951; 58.9 ; 117.9 ; 4.2 ;2;14;275;0;2;2;0;0;2;0;0;2
4952; 34.5 ; 1,895.7 ; 22.5 ;55;7;2;0;55;28;27;34;21;18;19;18
4953; 47.1 ; 235.3 ; 23.6 ;5;74;10;0;5;1;4;3;2;2;1;2
4954; 29.2 ; 175.2 ; 12.2 ;6;33;2;0;6;2;4;2;4;4;2;0
4955; 30.9 ; 61.7 ; 23.8 ;2;29;234;0;2;1;1;2;0;1;1;0
4956; 43.1 ; 129.4 ; 22.1 ;3;22;232;0;3;0;3;0;3;1;1;1
4957; 70.1 ; 140.3 ; 35.0 ;2;25;112;2;0;2;0;0;2;0;0;2
4958; 20.5 ; 122.9 ; 6.4 ;6;22;106;0;6;4;2;5;1;6;0;0
4959; 91.2 ; 182.5 ; 3.2 ;2;100;146;0;2;0;2;2;0;0;0;2
4960; 26.8 ; 160.9 ; 4.6 ;6;16;17;0;6;4;2;1;5;4;2;0
4961; 47.0 ; 188.1 ; 19.3 ;4;4;230;0;4;4;0;1;3;1;2;1
4962; 47.5 ; 94.9 ; -   ;2;24;77;2;0;2;0;2;0;0;2;0
4963; 27.9 ; 1,949.8 ; 16.1 ;70;5;57;0;70;34;36;33;37;47;23;0
4964; 17.3 ; 52.0 ; 2.5 ;3;78;2;3;0;3;0;3;0;3;0;0
4965; 73.9 ; 221.8 ; 17.8 ;3;56;194;0;3;0;3;3;0;0;0;3
4966; 37.0 ; 222.1 ; 16.1 ;6;17;28;0;6;3;3;3;3;2;4;0
4967; 26.2 ; 104.7 ; 15.3 ;4;2;42;0;4;0;4;2;2;3;1;0
4968; 42.6 ; 212.8 ; 16.3 ;5;12;347;0;5;1;4;4;1;2;1;2
4969; 22.3 ; 111.5 ; 10.9 ;5;34;149;0;5;4;1;4;1;3;2;0
4970; 36.6 ; 73.2 ; -   ;2;4;206;0;2;1;1;2;0;0;2;0
4971; 61.1 ; 122.2 ; 53.8 ;2;1;184;0;2;1;1;1;1;1;0;1
4972; 22.0 ; 88.0 ; 4.3 ;4;134;66;0;4;4;0;1;3;4;0;0
4973; 38.8 ; 77.7 ; 12.9 ;2;23;33;1;1;1;1;1;1;1;1;0
4974; 64.6 ; 581.7 ; 14.9 ;9;26;10;0;9;1;8;7;2;0;0;9
4975; 55.4 ; 388.1 ; 24.8 ;7;45;36;0;7;0;7;7;0;0;0;7
4976; 48.1 ; 192.5 ; 1.5 ;4;110;0;0;4;0;4;2;2;0;4;0
4977; 26.1 ; 52.3 ; -   ;2;9;275;0;2;2;0;2;0;2;0;0
4978; 33.3 ; 100.0 ; 21.9 ;3;37;29;0;3;3;0;3;0;1;1;1
4979; 53.1 ; 265.5 ; 46.8 ;5;51;131;0;5;0;5;5;0;2;1;2
4980; 47.5 ; 94.9 ; -   ;2;72;36;0;2;1;1;0;2;0;2;0
4981; 29.9 ; 89.6 ; 2.4 ;3;28;79;1;2;1;2;3;0;2;1;0
4982; 36.6 ; 73.2 ; -   ;2;41;232;0;2;1;1;1;1;0;2;0
4983; 28.6 ; 171.4 ; 7.7 ;6;30;23;0;6;0;6;3;3;4;2;0
4984; 25.1 ; 50.1 ; -   ;2;6;1;0;2;0;2;0;2;2;0;0
4985; 22.1 ; 66.3 ; 8.1 ;3;99;59;0;3;1;2;2;1;2;1;0
4986; 35.8 ; 179.0 ; 26.7 ;5;66;10;0;5;0;5;5;0;2;1;2
4987; 75.5 ; 151.0 ; 27.0 ;2;81;146;0;2;0;2;2;0;0;0;2
4988; 52.1 ; 468.5 ; 19.4 ;9;50;31;0;9;5;4;7;2;0;6;3
4989; 19.5 ; 253.7 ; 8.6 ;13;14;20;0;13;0;13;9;4;13;0;0
4990; 42.7 ; 85.4 ; 20.1 ;2;31;330;0;2;0;2;2;0;1;0;1
4991; 46.8 ; 93.5 ; -   ;2;1;266;0;2;1;1;2;0;0;2;0
4992; 18.3 ; 55.0 ; 6.2 ;3;16;119;0;3;1;2;3;0;3;0;0
4993; 49.2 ; 344.1 ; 14.8 ;7;26;22;0;7;4;3;4;3;0;5;2
4994; 55.8 ; 278.8 ; 23.2 ;5;50;17;0;5;1;4;3;2;0;0;5
4995; 50.9 ; 203.8 ; 22.8 ;4;50;141;0;4;1;3;4;0;1;2;1
4996; 54.7 ; 164.2 ; 60.5 ;3;31;152;0;3;1;2;1;2;1;1;1
4997; 40.6 ; 81.2 ; 9.2 ;2;220;92;0;2;2;0;0;2;0;2;0
4998; 32.6 ; 65.1 ; 11.2 ;2;72;197;0;2;1;1;1;1;1;1;0
4999; 48.1 ; 96.2 ; 0.9 ;2;246;41;0;2;2;0;2;0;0;2;0
5000; 38.2 ; 228.9 ; 18.2 ;6;38;93;0;6;3;3;4;2;2;2;2
5001; 48.1 ; 288.7 ; 12.4 ;6;47;5;0;6;0;6;5;1;0;4;2
5002; 46.8 ; 140.3 ; -   ;3;76;177;0;3;2;1;1;2;0;3;0
5003; 39.4 ; 78.9 ; 13.9 ;2;17;5;0;2;0;2;0;2;1;1;0
5004; 64.2 ; 192.7 ; 20.2 ;3;101;16;0;3;1;2;1;2;0;0;3
5005; 72.6 ; 145.2 ; 13.4 ;2;75;58;0;2;0;2;1;1;0;0;2
5006; 56.9 ; 739.2 ; 33.5 ;13;26;8;0;13;6;7;7;6;4;0;9
5007; 59.5 ; 238.1 ; 66.5 ;4;89;110;0;4;2;2;4;0;1;0;3
5008; 41.4 ; 82.7 ; 16.7 ;2;5;243;0;2;1;1;2;0;1;0;1
5009; 65.7 ; 131.3 ; 25.5 ;2;5;260;0;2;1;1;0;2;0;0;2
5010; 31.6 ; 63.2 ; 24.9 ;2;209;5;1;1;0;2;0;2;1;0;1
5011; 37.5 ; 150.0 ; 9.8 ;4;60;217;1;3;3;1;4;0;1;3;0
5012; 41.8 ; 83.6 ; 7.8 ;2;320;104;0;2;0;2;2;0;0;2;0
5013; 27.6 ; 138.1 ; 3.0 ;5;63;24;0;5;2;3;3;2;3;2;0
5014; 34.6 ; 725.6 ; 10.8 ;21;21;26;0;21;1;20;15;6;7;14;0
5015; 53.4 ; 160.3 ; 1.7 ;3;63;104;0;3;0;3;3;0;0;2;1
5016; 25.2 ; 126.0 ; 7.3 ;5;48;15;0;5;2;3;1;4;3;2;0
5017; 20.0 ; 40.1 ; 7.6 ;2;14;119;0;2;1;1;1;1;2;0;0
5018; 45.3 ; 588.5 ; 15.9 ;13;19;3;12;1;3;10;11;2;4;5;4
5019; 24.5 ; 637.1 ; 3.8 ;26;8;26;0;26;0;26;5;21;26;0;0
5020; 58.7 ; 762.7 ; 13.9 ;13;26;99;0;13;3;10;8;5;0;0;13
5021; 28.6 ; 57.2 ; 13.4 ;2;113;172;0;2;1;1;2;0;1;1;0
5022; 46.4 ; 139.2 ; 2.6 ;3;52;15;3;0;2;1;3;0;0;3;0
5023; 48.9 ; 342.1 ; 8.6 ;7;5;182;0;7;4;3;7;0;0;5;2
5024; 49.2 ; 147.7 ; 2.9 ;3;38;53;0;3;0;3;3;0;0;3;0
5025; 45.0 ; 89.9 ; 44.9 ;2;146;29;2;0;2;0;2;0;1;0;1
5026; 47.5 ; 142.4 ; 0.8 ;3;132;11;0;3;0;3;1;2;0;3;0
5027; 54.0 ; 216.0 ; 16.9 ;4;46;115;0;4;1;3;4;0;0;3;1
5028; 109.9 ; 219.8 ; 6.2 ;2;16;254;0;2;1;1;1;1;0;0;2
5029; 15.0 ; 30.0 ; -   ;2;75;58;0;2;0;2;2;0;2;0;0
5030; 43.3 ; 86.7 ; 6.2 ;2;96;32;0;2;1;1;2;0;0;2;0
5031; 72.4 ; 1,302.3 ; 30.6 ;18;14;31;0;18;4;14;13;5;0;0;18
5032; 41.2 ; 82.5 ; 16.9 ;2;101;99;0;2;0;2;1;1;1;0;1
5033; 41.8 ; 83.6 ; 8.5 ;2;5;23;0;2;1;1;1;1;0;2;0
5034; 47.7 ; 477.3 ; 69.9 ;10;20;5;0;10;5;5;6;4;3;4;3
5035; 49.2 ; 344.1 ; 2.6 ;7;24;5;0;7;2;5;1;6;0;7;0
5036; 46.5 ; 1,116.9 ; 4.2 ;24;16;11;11;13;4;20;21;3;0;24;0
5037; 30.0 ; 59.9 ; -   ;2;8;338;0;2;2;0;0;2;2;0;0
5038; 53.1 ; 212.6 ; 10.6 ;4;105;10;1;3;0;4;4;0;0;3;1
5039; 30.6 ; 91.8 ; 24.8 ;3;11;115;3;0;2;1;2;1;1;1;1
5040; 35.2 ; 175.8 ; 8.5 ;5;46;5;5;0;0;5;3;2;2;3;0
5041; 20.0 ; 40.1 ; 7.6 ;2;25;238;0;2;2;0;2;0;2;0;0
5042; 46.0 ; 229.8 ; 10.9 ;5;7;45;0;5;1;4;1;4;0;3;2
5043; 16.5 ; 66.1 ; 3.2 ;4;105;7;0;4;4;0;2;2;4;0;0
5044; 51.7 ; 1,602.6 ; 20.7 ;31;10;5;0;31;4;27;23;8;0;21;10
5045; 51.8 ; 103.6 ; 4.9 ;2;62;212;0;2;2;0;2;0;0;1;1
5046; 53.9 ; 161.7 ; 36.5 ;3;106;185;0;3;0;3;2;1;1;1;1
5047; 25.8 ; 51.6 ; 16.2 ;2;5;12;0;2;1;1;0;2;1;1;0
5048; 32.5 ; 390.4 ; 17.2 ;12;18;5;0;12;3;9;12;0;4;8;0
5049; 52.6 ; 105.2 ; 5.6 ;2;31;195;2;0;0;2;2;0;0;1;1
5050; 56.1 ; 224.5 ; -   ;4;19;282;0;4;1;3;2;2;0;0;4
5051; 51.1 ; 306.4 ; 16.1 ;6;68;4;0;6;1;5;3;3;0;4;2
5052; 66.9 ; 334.4 ; 56.3 ;5;33;60;0;5;3;2;3;2;2;0;3
5053; 34.0 ; 67.9 ; 13.3 ;2;13;257;0;2;0;2;0;2;1;1;0
5054; 26.2 ; 209.8 ; 1.7 ;8;16;32;8;0;3;5;2;6;8;0;0
5055; 66.9 ; 601.8 ; 34.7 ;9;44;27;0;9;2;7;5;4;0;0;9
5056; 52.6 ; 263.1 ; 14.7 ;5;16;166;0;5;2;3;2;3;0;3;2
5057; 63.3 ; 189.9 ; 29.0 ;3;15;51;0;3;3;0;1;2;0;0;3
5058; 40.2 ; 361.5 ; 17.2 ;9;29;57;0;9;2;7;5;4;3;3;3
5059; 35.6 ; 71.1 ; 30.8 ;2;101;164;0;2;1;1;1;1;1;0;1
5060; 28.1 ; 56.3 ; 4.6 ;2;16;260;0;2;1;1;2;0;1;1;0
5061; 26.9 ; 134.7 ; 4.4 ;5;50;3;2;3;3;2;3;2;3;2;0
5062; 27.9 ; 167.2 ; 16.8 ;6;24;93;1;5;3;3;6;0;4;2;0
5063; 44.2 ; 220.9 ; 13.6 ;5;77;10;0;5;0;5;3;2;0;3;2
5064; 33.9 ; 67.8 ; 4.1 ;2;182;110;0;2;1;1;0;2;1;1;0
5065; 39.7 ; 158.6 ; 26.7 ;4;34;190;0;4;1;3;1;3;1;2;1
5066; 26.5 ; 132.6 ; 9.5 ;5;4;326;0;5;2;3;1;4;3;2;0
5067; 41.3 ; 413.2 ; 15.8 ;10;43;10;0;10;5;5;7;3;3;4;3
5068; 31.0 ; 92.9 ; 1.9 ;3;60;69;0;3;1;2;1;2;1;2;0
5069; 43.7 ; 87.4 ; 20.6 ;2;102;140;0;2;1;1;0;2;1;0;1
5070; 48.5 ; 242.3 ; 10.0 ;5;82;18;0;5;4;1;1;4;0;3;2
5071; 16.9 ; 203.0 ; 5.1 ;12;12;20;0;12;7;5;9;3;12;0;0
5072; 46.8 ; 93.5 ; -   ;2;9;269;0;2;2;0;2;0;0;2;0
5073; 31.4 ; 596.3 ; 12.7 ;19;14;9;3;16;6;13;8;11;6;13;0
5074; 17.5 ; 105.3 ; 1.2 ;6;9;140;0;6;4;2;2;4;6;0;0
5075; 33.0 ; 66.1 ; 4.6 ;2;69;215;0;2;0;2;1;1;1;1;0
5076; 44.1 ; 132.4 ; 4.8 ;3;27;233;0;3;2;1;2;1;0;3;0
5077; 18.5 ; 55.4 ; 6.4 ;3;22;132;0;3;0;3;2;1;3;0;0
5078; 17.1 ; 34.3 ; 3.2 ;2;216;90;1;1;1;1;1;1;2;0;0
5079; 41.1 ; 164.5 ; 20.2 ;4;98;23;0;4;3;1;2;2;1;2;1
5080; 15.0 ; 74.9 ; -   ;5;54;11;0;5;4;1;5;0;5;0;0
5081; 43.8 ; 131.5 ; 6.7 ;3;90;2;0;3;1;2;3;0;0;3;0
5082; 52.7 ; 263.6 ; 8.5 ;5;41;53;4;1;0;5;5;0;0;3;2
5083; 15.0 ; 30.0 ; -   ;2;27;23;0;2;2;0;0;2;2;0;0
5084; 47.9 ; 239.7 ; 7.8 ;5;40;0;3;2;1;4;3;2;0;3;2
5085; 23.8 ; 95.0 ; 18.6 ;4;48;22;0;4;1;3;2;2;3;1;0
5086; 25.5 ; 51.0 ; 15.7 ;2;13;79;0;2;0;2;1;1;1;1;0
5087; 25.1 ; 50.1 ; -   ;2;30;68;0;2;1;1;2;0;2;0;0
5088; 21.7 ; 108.5 ; 5.5 ;5;10;328;0;5;2;3;0;5;5;0;0
5089; 57.3 ; 171.9 ; 13.7 ;3;11;131;0;3;2;1;1;2;0;0;3
5090; 71.5 ; 429.2 ; 3.5 ;6;22;20;0;6;2;4;3;3;0;0;6
5091; 52.0 ; 208.1 ; 5.2 ;4;38;11;0;4;1;3;2;2;0;3;1
5092; 36.5 ; 109.6 ; 27.5 ;3;54;93;1;2;1;2;3;0;1;1;1
5093; 20.7 ; 249.0 ; 8.0 ;12;38;19;0;12;6;6;4;8;12;0;0
5094; 39.9 ; 119.7 ; 32.9 ;3;41;97;0;3;3;0;1;2;1;1;1
5095; 43.2 ; 475.6 ; 16.6 ;11;2;242;0;11;6;5;5;6;4;3;4
5096; 30.2 ; 60.4 ; -   ;2;241;42;0;2;1;1;0;2;0;2;0
5097; 91.8 ; 183.5 ; 60.2 ;2;52;152;2;0;0;2;2;0;0;0;2
5098; 21.4 ; 214.5 ; 8.3 ;10;32;20;0;10;3;7;1;9;10;0;0
5099; 32.4 ; 453.3 ; 10.2 ;14;15;1;0;14;4;10;4;10;5;9;0
5100; 54.6 ; 764.2 ; 26.7 ;14;7;22;0;14;3;11;2;12;5;4;5
5101; 31.3 ; 93.9 ; 17.9 ;3;36;123;0;3;1;2;0;3;1;2;0
5102; 61.4 ; 245.8 ; 30.6 ;4;43;216;0;4;1;3;2;2;0;0;4
5103; 30.9 ; 154.7 ; 14.4 ;5;44;74;0;5;4;1;3;2;2;3;0
5104; 35.9 ; 143.7 ; 13.3 ;4;14;227;0;4;4;0;4;0;1;3;0
5105; 44.0 ; 132.0 ; 8.8 ;3;50;5;0;3;0;3;1;2;0;3;0
5106; 24.0 ; 71.9 ; 9.6 ;3;164;104;0;3;1;2;1;2;2;1;0
5107; 24.8 ; 173.7 ; 8.3 ;7;32;80;0;7;2;5;4;3;5;2;0
5108; 28.0 ; 56.0 ; 19.5 ;2;57;99;0;2;0;2;2;0;1;1;0
5109; 40.8 ; 81.6 ; 16.1 ;2;57;52;0;2;0;2;2;0;1;0;1
5110; 15.0 ; 45.0 ; -   ;3;54;115;0;3;0;3;2;1;3;0;0
5111; 58.9 ; 176.8 ; 17.4 ;3;29;231;0;3;1;2;2;1;0;0;3
5112; 23.3 ; 443.5 ; 4.4 ;19;14;52;0;19;10;9;12;7;19;0;0
5113; 44.9 ; 89.9 ; -   ;2;20;179;0;2;1;1;2;0;0;2;0
5114; 52.9 ; 634.8 ; 0.5 ;12;23;20;0;12;1;11;8;4;0;12;0
5115; 58.2 ; 174.7 ; 9.2 ;3;122;17;0;3;0;3;0;3;0;0;3
5116; 24.3 ; 121.6 ; 10.0 ;5;75;27;0;5;1;4;5;0;3;2;0
5117; 48.4 ; 532.7 ; 8.6 ;11;34;26;0;11;3;8;6;5;0;7;4
5118; 42.7 ; 1,152.1 ; 23.9 ;27;15;1;0;27;3;24;11;16;9;9;9
5119; 29.3 ; 58.6 ; 7.8 ;2;26;83;0;2;0;2;2;0;1;1;0
5120; 17.5 ; 228.1 ; 4.8 ;13;27;14;0;13;5;8;6;7;13;0;0
5121; 39.9 ; 79.7 ; 4.6 ;2;7;303;0;2;1;1;1;1;0;2;0
5122; 44.3 ; 221.3 ; 16.8 ;5;43;11;0;5;1;4;5;0;2;1;2
5123; 30.2 ; 90.6 ; -   ;3;13;193;3;0;3;0;3;0;0;3;0
5124; 15.0 ; 30.0 ; -   ;2;50;11;2;0;0;2;1;1;2;0;0
5125; 49.6 ; 99.3 ; -   ;2;5;95;0;2;0;2;2;0;0;2;0
5126; 53.6 ; 803.5 ; 18.8 ;15;28;21;0;15;1;14;4;11;0;10;5
5127; 21.0 ; 105.2 ; 2.9 ;5;16;8;0;5;4;1;1;4;5;0;0
5128; 58.1 ; 232.3 ; 4.4 ;4;60;55;0;4;1;3;3;1;0;0;4
5129; 50.0 ; 100.0 ; 4.9 ;2;321;62;0;2;0;2;2;0;0;2;0
5130; 51.7 ; 103.4 ; -   ;2;59;28;0;2;2;0;0;2;0;2;0
5131; 34.7 ; 173.5 ; 17.2 ;5;60;17;0;5;0;5;1;4;2;3;0
5132; 51.8 ; 155.3 ; 3.8 ;3;34;210;0;3;0;3;3;0;0;2;1
5133; 32.5 ; 227.3 ; 17.6 ;7;11;214;0;7;3;4;2;5;2;5;0
5134; 46.5 ; 232.3 ; 6.5 ;5;37;10;0;5;0;5;5;0;0;5;0
5135; 31.1 ; 186.9 ; 14.0 ;6;50;11;1;5;1;5;6;0;2;4;0
5136; 20.0 ; 40.1 ; 7.6 ;2;290;64;0;2;0;2;1;1;2;0;0
5137; 56.6 ; 113.2 ; 25.7 ;2;8;276;0;2;1;1;1;1;0;0;2
5138; 47.5 ; 94.9 ; 0.5 ;2;71;78;0;2;0;2;0;2;0;2;0
5139; 41.0 ; 532.6 ; 26.6 ;13;22;117;0;13;9;4;6;7;4;5;4
5140; 24.2 ; 48.4 ; 10.5 ;2;64;124;1;1;1;1;0;2;1;1;0
5141; 65.7 ; 394.3 ; 19.7 ;6;45;138;0;6;2;4;2;4;0;0;6
5142; 35.6 ; 71.1 ; 8.0 ;2;214;104;0;2;0;2;1;1;1;1;0
5143; 26.5 ; 52.9 ; 5.2 ;2;78;160;0;2;1;1;1;1;1;1;0
5144; 90.3 ; 271.0 ; 37.3 ;3;79;91;0;3;2;1;3;0;0;0;3
5145; 18.4 ; 202.5 ; 9.5 ;11;18;140;0;11;8;3;3;8;11;0;0
5146; 21.1 ; 84.4 ; 7.5 ;4;77;74;0;4;2;2;4;0;4;0;0
5147; 45.8 ; 137.4 ; 5.3 ;3;140;15;0;3;1;2;1;2;0;3;0
5148; 28.1 ; 56.3 ; 4.6 ;2;18;236;0;2;0;2;2;0;1;1;0
5149; 35.5 ; 1,134.5 ; 24.9 ;32;9;13;0;32;17;15;29;3;11;10;11
5150; 60.4 ; 543.8 ; 15.9 ;9;17;2;0;9;3;6;1;8;0;0;9
5151; 25.8 ; 103.2 ; 13.2 ;4;54;16;0;4;1;3;1;3;3;1;0
5152; 16.4 ; 65.8 ; 1.8 ;4;32;110;0;4;1;3;4;0;4;0;0
5153; 49.8 ; 348.6 ; 21.8 ;7;37;168;0;7;2;5;3;4;2;3;2
5154; 23.9 ; 95.4 ; 11.3 ;4;10;62;0;4;2;2;3;1;3;1;0
5155; 47.5 ; 142.4 ; -   ;3;36;40;0;3;1;2;3;0;0;3;0
5156; 72.5 ; 217.5 ; 25.6 ;3;16;236;0;3;0;3;3;0;0;0;3
5157; 32.9 ; 65.7 ; 13.9 ;2;12;189;0;2;0;2;2;0;1;1;0
5158; 19.7 ; 39.5 ; -   ;2;5;51;0;2;2;0;0;2;2;0;0
5159; 40.8 ; 285.9 ; 12.8 ;7;27;110;0;7;1;6;6;1;2;5;0
5160; 84.1 ; 168.3 ; 30.6 ;2;69;152;0;2;0;2;1;1;0;0;2
5161; 20.6 ; 473.5 ; 11.9 ;23;14;11;7;16;10;13;10;13;15;8;0
5162; 35.1 ; 105.3 ; 18.5 ;3;104;94;0;3;1;2;2;1;1;2;0
5163; 38.5 ; 76.9 ; 12.4 ;2;221;153;0;2;0;2;1;1;1;1;0
5164; 32.2 ; 160.9 ; 19.2 ;5;17;61;0;5;4;1;2;3;2;3;0
5165; 42.1 ; 589.2 ; 4.4 ;14;14;5;0;14;7;7;7;7;0;14;0
5166; 83.1 ; 498.8 ; 34.3 ;6;46;89;0;6;0;6;6;0;0;0;6
5167; 34.2 ; 102.5 ; 35.2 ;3;106;101;0;3;1;2;1;2;1;1;1
5168; 48.5 ; 388.0 ; 15.1 ;8;39;3;0;8;6;2;6;2;0;5;3
5169; 36.8 ; 110.3 ; 10.9 ;3;32;152;0;3;1;2;3;0;1;2;0
5170; 36.6 ; 183.0 ; 34.4 ;5;39;5;0;5;0;5;4;1;2;1;2
5171; 36.5 ; 292.3 ; 16.4 ;8;31;34;0;8;5;3;2;6;3;5;0
5172; 22.4 ; 67.3 ; 7.6 ;3;17;2;0;3;3;0;0;3;2;1;0
5173; 43.4 ; 216.8 ; 3.3 ;5;41;11;0;5;1;4;2;3;0;5;0
5174; 18.2 ; 418.4 ; 2.1 ;23;12;8;0;23;18;5;23;0;23;0;0
5175; 18.2 ; 36.4 ; -   ;2;19;0;2;0;0;2;2;0;2;0;0
5176; 73.8 ; 442.6 ; 20.7 ;6;42;20;0;6;0;6;4;2;0;0;6
5177; 40.2 ; 160.7 ; 19.0 ;4;52;205;0;4;1;3;2;2;1;2;1
5178; 28.3 ; 113.3 ; 11.0 ;4;83;42;0;4;2;2;1;3;3;1;0
5179; 35.1 ; 70.2 ; 7.4 ;2;97;170;0;2;1;1;0;2;1;1;0
5180; 30.2 ; 60.4 ; -   ;2;136;104;1;1;1;1;1;1;0;2;0
5181; 41.6 ; 83.3 ; 24.8 ;2;36;74;0;2;0;2;1;1;1;0;1
5182; 37.4 ; 74.9 ; 16.9 ;2;54;5;0;2;1;1;1;1;1;1;0
5183; 36.1 ; 108.4 ; 11.5 ;3;7;92;0;3;1;2;1;2;1;2;0
5184; 126.0 ; 252.1 ; 118.7 ;2;5;142;0;2;0;2;1;1;1;0;1
5185; 50.3 ; 302.1 ; 23.0 ;6;51;5;0;6;4;2;1;5;2;2;2
5186; 26.9 ; 215.2 ; 6.2 ;8;14;2;0;8;1;7;5;3;5;3;0
5187; 28.8 ; 144.0 ; 9.7 ;5;22;22;0;5;1;4;1;4;3;2;0
5188; 62.1 ; 372.8 ; 53.2 ;6;55;55;0;6;2;4;6;0;2;0;4
5189; 23.3 ; 70.0 ; 11.0 ;3;113;113;0;3;2;1;0;3;2;1;0
5190; 84.0 ; 420.1 ; 30.5 ;5;32;173;0;5;2;3;3;2;0;0;5
5191; 65.7 ; 131.4 ; 25.5 ;2;1;58;0;2;1;1;1;1;0;0;2
5192; 28.0 ; 224.1 ; 1.9 ;8;38;14;8;0;7;1;6;2;8;0;0
5193; 25.5 ; 127.6 ; 8.0 ;5;13;193;0;5;3;2;0;5;3;2;0
5194; 30.0 ; 59.9 ; -   ;2;13;78;0;2;0;2;0;2;2;0;0
5195; 36.9 ; 110.6 ; 18.1 ;3;14;160;0;3;1;2;1;2;1;2;0
5196; 33.8 ; 169.1 ; 14.5 ;5;67;128;0;5;4;1;2;3;2;3;0
5197; 34.0 ; 748.7 ; 8.5 ;22;23;8;0;22;11;11;6;16;7;15;0
5198; 49.0 ; 245.1 ; 18.4 ;5;25;188;0;5;0;5;5;0;0;3;2
5199; 41.7 ; 83.4 ; 7.6 ;2;300;38;0;2;1;1;1;1;0;2;0
5200; 42.7 ; 213.4 ; 5.9 ;5;41;14;0;5;2;3;2;3;0;5;0
5201; 59.2 ; 236.6 ; 4.7 ;4;21;73;0;4;1;3;2;2;0;0;4
5202; 15.0 ; 30.0 ; -   ;2;2;236;0;2;1;1;1;1;2;0;0
5203; 24.9 ; 174.2 ; 19.8 ;7;61;2;0;7;4;3;1;6;5;2;0
5204; 41.1 ; 82.3 ; -   ;2;38;37;0;2;0;2;2;0;0;2;0
5205; 29.9 ; 299.1 ; 15.9 ;10;26;50;0;10;1;9;3;7;7;3;0
5206; 42.4 ; 127.3 ; 10.4 ;3;11;103;0;3;2;1;0;3;0;3;0
5207; 33.8 ; 67.5 ; 28.1 ;2;25;141;0;2;0;2;1;1;1;0;1
5208; 15.0 ; 74.9 ; -   ;5;14;318;0;5;4;1;1;4;5;0;0
5209; 27.4 ; 137.1 ; 18.9 ;5;29;75;0;5;3;2;4;1;3;2;0
5210; 50.2 ; 100.4 ; 2.3 ;2;402;26;0;2;0;2;1;1;0;2;0
5211; 51.9 ; 207.4 ; 12.9 ;4;38;22;0;4;0;4;4;0;0;3;1
5212; 48.9 ; 97.8 ; 9.1 ;2;139;142;0;2;0;2;1;1;0;1;1
5213; 20.8 ; 228.7 ; 5.9 ;11;20;5;0;11;3;8;2;9;11;0;0
5214; 32.6 ; 163.0 ; 10.8 ;5;26;117;0;5;0;5;3;2;2;3;0
5215; 15.0 ; 30.0 ; -   ;2;176;116;0;2;0;2;2;0;2;0;0
5216; 37.2 ; 111.5 ; 20.3 ;3;64;113;0;3;2;1;2;1;1;1;1
5217; 86.0 ; 172.1 ; 58.8 ;2;149;236;0;2;0;2;1;1;1;0;1
5218; 15.0 ; 30.0 ; -   ;2;1;89;0;2;0;2;2;0;2;0;0
5219; 31.1 ; 186.8 ; 22.7 ;6;15;109;0;6;5;1;2;4;2;4;0
5220; 44.8 ; 89.6 ; 2.9 ;2;14;284;0;2;1;1;1;1;0;2;0
5221; 17.5 ; 70.0 ; 5.3 ;4;67;94;0;4;2;2;1;3;4;0;0
5222; 21.8 ; 43.7 ; -   ;2;20;144;0;2;2;0;2;0;2;0;0
5223; 29.7 ; 148.4 ; 6.7 ;5;9;99;0;5;1;4;2;3;3;2;0
5224; 43.4 ; 130.1 ; 6.2 ;3;60;192;0;3;2;1;2;1;0;3;0
5225; 25.3 ; 126.4 ; 24.4 ;5;5;4;1;4;5;0;2;3;3;2;0
5226; 15.0 ; 30.0 ; -   ;2;1;343;0;2;2;0;0;2;2;0;0
5227; 40.4 ; 202.1 ; 14.4 ;5;23;36;0;5;0;5;5;0;2;3;0
5228; 24.4 ; 584.9 ; 10.5 ;24;18;5;0;24;6;18;21;3;16;8;0
5229; 75.1 ; 300.4 ; 14.0 ;4;77;29;0;4;2;2;1;3;0;0;4
5230; 50.0 ; 100.0 ; 4.9 ;2;371;30;0;2;2;0;2;0;0;2;0
5231; 38.5 ; 886.2 ; 21.4 ;23;16;9;0;23;10;13;16;7;8;7;8
5232; 20.2 ; 40.4 ; 0.8 ;2;5;272;0;2;0;2;2;0;2;0;0
5233; 85.9 ; 257.7 ; 47.6 ;3;78;147;0;3;0;3;2;1;0;0;3
5234; 60.5 ; 726.5 ; 19.6 ;12;27;11;0;12;3;9;8;4;0;0;12
5235; 24.4 ; 268.3 ; 8.2 ;11;23;43;0;11;7;4;9;2;7;4;0
5236; 15.0 ; 74.9 ; -   ;5;11;115;0;5;3;2;3;2;5;0;0
5237; 31.3 ; 156.6 ; 24.3 ;5;40;2;0;5;4;1;5;0;2;1;2
5238; 34.9 ; 802.3 ; 16.1 ;23;15;20;0;23;10;13;14;9;8;15;0
5239; 17.7 ; 35.4 ; 4.1 ;2;27;277;0;2;1;1;0;2;2;0;0
5240; 66.0 ; 329.8 ; 23.6 ;5;28;16;0;5;1;4;3;2;0;0;5
5241; 25.9 ; 155.3 ; 5.3 ;6;63;78;0;6;1;5;2;4;4;2;0
5242; 47.8 ; 191.3 ; 7.2 ;4;84;52;0;4;0;4;1;3;0;4;0
5243; 59.1 ; 236.3 ; 7.7 ;4;35;8;0;4;2;2;2;2;0;0;4
5244; 14.9 ; 59.6 ; 0.2 ;4;12;185;0;4;2;2;3;1;4;0;0
5245; 17.8 ; 35.6 ; -   ;2;12;200;0;2;0;2;0;2;2;0;0
5246; 24.3 ; 121.7 ; 8.9 ;5;27;87;0;5;4;1;4;1;3;2;0
5247; 30.9 ; 61.7 ; 23.8 ;2;93;125;0;2;2;0;0;2;1;1;0
5248; 55.7 ; 167.2 ; 16.5 ;3;18;335;0;3;1;2;3;0;0;0;3
5249; 37.6 ; 112.8 ; 17.4 ;3;117;101;0;3;3;0;1;2;1;1;1
5250; 35.4 ; 176.8 ; 14.5 ;5;65;74;0;5;3;2;4;1;2;3;0
5251; 36.8 ; 515.4 ; 17.7 ;14;16;5;0;14;2;12;10;4;5;9;0
5252; 61.0 ; 183.0 ; 33.0 ;3;84;140;0;3;2;1;1;2;1;0;2
5253; 20.0 ; 40.1 ; 7.6 ;2;198;117;0;2;1;1;2;0;2;0;0
5254; 48.2 ; 240.8 ; 18.7 ;5;14;66;2;3;2;3;2;3;2;1;2
5255; 20.7 ; 372.7 ; 7.4 ;18;15;23;0;18;7;11;10;8;18;0;0
5256; 27.6 ; 82.8 ; 17.8 ;3;10;231;0;3;2;1;1;2;2;1;0
5257; 50.0 ; 1,149.1 ; 15.2 ;23;13;121;0;23;4;19;9;14;0;15;8
5258; 23.4 ; 70.2 ; 8.2 ;3;12;308;0;3;3;0;3;0;2;1;0
5259; 39.1 ; 117.4 ; 11.9 ;3;86;247;0;3;0;3;1;2;1;2;0
5260; 30.2 ; 60.4 ; -   ;2;1;218;0;2;2;0;0;2;0;2;0
5261; 22.8 ; 159.9 ; 7.3 ;7;17;14;0;7;5;2;7;0;5;2;0
5262; 29.8 ; 59.5 ; 0.6 ;2;91;115;0;2;1;1;2;0;1;1;0
5263; 40.1 ; 280.9 ; 21.4 ;7;36;60;0;7;5;2;2;5;2;3;2
5264; 37.9 ; 340.7 ; 19.4 ;9;27;105;0;9;5;4;4;5;3;3;3
5265; 43.6 ; 218.0 ; 8.9 ;5;42;83;0;5;1;4;4;1;0;5;0
5266; 25.2 ; 226.4 ; 9.5 ;9;18;26;0;9;2;7;6;3;6;3;0
5267; 16.9 ; 135.6 ; 3.9 ;8;11;47;0;8;3;5;3;5;8;0;0
5268; 35.7 ; 107.1 ; 10.1 ;3;34;152;0;3;1;2;2;1;1;2;0
5269; 31.3 ; 375.8 ; 11.1 ;12;22;129;0;12;8;4;8;4;4;8;0
5270; 27.3 ; 163.6 ; 10.5 ;6;59;2;0;6;2;4;2;4;4;2;0
5271; 30.6 ; 91.7 ; 10.1 ;3;82;126;0;3;0;3;3;0;1;2;0
5272; 45.2 ; 90.5 ; 28.6 ;2;276;73;0;2;0;2;2;0;1;0;1
5273; 23.9 ; 334.5 ; 14.0 ;14;23;10;0;14;2;12;1;13;9;5;0
5274; 46.8 ; 140.3 ; -   ;3;11;268;0;3;1;2;1;2;0;3;0
5275; 36.3 ; 108.9 ; 3.4 ;3;120;31;0;3;0;3;3;0;0;3;0
5276; 20.1 ; 360.9 ; 6.2 ;18;6;164;0;18;3;15;11;7;18;0;0
5277; 41.2 ; 82.4 ; 16.9 ;2;317;134;0;2;1;1;0;2;1;0;1
5278; 22.5 ; 44.9 ; 11.2 ;2;337;2;1;1;2;0;0;2;1;1;0
5279; 47.2 ; 236.1 ; 7.1 ;5;70;13;0;5;2;3;1;4;0;5;0
5280; 30.2 ; 150.9 ; -   ;5;9;58;0;5;1;4;1;4;0;5;0
5281; 46.8 ; 233.8 ; -   ;5;57;110;0;5;0;5;2;3;0;5;0
5282; 25.5 ; 51.1 ; 6.6 ;2;114;16;0;2;0;2;1;1;1;1;0
5283; 34.7 ; 69.3 ; 18.1 ;2;50;267;0;2;0;2;2;0;1;1;0
5284; 39.2 ; 783.5 ; 23.6 ;20;13;5;0;20;3;17;14;6;7;6;7
5285; 64.2 ; 192.7 ; 30.7 ;3;121;65;0;3;2;1;2;1;0;0;3
5286; 41.3 ; 412.9 ; 29.3 ;10;7;13;0;10;9;1;1;9;3;4;3
5287; 25.2 ; 50.4 ; 15.3 ;2;156;120;0;2;1;1;0;2;1;1;0
5288; 32.8 ; 163.9 ; 7.5 ;5;29;59;0;5;4;1;1;4;2;3;0
5289; 18.0 ; 36.1 ; 4.6 ;2;126;169;0;2;1;1;2;0;2;0;0
5290; 57.1 ; 114.2 ; 5.8 ;2;11;84;0;2;0;2;1;1;0;0;2
5291; 38.5 ; 76.9 ; 12.4 ;2;28;131;0;2;1;1;2;0;1;1;0
5292; 39.2 ; 78.4 ; 13.5 ;2;92;16;0;2;1;1;2;0;1;1;0
5293; 47.2 ; 141.7 ; 10.2 ;3;113;26;0;3;0;3;2;1;0;2;1
5294; 37.5 ; 112.4 ; 20.6 ;3;40;7;0;3;2;1;1;2;1;1;1
5295; 15.0 ; 59.9 ; -   ;4;26;48;0;4;2;2;2;2;4;0;0
5296; 45.7 ; 137.1 ; 2.6 ;3;87;65;0;3;1;2;1;2;0;3;0
5297; 32.3 ; 354.8 ; 13.0 ;11;29;16;0;11;4;7;5;6;4;7;0
5298; 60.7 ; 303.7 ; 11.1 ;5;5;247;0;5;4;1;2;3;0;0;5
5299; 72.2 ; 288.9 ; 26.7 ;4;41;99;0;4;0;4;3;1;0;0;4
5300; 28.5 ; 85.4 ; 3.1 ;3;40;68;0;3;2;1;1;2;2;1;0
5301; 36.3 ; 72.5 ; 16.8 ;2;4;92;2;0;1;1;0;2;1;1;0
5302; 32.5 ; 715.5 ; 6.7 ;22;16;2;0;22;7;15;20;2;7;15;0
5303; 52.3 ; 104.6 ; 0.9 ;2;40;93;0;2;1;1;1;1;0;2;0
5304; 38.4 ; 76.7 ; 14.7 ;2;111;11;0;2;1;1;1;1;1;1;0
5305; 45.3 ; 226.4 ; 17.5 ;5;59;16;0;5;4;1;2;3;2;1;2
5306; 20.2 ; 465.1 ; 9.2 ;23;18;4;0;23;8;15;13;10;23;0;0
5307; 15.0 ; 30.0 ; -   ;2;3;1;0;2;1;1;2;0;2;0;0
5308; 39.4 ; 78.9 ; 13.9 ;2;206;125;0;2;1;1;1;1;1;1;0
5309; 28.7 ; 86.2 ; 16.5 ;3;90;147;0;3;1;2;3;0;2;1;0
5310; 45.2 ; 225.8 ; 3.5 ;5;41;89;0;5;0;5;5;0;0;5;0
5311; 25.6 ; 230.2 ; 10.7 ;9;23;93;0;9;1;8;5;4;6;3;0
5312; 31.2 ; 187.2 ; 14.6 ;6;16;5;0;6;4;2;1;5;2;4;0
5313; 16.1 ; 64.4 ; 2.4 ;4;74;85;0;4;1;3;1;3;4;0;0
5314; 52.8 ; 264.1 ; 25.0 ;5;41;252;0;5;1;4;2;3;2;1;2
5315; 39.7 ; 79.5 ; 4.7 ;2;11;101;0;2;0;2;0;2;0;2;0
5316; 38.8 ; 77.7 ; 12.9 ;2;139;99;1;1;0;2;0;2;1;1;0
5317; 37.7 ; 113.1 ; 13.9 ;3;7;188;1;2;2;1;1;2;1;2;0
5318; 32.9 ; 296.1 ; 37.2 ;9;33;6;0;9;4;5;9;0;3;3;3
5319; 20.0 ; 40.1 ; 7.6 ;2;7;170;0;2;2;0;2;0;2;0;0
5320; 27.3 ; 54.7 ; 10.9 ;2;162;71;0;2;1;1;2;0;1;1;0
5321; 61.1 ; 244.3 ; 11.7 ;4;35;2;0;4;2;2;2;2;0;0;4
5322; 18.0 ; 53.9 ; 2.7 ;3;4;153;0;3;1;2;1;2;3;0;0
5323; 17.6 ; 194.0 ; 6.2 ;11;21;15;11;0;4;7;4;7;11;0;0
5324; 47.5 ; 94.9 ; -   ;2;63;47;0;2;0;2;0;2;0;2;0
5325; 50.4 ; 100.9 ; 1.7 ;2;81;5;0;2;0;2;2;0;0;2;0
5326; 38.8 ; 1,474.2 ; 15.9 ;38;5;120;0;38;19;19;7;31;13;25;0
5327; 53.9 ; 323.2 ; 16.4 ;6;38;5;0;6;0;6;6;0;0;4;2
5328; 78.4 ; 156.9 ; 25.3 ;2;76;183;0;2;0;2;1;1;0;0;2
5329; 47.5 ; 94.9 ; 1.1 ;2;188;0;1;1;0;2;2;0;0;2;0
5330; 61.2 ; 183.5 ; 13.0 ;3;101;5;0;3;1;2;3;0;0;0;3
5331; 42.0 ; 209.9 ; 14.4 ;5;43;19;0;5;3;2;3;2;2;1;2
5332; 39.6 ; 198.2 ; 31.6 ;5;88;23;0;5;3;2;2;3;2;1;2
5333; 49.2 ; 98.5 ; 3.7 ;2;237;31;0;2;1;1;0;2;0;2;0
5334; 41.4 ; 82.7 ; 16.7 ;2;223;160;0;2;1;1;1;1;1;0;1
5335; 20.0 ; 99.9 ; 2.8 ;5;28;177;0;5;2;3;2;3;5;0;0
5336; 47.0 ; 235.2 ; 0.7 ;5;59;21;0;5;1;4;4;1;0;5;0
5337; 30.9 ; 61.7 ; 23.8 ;2;5;245;0;2;2;0;2;0;1;1;0
5338; 23.8 ; 547.4 ; 9.4 ;23;14;4;0;23;11;12;19;4;15;8;0
5339; 52.4 ; 157.2 ; 5.5 ;3;91;41;0;3;1;2;3;0;0;2;1
5340; 47.1 ; 94.2 ; 0.5 ;2;284;41;1;1;0;2;0;2;0;2;0
5341; 46.5 ; 232.6 ; 22.6 ;5;30;57;0;5;1;4;4;1;2;1;2
5342; 47.0 ; 658.5 ; 0.4 ;14;22;26;0;14;0;14;13;1;0;14;0
5343; 53.8 ; 376.5 ; 14.6 ;7;39;7;0;7;1;6;3;4;0;5;2
5344; 43.5 ; 478.9 ; 32.6 ;11;12;47;11;0;8;3;3;8;4;3;4
5345; 60.1 ; 540.7 ; 25.8 ;9;26;36;0;9;0;9;7;2;0;0;9
5346; 47.8 ; 95.7 ; 0.5 ;2;86;5;0;2;1;1;1;1;0;2;0
5347; 69.6 ; 139.2 ; 27.8 ;2;290;110;0;2;0;2;1;1;0;0;2
5348; 47.7 ; 286.2 ; 8.4 ;6;43;63;0;6;1;5;2;4;0;4;2
5349; 41.7 ; 83.4 ; 7.6 ;2;24;310;0;2;0;2;1;1;0;2;0
5350; 45.1 ; 135.2 ; 13.7 ;3;50;146;0;3;0;3;2;1;0;2;1
5351; 47.2 ; 141.7 ; 0.4 ;3;30;56;0;3;2;1;1;2;0;3;0
5352; 15.0 ; 30.0 ; -   ;2;113;80;0;2;2;0;1;1;2;0;0
5353; 15.0 ; 149.9 ; -   ;10;31;15;0;10;1;9;7;3;10;0;0
5354; 24.0 ; 119.9 ; 14.2 ;5;14;165;0;5;5;0;4;1;3;2;0
5355; 43.8 ; 87.7 ; 20.4 ;2;157;62;0;2;0;2;1;1;1;0;1
5356; 34.0 ; 67.9 ; 13.3 ;2;95;115;0;2;0;2;2;0;1;1;0
5357; 24.4 ; 219.2 ; 13.0 ;9;34;35;0;9;2;7;5;4;6;3;0
5358; 23.6 ; 636.6 ; 17.5 ;27;9;7;0;27;19;8;6;21;18;9;0
5359; 62.0 ; 247.9 ; 26.3 ;4;19;173;0;4;0;4;2;2;0;0;4
5360; 19.0 ; 114.0 ; 4.7 ;6;43;47;0;6;3;3;4;2;6;0;0
5361; 21.5 ; 43.1 ; 5.3 ;2;277;40;0;2;2;0;0;2;2;0;0
5362; 56.2 ; 280.8 ; 7.7 ;5;9;232;0;5;3;2;2;3;0;0;5
5363; 60.3 ; 120.6 ; 35.5 ;2;25;131;0;2;0;2;1;1;1;0;1
5364; 15.0 ; 30.0 ; -   ;2;14;167;0;2;0;2;2;0;2;0;0
5365; 26.7 ; 80.0 ; 11.3 ;3;122;2;0;3;3;0;1;2;2;1;0
5366; 62.5 ; 187.4 ; 34.7 ;3;145;44;0;3;2;1;2;1;1;0;2
5367; 52.9 ; 423.2 ; 18.8 ;8;23;127;0;8;4;4;2;6;0;5;3
5368; 27.6 ; 55.3 ; 3.8 ;2;106;43;0;2;0;2;1;1;1;1;0
5369; 52.9 ; 211.7 ; 40.1 ;4;116;64;0;4;2;2;2;2;1;2;1
5370; 62.6 ; 1,189.3 ; 12.5 ;19;16;79;0;19;6;13;9;10;0;0;19
5371; 37.4 ; 112.1 ; 1.8 ;3;47;157;0;3;1;2;2;1;0;3;0
5372; 42.3 ; 169.2 ; 13.6 ;4;140;20;0;4;1;3;2;2;1;2;1
5373; 48.8 ; 146.4 ; 22.4 ;3;25;209;0;3;1;2;1;2;1;1;1
5374; 38.8 ; 77.6 ; 20.5 ;2;91;184;0;2;1;1;0;2;1;0;1
5375; 61.0 ; 183.1 ; 29.8 ;3;112;110;1;2;1;2;1;2;0;0;3
5376; 15.4 ; 338.8 ; 2.2 ;22;5;0;0;22;3;19;7;15;22;0;0
5377; 15.0 ; 74.9 ; -   ;5;7;370;0;5;2;3;1;4;5;0;0
5378; 36.7 ; 73.5 ; 4.5 ;2;6;167;2;0;0;2;2;0;0;2;0
5379; 54.9 ; 109.8 ; 27.4 ;2;18;110;0;2;0;2;2;0;1;0;1
5380; 17.0 ; 85.0 ; 4.8 ;5;18;221;0;5;4;1;1;4;5;0;0
5381; 72.6 ; 217.9 ; 29.7 ;3;11;265;0;3;2;1;0;3;0;0;3
5382; 30.8 ; 61.7 ; 8.6 ;2;10;221;0;2;1;1;1;1;1;1;0
5383; 46.5 ; 232.4 ; 10.5 ;5;14;101;0;5;1;4;1;4;0;3;2
5384; 42.9 ; 85.7 ; -   ;2;127;105;0;2;0;2;0;2;0;2;0
5385; 40.3 ; 322.2 ; 9.5 ;8;23;167;0;8;2;6;3;5;0;8;0
5386; 31.2 ; 62.5 ; 18.9 ;2;240;14;2;0;1;1;0;2;1;1;0
5387; 40.7 ; 447.3 ; 34.2 ;11;20;38;0;11;5;6;5;6;4;3;4
5388; 15.7 ; 219.2 ; 2.8 ;14;17;146;0;14;7;7;4;10;14;0;0
5389; 22.0 ; 44.0 ; 10.5 ;2;37;234;0;2;2;0;0;2;1;1;0
5390; 25.1 ; 50.1 ; -   ;2;17;247;0;2;0;2;0;2;2;0;0
5391; 35.3 ; 424.1 ; 18.2 ;12;23;0;0;12;3;9;7;5;4;8;0
5392; 36.2 ; 181.0 ; 9.5 ;5;58;38;0;5;2;3;2;3;2;3;0
5393; 26.2 ; 131.2 ; 14.6 ;5;39;90;1;4;0;5;2;3;3;2;0
5394; 47.6 ; 142.9 ; 6.2 ;3;68;232;0;3;1;2;1;2;0;3;0
5395; 15.0 ; 59.9 ; -   ;4;7;243;0;4;2;2;2;2;4;0;0
5396; 47.8 ; 95.7 ; 0.5 ;2;62;1;2;0;0;2;0;2;0;2;0
5397; 75.1 ; 150.2 ; 11.4 ;2;88;193;0;2;1;1;2;0;0;0;2
5398; 41.5 ; 124.6 ; 19.0 ;3;16;11;0;3;1;2;2;1;1;1;1
5399; 23.5 ; 140.8 ; 6.9 ;6;15;230;0;6;1;5;1;5;4;2;0
5400; 40.1 ; 200.3 ; 17.6 ;5;64;0;0;5;0;5;5;0;2;1;2
5401; 22.4 ; 313.4 ; 2.1 ;14;7;80;0;14;10;4;7;7;14;0;0
5402; 52.5 ; 105.0 ; -   ;2;5;257;0;2;0;2;2;0;0;2;0
5403; 25.3 ; 126.4 ; 7.1 ;5;53;73;0;5;1;4;2;3;3;2;0
5404; 40.2 ; 120.7 ; 13.9 ;3;34;15;0;3;0;3;1;2;1;2;0
5405; 54.7 ; 164.0 ; 33.7 ;3;4;199;0;3;1;2;3;0;1;1;1
5406; 34.9 ; 278.9 ; 15.0 ;8;7;91;0;8;3;5;3;5;3;5;0
5407; 91.1 ; 182.2 ; 105.8 ;2;20;250;0;2;1;1;2;0;1;0;1
5408; 53.1 ; 372.0 ; 33.2 ;7;37;121;0;7;0;7;3;4;2;3;2
5409; 47.9 ; 143.8 ; 0.4 ;3;21;5;2;1;1;2;3;0;0;3;0
5410; 53.7 ; 107.3 ; 2.1 ;2;17;176;2;0;2;0;0;2;0;1;1
5411; 54.2 ; 217.0 ; 9.2 ;4;55;125;0;4;0;4;3;1;0;3;1
5412; 31.7 ; 507.3 ; 24.0 ;16;20;0;0;16;8;8;13;3;5;6;5
5413; 58.7 ; 117.5 ; 18.0 ;2;22;260;0;2;1;1;1;1;0;0;2
5414; 17.2 ; 137.8 ; 4.7 ;8;36;7;0;8;5;3;7;1;8;0;0
5415; 71.1 ; 142.2 ; 33.5 ;2;158;110;0;2;0;2;2;0;0;0;2
5416; 47.4 ; 189.7 ; 1.0 ;4;80;62;0;4;0;4;1;3;0;4;0
5417; 38.0 ; 265.8 ; 14.3 ;7;20;148;0;7;5;2;7;0;2;5;0
5418; 41.5 ; 621.8 ; 27.7 ;15;15;63;0;15;2;13;10;5;5;5;5
5419; 45.0 ; 224.8 ; 7.7 ;5;13;292;0;5;2;3;2;3;0;5;0
5420; 43.9 ; 219.5 ; 7.5 ;5;53;35;0;5;3;2;1;4;0;5;0
5421; 40.8 ; 122.5 ; 24.1 ;3;13;238;0;3;2;1;2;1;1;1;1
5422; 19.7 ; 39.4 ; 0.1 ;2;44;144;0;2;2;0;2;0;2;0;0
5423; 46.8 ; 93.5 ; -   ;2;31;248;0;2;1;1;2;0;0;2;0
5424; 26.4 ; 105.5 ; 8.0 ;4;37;77;0;4;4;0;2;2;3;1;0
5425; 59.6 ; 119.2 ; 6.9 ;2;6;167;0;2;0;2;2;0;0;0;2
5426; 31.6 ; 189.4 ; 17.8 ;6;10;60;6;0;4;2;3;3;2;4;0
5427; 29.1 ; 145.7 ; 9.5 ;5;33;134;0;5;2;3;4;1;3;2;0
5428; 43.5 ; 130.4 ; 26.2 ;3;2;102;0;3;1;2;1;2;1;1;1
5429; 103.9 ; 207.8 ; 39.5 ;2;27;237;0;2;1;1;1;1;0;0;2
5430; 39.4 ; 236.3 ; 15.6 ;6;11;155;0;6;3;3;3;3;2;2;2
5431; 17.3 ; 34.7 ; 3.5 ;2;38;58;2;0;0;2;2;0;2;0;0
5432; 42.0 ; 210.1 ; 26.1 ;5;56;36;0;5;1;4;4;1;2;1;2
5433; 62.7 ; 1,066.6 ; 34.2 ;17;23;32;0;17;0;17;14;3;6;0;11
5434; 37.5 ; 187.6 ; 8.0 ;5;25;83;0;5;0;5;5;0;2;3;0
5435; 31.2 ; 93.5 ; 16.0 ;3;18;368;0;3;1;2;3;0;1;2;0
5436; 30.0 ; 59.9 ; -   ;2;32;61;0;2;2;0;1;1;2;0;0
5437; 32.5 ; 325.0 ; 26.8 ;10;31;113;0;10;7;3;6;4;3;4;3
5438; 53.9 ; 161.8 ; 12.8 ;3;72;108;0;3;3;0;3;0;0;2;1
5439; 42.7 ; 85.4 ; 6.6 ;2;33;288;0;2;1;1;2;0;0;2;0
5440; 25.8 ; 51.6 ; 16.2 ;2;95;137;0;2;1;1;0;2;1;1;0
5441; 40.8 ; 163.4 ; -   ;4;14;292;0;4;3;1;1;3;0;4;0
5442; 56.5 ; 169.6 ; 39.5 ;3;7;304;0;3;1;2;2;1;1;0;2
5443; 23.1 ; 46.2 ; 3.0 ;2;56;228;0;2;2;0;0;2;2;0;0
5444; 28.4 ; 142.0 ; 17.1 ;5;7;239;0;5;3;2;5;0;3;2;0
5445; 20.0 ; 59.9 ; 9.2 ;3;49;179;0;3;2;1;1;2;3;0;0
5446; 37.8 ; 113.5 ; 8.8 ;3;43;181;0;3;1;2;2;1;1;2;0
5447; 32.8 ; 98.3 ; 17.2 ;3;12;210;0;3;0;3;1;2;1;2;0
5448; 19.2 ; 461.2 ; 6.8 ;24;10;6;0;24;8;16;14;10;24;0;0
5449; 55.1 ; 110.3 ; 9.9 ;2;4;230;0;2;1;1;2;0;0;0;2
5450; 51.1 ; 255.5 ; 43.6 ;5;86;10;0;5;1;4;3;2;2;1;2
5451; 34.1 ; 68.2 ; 7.6 ;2;23;266;0;2;2;0;1;1;1;1;0
5452; 47.1 ; 94.2 ; 0.5 ;2;60;65;0;2;1;1;0;2;0;2;0
5453; 15.0 ; 30.0 ; -   ;2;23;146;0;2;2;0;1;1;2;0;0
5454; 44.0 ; 571.4 ; 5.3 ;13;24;73;0;13;1;12;13;0;0;13;0
5455; 34.8 ; 243.3 ; 14.6 ;7;25;120;0;7;1;6;4;3;2;5;0
5456; 48.8 ; 146.3 ; 9.3 ;3;23;4;0;3;1;2;2;1;0;2;1
5457; 49.2 ; 245.8 ; 24.9 ;5;52;52;0;5;3;2;3;2;2;1;2
5458; 49.7 ; 99.4 ; 0.5 ;2;23;13;0;2;2;0;1;1;0;2;0
5459; 45.9 ; 229.6 ; 4.8 ;5;67;98;0;5;2;3;2;3;0;5;0
5460; 45.7 ; 183.0 ; 19.4 ;4;115;52;2;2;2;2;2;2;1;2;1
5461; 36.6 ; 73.2 ; -   ;2;170;36;2;0;0;2;2;0;0;2;0
5462; 29.7 ; 386.0 ; 14.7 ;13;21;10;0;13;2;11;11;2;9;4;0
5463; 21.9 ; 109.6 ; 2.0 ;5;15;232;0;5;1;4;2;3;5;0;0
5464; 41.7 ; 83.4 ; 7.6 ;2;18;94;0;2;0;2;2;0;0;2;0
5465; 25.1 ; 50.1 ; -   ;2;16;43;2;0;1;1;0;2;2;0;0
5466; 20.0 ; 40.1 ; 7.6 ;2;12;236;0;2;0;2;2;0;2;0;0
5467; 39.6 ; 79.1 ; 13.7 ;2;37;88;0;2;2;0;1;1;1;1;0
5468; 17.3 ; 34.7 ; 3.5 ;2;167;152;0;2;1;1;2;0;2;0;0
5469; 32.3 ; 96.9 ; 19.5 ;3;103;94;0;3;2;1;2;1;1;2;0
5470; 54.6 ; 163.9 ; 54.1 ;3;65;160;0;3;2;1;1;2;1;1;1
5471; 70.1 ; 140.3 ; 35.0 ;2;6;253;0;2;1;1;2;0;0;0;2
5472; 23.3 ; 46.5 ; 2.7 ;2;29;235;0;2;2;0;2;0;2;0;0
5473; 23.6 ; 330.9 ; 13.0 ;14;30;9;0;14;13;1;12;2;9;5;0
5474; 30.2 ; 60.4 ; -   ;2;20;134;2;0;2;0;0;2;0;2;0
5475; 49.3 ; 246.6 ; 2.3 ;5;22;15;0;5;3;2;3;2;0;5;0
5476; 65.4 ; 130.7 ; 19.3 ;2;9;267;0;2;1;1;2;0;0;0;2
5477; 15.0 ; 74.9 ; -   ;5;64;6;0;5;3;2;5;0;5;0;0
5478; 20.0 ; 40.1 ; 7.6 ;2;201;111;0;2;0;2;0;2;2;0;0
5479; 46.1 ; 276.4 ; 39.7 ;6;41;82;3;3;1;5;2;4;2;2;2
5480; 42.7 ; 128.1 ; 32.3 ;3;19;218;0;3;2;1;1;2;1;1;1
5481; 50.3 ; 201.3 ; 6.1 ;4;32;0;0;4;0;4;4;0;0;3;1
5482; 30.2 ; 60.4 ; -   ;2;57;328;0;2;2;0;1;1;0;2;0
5483; 30.0 ; 869.4 ; 19.8 ;29;9;2;18;11;13;16;22;7;19;10;0
5484; 236.9 ; 710.8 ; 85.2 ;3;53;133;3;0;2;1;2;1;0;0;3
5485; 60.9 ; 121.8 ; 18.4 ;2;131;121;0;2;0;2;1;1;0;0;2
5486; 23.3 ; 139.6 ; 7.8 ;6;14;101;0;6;2;4;5;1;4;2;0
5487; 50.0 ; 100.0 ; 3.8 ;2;301;26;0;2;1;1;0;2;0;2;0
5488; 32.3 ; 129.2 ; 17.1 ;4;25;293;0;4;0;4;2;2;1;3;0
5489; 30.9 ; 61.7 ; 23.8 ;2;4;143;0;2;1;1;2;0;1;1;0
5490; 33.9 ; 135.5 ; 17.5 ;4;81;91;1;3;3;1;2;2;1;3;0
5491; 48.4 ; 96.8 ; 1.4 ;2;12;33;0;2;1;1;1;1;0;2;0
5492; 90.0 ; 180.1 ; 27.3 ;2;1;299;0;2;0;2;2;0;0;0;2
5493; 25.1 ; 75.2 ; -   ;3;19;68;0;3;1;2;3;0;3;0;0
5494; 57.5 ; 115.0 ; -   ;2;50;47;2;0;0;2;1;1;0;0;2
5495; 45.2 ; 90.3 ; 2.4 ;2;37;73;2;0;0;2;2;0;0;2;0
5496; 29.8 ; 119.0 ; 11.2 ;4;4;2;0;4;2;2;1;3;3;1;0
5497; 57.8 ; 231.4 ; 28.6 ;4;38;210;0;4;0;4;4;0;1;0;3
5498; 33.9 ; 237.3 ; 5.7 ;7;56;39;0;7;1;6;6;1;2;5;0
5499; 55.9 ; 223.5 ; 15.8 ;4;44;10;0;4;0;4;3;1;0;0;4
5500; 41.4 ; 82.7 ; 16.7 ;2;12;257;0;2;0;2;1;1;1;0;1
5501; 47.3 ; 141.9 ; 30.5 ;3;59;41;0;3;1;2;2;1;1;1;1
5502; 72.6 ; 145.3 ; 22.7 ;2;48;110;0;2;1;1;2;0;0;0;2
5503; 15.0 ; 74.9 ; -   ;5;18;23;0;5;1;4;3;2;5;0;0
5504; 51.0 ; 255.2 ; 30.8 ;5;9;10;0;5;1;4;5;0;2;1;2
5505; 47.1 ; 94.2 ; 0.5 ;2;188;69;0;2;0;2;2;0;0;2;0
5506; 38.3 ; 76.5 ; 34.8 ;2;167;66;0;2;1;1;1;1;1;0;1
5507; 35.2 ; 316.4 ; 12.8 ;9;31;5;0;9;0;9;8;1;3;6;0
5508; 42.1 ; 126.3 ; 3.7 ;3;52;16;0;3;2;1;3;0;0;3;0
5509; 24.0 ; 144.1 ; 6.9 ;6;11;207;0;6;1;5;2;4;4;2;0
5510; 27.4 ; 136.8 ; 16.2 ;5;41;15;0;5;3;2;4;1;3;2;0
5511; 55.6 ; 111.2 ; 9.1 ;2;60;163;0;2;1;1;1;1;0;0;2
5512; 40.6 ; 162.3 ; 8.4 ;4;8;332;0;4;0;4;1;3;0;4;0
5513; 40.7 ; 81.5 ; 9.0 ;2;76;258;0;2;0;2;1;1;0;2;0
5514; 30.5 ; 122.0 ; 11.5 ;4;149;17;0;4;0;4;2;2;1;3;0
5515; 27.1 ; 54.2 ; 18.1 ;2;132;76;0;2;2;0;1;1;1;1;0
5516; 28.8 ; 115.3 ; 24.2 ;4;23;270;0;4;3;1;4;0;3;1;0
5517; 41.7 ; 2,083.4 ; 16.0 ;50;7;15;0;50;26;24;32;18;17;16;17
5518; 17.5 ; 104.8 ; 3.9 ;6;46;47;0;6;0;6;4;2;6;0;0
5519; 59.3 ; 652.7 ; 22.0 ;11;19;25;0;11;11;0;11;0;0;0;11
5520; 35.8 ; 107.4 ; 10.7 ;3;29;69;0;3;2;1;1;2;1;2;0
5521; 78.4 ; 392.1 ; 76.2 ;5;59;44;0;5;5;0;1;4;2;0;3
5522; 17.9 ; 35.8 ; 0.2 ;2;190;62;0;2;1;1;2;0;2;0;0
5523; 40.1 ; 80.1 ; -   ;2;184;124;0;2;1;1;1;1;0;2;0
5524; 47.0 ; 141.0 ; 0.4 ;3;69;71;3;0;3;0;1;2;0;3;0
5525; 52.5 ; 210.2 ; 14.6 ;4;5;368;0;4;0;4;2;2;0;3;1
5526; 47.3 ; 236.4 ; 0.9 ;5;95;62;0;5;1;4;3;2;0;5;0
5527; 15.0 ; 134.9 ; -   ;9;37;18;0;9;1;8;7;2;9;0;0
5528; 20.0 ; 40.1 ; 7.6 ;2;10;285;0;2;1;1;1;1;2;0;0
5529; 34.0 ; 170.0 ; 9.6 ;5;43;10;0;5;2;3;1;4;2;3;0
5530; 20.4 ; 61.2 ; 6.1 ;3;34;52;0;3;0;3;3;0;3;0;0
5531; 52.2 ; 104.3 ; 7.0 ;2;121;61;0;2;2;0;0;2;0;1;1
5532; 61.5 ; 184.5 ; 15.5 ;3;37;70;0;3;2;1;1;2;0;0;3
5533; 30.6 ; 183.7 ; 6.0 ;6;4;164;0;6;3;3;5;1;2;4;0
5534; 15.0 ; 30.0 ; -   ;2;40;42;0;2;1;1;0;2;2;0;0
5535; 26.0 ; 130.0 ; 15.1 ;5;60;108;0;5;3;2;0;5;3;2;0
5536; 39.2 ; 78.4 ; 10.9 ;2;419;28;0;2;1;1;1;1;1;1;0
5537; 50.2 ; 351.5 ; 13.2 ;7;36;68;0;7;1;6;5;2;0;5;2
5538; 32.8 ; 65.7 ; 2.5 ;2;1;109;0;2;1;1;1;1;0;2;0
5539; 33.8 ; 67.5 ; 28.1 ;2;41;250;0;2;1;1;1;1;1;0;1
5540; 22.5 ; 44.9 ; 11.2 ;2;23;116;0;2;1;1;2;0;1;1;0
5541; 70.4 ; 140.8 ; 24.8 ;2;63;147;0;2;0;2;1;1;0;0;2
5542; 26.1 ; 130.7 ; 15.5 ;5;16;31;0;5;0;5;1;4;3;2;0
5543; 25.1 ; 50.1 ; -   ;2;24;199;2;0;0;2;2;0;2;0;0
5544; 54.6 ; 109.2 ; 2.1 ;2;20;71;2;0;2;0;0;2;0;1;1
5545; 31.9 ; 575.0 ; 12.7 ;18;22;13;0;18;10;8;6;12;6;12;0
5546; 64.0 ; 511.8 ; 53.7 ;8;5;255;0;8;1;7;6;2;3;0;5
5547; 19.7 ; 315.9 ; 3.9 ;16;19;5;0;16;9;7;10;6;16;0;0
5548; 35.9 ; 71.8 ; 16.2 ;2;33;77;0;2;1;1;0;2;1;1;0
5549; 46.9 ; 93.9 ; 8.6 ;2;25;351;0;2;0;2;1;1;0;1;1
5550; 44.0 ; 176.1 ; 28.4 ;4;38;99;0;4;0;4;3;1;1;2;1
5551; 29.9 ; 119.4 ; 10.2 ;4;56;101;0;4;3;1;1;3;3;1;0
5552; 56.9 ; 284.5 ; -   ;5;4;386;0;5;4;1;2;3;0;0;5
5553; 52.0 ; 364.3 ; 37.7 ;7;16;189;0;7;3;4;1;6;2;3;2
5554; 20.7 ; 62.0 ; 8.8 ;3;77;143;0;3;1;2;3;0;3;0;0
5555; 53.1 ; 265.5 ; 7.3 ;5;74;31;0;5;2;3;4;1;0;3;2
5556; 31.2 ; 436.7 ; 3.4 ;14;13;1;14;0;6;8;7;7;5;9;0
5557; 47.0 ; 141.0 ; 0.4 ;3;85;78;0;3;1;2;3;0;0;3;0
5558; 26.6 ; 266.0 ; 8.7 ;10;32;79;0;10;6;4;6;4;7;3;0
5559; 41.4 ; 413.5 ; 12.8 ;10;17;84;0;10;1;9;4;6;3;7;0
5560; 42.5 ; 212.4 ; 13.2 ;5;74;104;0;5;2;3;1;4;2;1;2
5561; 22.5 ; 89.9 ; 9.2 ;4;50;23;0;4;3;1;2;2;3;1;0
5562; 48.7 ; 97.4 ; -   ;2;57;3;1;1;2;0;2;0;0;2;0
5563; 34.0 ; 204.3 ; 16.4 ;6;41;167;0;6;3;3;1;5;2;4;0
5564; 49.0 ; 98.0 ; 0.5 ;2;248;89;0;2;1;1;0;2;0;2;0
5565; 20.9 ; 125.6 ; 2.1 ;6;55;0;0;6;1;5;5;1;6;0;0
5566; 17.9 ; 53.8 ; 4.6 ;3;176;5;0;3;0;3;0;3;3;0;0
5567; 16.1 ; 242.0 ; 3.9 ;15;10;6;0;15;7;8;4;11;15;0;0
5568; 47.1 ; 94.2 ; 0.5 ;2;277;74;0;2;0;2;1;1;0;2;0
5569; 56.4 ; 282.2 ; 3.9 ;5;78;11;0;5;0;5;5;0;0;0;5
5570; 66.9 ; 133.7 ; 23.7 ;2;32;141;0;2;0;2;0;2;0;0;2
5571; 69.7 ; 418.3 ; 25.6 ;6;21;68;0;6;0;6;5;1;0;0;6
5572; 109.1 ; 327.3 ; 52.5 ;3;56;48;0;3;1;2;1;2;0;0;3
5573; 15.0 ; 30.0 ; -   ;2;36;97;2;0;2;0;2;0;2;0;0
5574; 29.2 ; 146.0 ; 18.3 ;5;52;5;0;5;1;4;3;2;3;2;0
5575; 70.8 ; 141.7 ; 36.1 ;2;88;47;0;2;0;2;2;0;0;0;2
5576; 70.7 ; 494.9 ; 32.6 ;7;6;267;0;7;4;3;4;3;0;0;7
5577; 25.3 ; 151.7 ; 11.2 ;6;27;16;0;6;2;4;0;6;4;2;0
5578; 51.5 ; 360.8 ; 32.7 ;7;41;29;0;7;4;3;3;4;2;3;2
5579; 44.4 ; 88.8 ; 44.0 ;2;26;99;0;2;0;2;2;0;1;0;1
5580; 44.7 ; 223.3 ; 38.3 ;5;50;60;0;5;2;3;2;3;2;1;2
5581; 42.3 ; 296.2 ; 14.6 ;7;42;49;0;7;3;4;4;3;2;3;2
5582; 32.1 ; 128.5 ; 18.0 ;4;60;110;0;4;1;3;2;2;1;3;0
5583; 79.3 ; 1,110.0 ; 40.4 ;14;23;16;0;14;0;14;12;2;0;0;14
5584; 46.4 ; 232.1 ; 37.4 ;5;72;0;0;5;0;5;4;1;2;1;2
5585; 16.8 ; 33.6 ; 2.7 ;2;6;80;0;2;2;0;1;1;2;0;0
5586; 30.9 ; 61.7 ; 23.8 ;2;29;251;0;2;2;0;2;0;1;1;0
5587; 30.0 ; 60.1 ; 15.0 ;2;17;250;0;2;2;0;1;1;1;1;0
5588; 27.3 ; 299.9 ; 40.0 ;11;14;14;0;11;6;5;6;5;7;0;4
5589; 57.0 ; 171.1 ; 18.8 ;3;15;179;0;3;0;3;3;0;0;0;3
5590; 50.9 ; 2,339.7 ; 24.0 ;46;10;5;0;46;6;40;24;22;15;16;15
5591; 40.2 ; 80.3 ; 2.2 ;2;7;15;0;2;0;2;1;1;0;2;0
5592; 54.0 ; 270.0 ; 24.9 ;5;59;106;0;5;2;3;2;3;2;1;2
5593; 21.7 ; 65.1 ; 6.2 ;3;166;111;0;3;1;2;1;2;3;0;0
5594; 21.8 ; 43.7 ; 4.9 ;2;2;262;0;2;1;1;1;1;2;0;0
5595; 34.0 ; 101.9 ; 15.1 ;3;16;277;0;3;2;1;2;1;1;2;0
5596; 50.1 ; 1,002.7 ; 29.1 ;20;16;0;0;20;5;15;8;12;7;6;7
5597; 41.5 ; 83.0 ; 23.0 ;2;348;92;0;2;1;1;1;1;1;0;1
5598; 20.0 ; 40.1 ; 7.6 ;2;37;230;0;2;0;2;0;2;2;0;0
5599; 38.8 ; 77.6 ; 20.5 ;2;145;95;0;2;0;2;1;1;1;0;1
5600; 27.9 ; 139.4 ; 3.0 ;5;28;107;0;5;4;1;1;4;3;2;0
5601; 65.4 ; 130.7 ; 20.4 ;2;181;32;0;2;0;2;1;1;0;0;2
5602; 35.6 ; 71.2 ; 18.9 ;2;5;10;2;0;0;2;1;1;1;1;0
5603; 22.5 ; 44.9 ; 11.2 ;2;93;16;2;0;1;1;1;1;1;1;0
5604; 15.0 ; 74.9 ; -   ;5;9;235;0;5;5;0;0;5;5;0;0
5605; 49.8 ; 149.5 ; 18.5 ;3;53;10;0;3;0;3;2;1;0;2;1
5606; 32.6 ; 65.1 ; 11.2 ;2;45;140;0;2;2;0;1;1;1;1;0
5607; 47.6 ; 190.4 ; 0.9 ;4;32;46;0;4;2;2;1;3;0;4;0
5608; 58.9 ; 176.8 ; 7.6 ;3;9;199;0;3;1;2;2;1;0;0;3
5609; 53.0 ; 159.0 ; 5.7 ;3;9;271;0;3;3;0;1;2;0;2;1
5610; 33.7 ; 134.8 ; 16.8 ;4;23;15;0;4;0;4;1;3;1;3;0
5611; 38.4 ; 192.0 ; 5.3 ;5;14;22;0;5;2;3;1;4;0;5;0
5612; 29.3 ; 498.8 ; 21.5 ;17;14;67;0;17;4;13;9;8;11;6;0
5613; 149.7 ; 299.3 ; 15.8 ;2;11;51;2;0;2;0;0;2;0;0;2
5614; 28.6 ; 85.9 ; 4.8 ;3;21;11;0;3;1;2;2;1;2;1;0
5615; 32.7 ; 98.1 ; 9.7 ;3;124;193;0;3;3;0;0;3;1;2;0
5616; 19.2 ; 96.0 ; 7.0 ;5;16;10;0;5;0;5;5;0;5;0;0
5617; 26.8 ; 80.3 ; 3.1 ;3;75;134;0;3;2;1;1;2;3;0;0
5618; 81.2 ; 324.8 ; 25.1 ;4;42;189;0;4;0;4;4;0;0;0;4
5619; 31.3 ; 344.7 ; 11.6 ;11;18;29;0;11;0;11;9;2;4;7;0
5620; 18.0 ; 251.3 ; 9.8 ;14;18;80;0;14;6;8;5;9;14;0;0
5621; 46.1 ; 368.6 ; 5.1 ;8;27;134;0;8;1;7;4;4;0;8;0
5622; 26.4 ; 52.7 ; 1.1 ;2;14;206;2;0;1;1;1;1;2;0;0
5623; 15.0 ; 45.0 ; -   ;3;38;38;0;3;1;2;1;2;3;0;0
5624; 54.7 ; 109.5 ; 1.4 ;2;93;169;0;2;0;2;0;2;0;1;1
5625; 36.4 ; 254.7 ; 9.3 ;7;44;16;0;7;3;4;4;3;2;5;0
5626; 20.0 ; 100.1 ; 5.9 ;5;20;26;0;5;0;5;3;2;5;0;0
5627; 22.3 ; 423.8 ; 9.9 ;19;7;225;0;19;0;19;16;3;13;6;0
5628; 126.5 ; 632.4 ; 42.4 ;5;32;23;0;5;2;3;1;4;0;0;5
5629; 21.1 ; 84.4 ; 6.2 ;4;45;52;0;4;1;3;2;2;4;0;0
5630; 15.0 ; 30.0 ; -   ;2;7;88;2;0;1;1;2;0;2;0;0
5631; 30.0 ; 240.2 ; 17.0 ;8;20;247;0;8;2;6;5;3;3;5;0
5632; 43.0 ; 172.2 ; 4.5 ;4;39;228;0;4;3;1;1;3;0;4;0
5633; 71.5 ; 142.9 ; 21.5 ;2;3;354;0;2;1;1;0;2;0;0;2
5634; 101.8 ; 1,119.8 ; 36.5 ;11;11;51;0;11;11;0;2;9;0;0;11
5635; 23.0 ; 138.2 ; 12.5 ;6;55;99;0;6;3;3;1;5;4;2;0
5636; 60.7 ; 121.3 ; 23.7 ;2;5;259;0;2;1;1;0;2;0;0;2
5637; 25.1 ; 75.2 ; 0.7 ;3;32;52;1;2;0;3;3;0;3;0;0
5638; 20.2 ; 323.8 ; 8.1 ;16;26;16;0;16;5;11;5;11;16;0;0
5639; 48.7 ; 292.0 ; 13.4 ;6;39;69;0;6;0;6;6;0;0;4;2
5640; 44.9 ; 89.8 ; 12.5 ;2;44;57;0;2;0;2;2;0;0;1;1
5641; 17.5 ; 87.6 ; 6.6 ;5;25;25;0;5;3;2;5;0;5;0;0
5642; 39.4 ; 629.8 ; 27.4 ;16;21;0;0;16;0;16;11;5;5;6;5
5643; 34.4 ; 68.9 ; -   ;2;24;158;2;0;0;2;2;0;0;2;0
5644; 37.5 ; 74.9 ; 11.2 ;2;138;105;0;2;0;2;2;0;1;1;0
5645; 39.7 ; 238.3 ; 13.7 ;6;61;69;0;6;2;4;4;2;2;4;0
5646; 62.6 ; 125.2 ; 38.1 ;2;54;65;1;1;1;1;1;1;1;0;1
5647; 24.5 ; 122.4 ; 22.5 ;5;63;56;0;5;1;4;2;3;3;2;0
5648; 21.1 ; 63.2 ; 5.6 ;3;4;293;0;3;1;2;3;0;3;0;0
5649; 20.0 ; 40.1 ; 7.6 ;2;1;263;0;2;0;2;1;1;2;0;0
5650; 51.7 ; 258.5 ; 30.5 ;5;72;0;0;5;0;5;5;0;2;1;2
5651; 58.0 ; 290.1 ; 37.1 ;5;54;36;0;5;0;5;5;0;2;0;3
5652; 22.2 ; 66.6 ; 13.2 ;3;16;126;0;3;0;3;1;2;2;1;0
5653; 20.5 ; 164.0 ; 12.2 ;8;34;5;0;8;0;8;6;2;5;3;0
5654; 31.2 ; 62.5 ; 24.3 ;2;138;26;0;2;0;2;1;1;1;0;1
5655; 19.9 ; 139.5 ; 7.1 ;7;16;22;0;7;4;3;3;4;7;0;0
5656; 53.5 ; 267.5 ; 46.9 ;5;36;121;0;5;1;4;2;3;2;1;2
5657; 43.2 ; 173.0 ; 13.1 ;4;65;162;0;4;0;4;2;2;0;3;1
5658; 20.0 ; 40.1 ; 7.6 ;2;5;368;0;2;0;2;0;2;2;0;0
5659; 45.5 ; 91.1 ; 0.6 ;2;9;173;0;2;1;1;0;2;0;2;0
5660; 15.0 ; 45.0 ; -   ;3;3;37;0;3;0;3;1;2;3;0;0
5661; 69.5 ; 139.0 ; 5.4 ;2;22;210;0;2;1;1;2;0;0;0;2
5662; 24.1 ; 48.1 ; 0.1 ;2;81;197;0;2;2;0;1;1;2;0;0
5663; 32.6 ; 162.8 ; 14.1 ;5;50;53;0;5;1;4;4;1;2;3;0
5664; 31.6 ; 94.8 ; 2.6 ;3;108;130;1;2;2;1;1;2;1;2;0
5665; 28.1 ; 140.6 ; 6.8 ;5;36;94;0;5;1;4;4;1;3;2;0
5666; 56.7 ; 170.0 ; 44.7 ;3;130;63;0;3;0;3;1;2;1;0;2
5667; 28.5 ; 199.7 ; 7.9 ;7;29;4;0;7;3;4;3;4;5;2;0
5668; 36.5 ; 438.5 ; 32.2 ;12;27;4;0;12;4;8;2;10;4;4;4
5669; 45.5 ; 227.5 ; 9.2 ;5;47;20;0;5;1;4;4;1;0;5;0
5670; 48.2 ; 144.5 ; 11.3 ;3;5;89;0;3;1;2;1;2;0;2;1
5671; 43.7 ; 1,397.0 ; 12.5 ;32;11;5;0;32;7;25;30;2;0;21;11
5672; 38.1 ; 266.6 ; 17.2 ;7;25;117;0;7;1;6;3;4;2;3;2
5673; 28.5 ; 113.9 ; 1.6 ;4;50;14;0;4;2;2;2;2;3;1;0
5674; 33.1 ; 430.7 ; 7.8 ;13;14;75;0;13;6;7;5;8;4;9;0
5675; 51.5 ; 154.5 ; 2.6 ;3;139;33;0;3;2;1;1;2;0;3;0
5676; 15.0 ; 74.9 ; -   ;5;29;216;0;5;3;2;3;2;5;0;0
5677; 36.7 ; 330.4 ; 7.9 ;9;23;4;0;9;5;4;3;6;3;6;0
5678; 40.1 ; 120.3 ; 14.4 ;3;7;29;0;3;2;1;0;3;1;2;0
5679; 34.7 ; 451.7 ; 8.1 ;13;32;11;0;13;2;11;10;3;4;9;0
5680; 25.1 ; 100.3 ; -   ;4;20;53;0;4;2;2;1;3;4;0;0
5681; 84.2 ; 168.5 ; 40.1 ;2;6;225;0;2;0;2;1;1;0;0;2
5682; 15.0 ; 30.0 ; -   ;2;5;246;0;2;0;2;1;1;2;0;0
5683; 36.8 ; 294.1 ; 20.9 ;8;49;26;0;8;2;6;2;6;3;2;3
5684; 30.1 ; 60.1 ; 7.5 ;2;13;171;0;2;2;0;2;0;1;1;0
5685; 21.9 ; 43.7 ; 10.3 ;2;29;122;0;2;1;1;1;1;1;1;0
5686; 50.5 ; 100.9 ; 10.5 ;2;18;95;0;2;0;2;2;0;0;1;1
5687; 31.9 ; 63.8 ; 2.5 ;2;353;68;0;2;0;2;2;0;1;1;0
5688; 31.8 ; 63.5 ; 19.7 ;2;13;212;0;2;2;0;0;2;1;1;0
5689; 50.2 ; 250.8 ; 30.6 ;5;52;84;0;5;1;4;2;3;2;1;2
5690; 40.2 ; 80.5 ; 10.8 ;2;5;83;0;2;0;2;1;1;1;1;0
5691; 28.2 ; 197.1 ; 13.4 ;7;45;5;0;7;2;5;6;1;5;2;0
5692; 19.2 ; 57.7 ; -   ;3;5;393;0;3;1;2;1;2;3;0;0
5693; 37.2 ; 743.2 ; 37.1 ;20;20;0;0;20;3;17;7;13;7;6;7
5694; 33.8 ; 101.3 ; 6.6 ;3;140;32;1;2;0;3;3;0;1;2;0
5695; 18.0 ; 36.1 ; 4.6 ;2;2;215;0;2;1;1;0;2;2;0;0
5696; 54.8 ; 164.4 ; 7.0 ;3;41;84;0;3;0;3;3;0;0;2;1
5697; 30.3 ; 60.5 ; 1.4 ;2;37;101;0;2;0;2;2;0;1;1;0
5698; 36.6 ; 146.4 ; -   ;4;23;176;0;4;1;3;1;3;0;4;0
5699; 29.5 ; 118.0 ; 0.4 ;4;16;21;0;4;1;3;3;1;4;0;0
5700; 25.1 ; 50.1 ; -   ;2;138;16;0;2;0;2;2;0;2;0;0
5701; 50.2 ; 501.6 ; 27.8 ;10;16;20;0;10;8;2;3;7;3;4;3
5702; 33.4 ; 535.0 ; 15.8 ;16;16;4;0;16;10;6;8;8;5;11;0
5703; 116.9 ; 233.8 ; 35.0 ;2;20;109;0;2;1;1;1;1;0;0;2
5704; 50.5 ; 252.6 ; 2.6 ;5;13;201;0;5;2;3;3;2;0;5;0
5705; 46.8 ; 234.2 ; 0.4 ;5;112;42;0;5;0;5;5;0;0;5;0
5706; 58.9 ; 176.8 ; 22.4 ;3;90;145;0;3;1;2;0;3;0;0;3
5707; 15.0 ; 30.0 ; -   ;2;208;36;0;2;0;2;2;0;2;0;0
5708; 41.4 ; 82.7 ; 16.7 ;2;246;73;1;1;0;2;0;2;1;0;1
5709; 32.7 ; 163.4 ; 20.5 ;5;77;3;0;5;2;3;3;2;2;3;0
5710; 33.5 ; 133.8 ; 10.0 ;4;42;107;1;3;2;2;1;3;1;3;0
5711; 94.9 ; 189.7 ; 13.7 ;2;79;137;0;2;0;2;2;0;0;0;2
5712; 62.8 ; 125.6 ; 24.0 ;2;130;115;0;2;1;1;1;1;0;0;2
5713; 22.6 ; 45.2 ; 11.4 ;2;45;157;0;2;0;2;0;2;1;1;0
5714; 17.8 ; 231.6 ; 2.1 ;13;15;5;0;13;6;7;5;8;13;0;0
5715; 64.6 ; 193.7 ; 28.4 ;3;132;126;0;3;1;2;2;1;0;0;3
5716; 24.3 ; 242.9 ; 14.3 ;10;13;54;0;10;7;3;4;6;7;3;0
5717; 51.7 ; 207.0 ; 2.2 ;4;77;57;0;4;1;3;2;2;0;4;0
5718; 35.2 ; 70.3 ; 30.2 ;2;59;199;0;2;1;1;1;1;1;0;1
5719; 83.3 ; 333.2 ; 23.5 ;4;64;7;0;4;1;3;4;0;0;0;4
5720; 47.3 ; 236.3 ; 0.9 ;5;57;73;0;5;0;5;5;0;0;5;0
5721; 42.7 ; 128.1 ; 5.8 ;3;185;36;0;3;0;3;1;2;0;3;0
5722; 42.0 ; 251.8 ; 17.7 ;6;52;0;1;5;0;6;5;1;2;2;2
5723; 29.7 ; 148.5 ; 9.4 ;5;52;5;5;0;2;3;3;2;3;2;0
5724; 26.2 ; 287.9 ; 6.4 ;11;14;2;0;11;8;3;2;9;7;4;0
5725; 43.5 ; 87.0 ; 19.9 ;2;131;158;0;2;0;2;0;2;1;0;1
5726; 33.6 ; 67.2 ; 20.8 ;2;173;74;0;2;1;1;0;2;1;1;0
5727; 29.2 ; 58.3 ; 6.1 ;2;80;29;0;2;2;0;0;2;1;1;0
5728; 22.5 ; 67.6 ; 3.0 ;3;18;245;0;3;3;0;1;2;3;0;0
5729; 38.2 ; 114.6 ; 17.0 ;3;7;27;0;3;1;2;3;0;1;1;1
5730; 84.9 ; 424.3 ; 17.8 ;5;57;63;0;5;0;5;5;0;0;0;5
5731; 32.5 ; 324.5 ; 21.2 ;10;32;14;1;9;8;2;2;8;3;7;0
5732; 45.9 ; 229.7 ; 22.1 ;5;38;11;0;5;0;5;5;0;2;1;2
5733; 17.6 ; 88.2 ; 4.1 ;5;18;114;0;5;0;5;1;4;5;0;0
5734; 41.4 ; 165.6 ; 11.8 ;4;29;11;0;4;0;4;4;0;1;3;0
5735; 19.7 ; 39.3 ; -   ;2;17;176;0;2;2;0;2;0;2;0;0
5736; 82.6 ; 412.8 ; 21.3 ;5;21;224;0;5;4;1;3;2;0;0;5
5737; 34.6 ; 103.7 ; 35.9 ;3;42;134;1;2;2;1;2;1;1;1;1
5738; 95.4 ; 190.9 ; 2.9 ;2;31;251;0;2;0;2;2;0;0;0;2
5739; 22.4 ; 179.2 ; 15.3 ;8;27;27;0;8;0;8;5;3;5;3;0
5740; 31.3 ; 93.8 ; 11.4 ;3;23;320;0;3;2;1;0;3;1;2;0
5741; 38.7 ; 116.0 ; 8.2 ;3;35;140;0;3;1;2;3;0;0;3;0
5742; 46.8 ; 374.3 ; 28.1 ;8;32;31;1;7;1;7;5;3;3;2;3
5743; 20.8 ; 208.0 ; 11.0 ;10;11;28;0;10;8;2;1;9;7;3;0
5744; 49.4 ; 148.2 ; 3.5 ;3;34;36;0;3;0;3;2;1;0;3;0
5745; 50.2 ; 150.7 ; 25.2 ;3;92;115;0;3;0;3;1;2;1;1;1
5746; 32.6 ; 65.3 ; -   ;2;16;74;0;2;0;2;1;1;0;2;0
5747; 18.0 ; 36.0 ; -   ;2;5;56;0;2;2;0;2;0;2;0;0
5748; 36.8 ; 73.6 ; 1.1 ;2;84;20;0;2;0;2;1;1;0;2;0
5749; 37.4 ; 149.5 ; 14.6 ;4;61;173;0;4;1;3;1;3;1;3;0
5750; 47.7 ; 95.4 ; 1.4 ;2;74;200;0;2;0;2;0;2;0;2;0
5751; 15.0 ; 30.0 ; -   ;2;287;34;0;2;1;1;2;0;2;0;0
5752; 15.1 ; 166.2 ; 1.5 ;11;15;74;0;11;9;2;3;8;11;0;0
5753; 15.0 ; 30.0 ; -   ;2;43;303;0;2;2;0;1;1;2;0;0
5754; 49.6 ; 347.3 ; 10.5 ;7;21;57;0;7;0;7;7;0;0;5;2
5755; 75.4 ; 377.0 ; 28.6 ;5;62;7;0;5;2;3;5;0;0;0;5
5756; 17.7 ; 35.4 ; 4.0 ;2;18;205;0;2;0;2;1;1;2;0;0
5757; 67.1 ; 201.4 ; 25.4 ;3;22;242;0;3;0;3;3;0;0;0;3
5758; 72.5 ; 579.9 ; 16.1 ;8;20;141;0;8;0;8;8;0;0;0;8
5759; 66.0 ; 132.0 ; -   ;2;19;167;0;2;0;2;1;1;0;0;2
5760; 36.0 ; 180.1 ; 15.1 ;5;80;110;0;5;2;3;1;4;2;3;0
5761; 22.8 ; 114.2 ; 10.9 ;5;70;105;0;5;2;3;3;2;3;2;0
5762; 16.3 ; 341.8 ; 2.4 ;21;19;20;0;21;7;14;3;18;21;0;0
5763; 54.1 ; 216.4 ; 22.9 ;4;79;181;0;4;2;2;1;3;0;3;1
5764; 23.6 ; 141.8 ; 4.0 ;6;28;0;0;6;1;5;0;6;6;0;0
5765; 46.8 ; 93.5 ; -   ;2;130;158;1;1;1;1;1;1;0;2;0
5766; 41.2 ; 123.7 ; 10.1 ;3;7;137;3;0;2;1;1;2;0;3;0
5767; 93.8 ; 281.4 ; 109.6 ;3;11;11;3;0;1;2;1;2;1;0;2
5768; 47.4 ; 94.7 ; 0.9 ;2;4;263;0;2;1;1;2;0;0;2;0
5769; 23.0 ; 183.6 ; 10.6 ;8;23;66;0;8;2;6;3;5;5;3;0
5770; 57.6 ; 518.7 ; 20.4 ;9;31;37;0;9;0;9;9;0;0;0;9
5771; 52.8 ; 105.7 ; 9.1 ;2;248;18;0;2;1;1;1;1;0;1;1
5772; 35.9 ; 71.8 ; 16.2 ;2;63;94;2;0;0;2;1;1;1;1;0
5773; 24.4 ; 463.2 ; 16.7 ;19;22;5;0;19;8;11;10;9;13;6;0
5774; 42.7 ; 85.4 ; 12.4 ;2;22;173;0;2;1;1;0;2;0;1;1
5775; 55.9 ; 111.8 ; 19.5 ;2;257;11;0;2;0;2;1;1;0;0;2
5776; 25.9 ; 77.6 ; 11.4 ;3;23;65;0;3;1;2;3;0;2;1;0
5777; 49.2 ; 98.5 ; 0.8 ;2;300;17;0;2;1;1;1;1;0;2;0
5778; 60.9 ; 121.9 ; 8.7 ;2;295;53;1;1;0;2;2;0;0;0;2
5779; 19.8 ; 59.4 ; 5.4 ;3;65;161;0;3;3;0;1;2;3;0;0
5780; 30.8 ; 185.0 ; 16.4 ;6;30;21;0;6;2;4;3;3;2;4;0
5781; 24.7 ; 98.9 ; 15.7 ;4;16;234;0;4;4;0;4;0;3;1;0
5782; 51.2 ; 204.7 ; 15.7 ;4;32;210;0;4;3;1;2;2;0;3;1
5783; 69.5 ; 972.8 ; 22.4 ;14;23;15;0;14;1;13;10;4;0;0;14
5784; 51.4 ; 102.9 ; 7.0 ;2;104;160;0;2;1;1;1;1;0;1;1
5785; 48.6 ; 145.9 ; 1.5 ;3;39;8;3;0;3;0;1;2;0;3;0
5786; 29.6 ; 88.7 ; 18.3 ;3;54;266;0;3;1;2;1;2;2;1;0
5787; 55.5 ; 110.9 ; 32.1 ;2;4;251;0;2;1;1;0;2;1;0;1
5788; 21.2 ; 380.8 ; 11.1 ;18;20;11;0;18;8;10;15;3;12;6;0
5789; 38.3 ; 114.8 ; 4.0 ;3;49;170;0;3;1;2;2;1;0;3;0
5790; 36.6 ; 73.2 ; -   ;2;5;250;0;2;2;0;2;0;0;2;0
5791; 56.1 ; 280.5 ; 28.9 ;5;75;71;0;5;4;1;1;4;2;0;3
5792; 41.5 ; 124.4 ; 24.9 ;3;31;259;0;3;1;2;3;0;1;1;1
5793; 24.3 ; 73.0 ; 6.6 ;3;34;164;0;3;0;3;1;2;2;1;0
5794; 31.9 ; 63.8 ; 6.4 ;2;91;15;2;0;1;1;0;2;1;1;0
5795; 88.7 ; 177.4 ; 78.0 ;2;131;68;0;2;0;2;1;1;1;0;1
5796; 20.0 ; 40.1 ; 7.6 ;2;1;179;2;0;1;1;0;2;2;0;0
5797; 26.0 ; 129.8 ; 10.5 ;5;36;5;0;5;2;3;2;3;3;2;0
5798; 31.0 ; 62.0 ; 14.8 ;2;231;42;0;2;1;1;0;2;1;1;0
5799; 18.0 ; 54.0 ; -   ;3;68;37;0;3;0;3;3;0;3;0;0
5800; 51.7 ; 207.0 ; 41.3 ;4;55;15;1;3;0;4;3;1;1;2;1
5801; 16.5 ; 165.2 ; 2.4 ;10;31;5;0;10;0;10;8;2;10;0;0
5802; 44.1 ; 220.4 ; 15.4 ;5;47;99;0;5;0;5;5;0;2;1;2
5803; 56.9 ; 113.7 ; 28.2 ;2;6;387;0;2;1;1;0;2;1;0;1
5804; 42.2 ; 168.6 ; 24.3 ;4;82;57;0;4;1;3;2;2;1;2;1
5805; 22.6 ; 45.2 ; 11.4 ;2;324;26;0;2;1;1;1;1;1;1;0
5806; 15.3 ; 61.4 ; 0.8 ;4;42;73;0;4;0;4;2;2;4;0;0
5807; 62.4 ; 748.4 ; 24.9 ;12;21;40;0;12;8;4;11;1;0;0;12
5808; 30.9 ; 61.8 ; -   ;2;12;11;0;2;0;2;1;1;0;2;0
5809; 57.8 ; 115.7 ; 41.8 ;2;89;105;2;0;0;2;2;0;1;0;1
5810; 44.1 ; 264.9 ; 13.5 ;6;13;6;2;4;2;4;4;2;0;4;2
5811; 39.6 ; 316.6 ; 13.5 ;8;40;5;0;8;0;8;8;0;3;5;0
5812; 53.5 ; 107.0 ; 24.0 ;2;30;260;0;2;1;1;1;1;1;0;1
5813; 41.9 ; 209.6 ; 6.2 ;5;56;17;0;5;4;1;5;0;0;5;0
5814; 78.7 ; 236.1 ; 42.4 ;3;61;200;0;3;2;1;2;1;0;0;3
5815; 46.9 ; 656.0 ; 11.8 ;14;25;15;0;14;2;12;11;3;0;9;5
5816; 32.6 ; 1,010.5 ; 17.1 ;31;10;13;0;31;20;11;15;16;10;21;0
5817; 47.1 ; 94.2 ; 0.5 ;2;76;89;1;1;0;2;2;0;0;2;0
5818; 59.3 ; 118.6 ; 18.8 ;2;55;190;0;2;0;2;1;1;0;0;2
5819; 34.9 ; 663.9 ; 40.2 ;19;11;2;0;19;7;12;12;7;6;7;6
5820; 32.0 ; 159.8 ; 8.0 ;5;42;104;0;5;1;4;3;2;2;3;0
5821; 56.7 ; 226.6 ; 25.0 ;4;106;15;0;4;2;2;4;0;0;0;4
5822; 36.9 ; 147.8 ; 15.7 ;4;42;268;0;4;2;2;1;3;1;3;0
5823; 29.4 ; 88.2 ; 4.0 ;3;22;47;0;3;0;3;2;1;2;1;0
5824; 16.7 ; 770.3 ; 5.1 ;46;9;7;0;46;26;20;33;13;46;0;0
5825; 49.2 ; 98.5 ; 3.7 ;2;72;99;0;2;1;1;1;1;0;2;0
5826; 24.7 ; 74.1 ; -   ;3;5;172;0;3;3;0;1;2;3;0;0
5827; 47.0 ; 187.8 ; 35.5 ;4;27;214;0;4;3;1;3;1;1;2;1
5828; 46.8 ; 140.3 ; -   ;3;35;216;0;3;1;2;2;1;0;3;0
5829; 31.4 ; 157.1 ; 10.7 ;5;25;137;0;5;3;2;5;0;2;3;0
5830; 63.3 ; 316.5 ; 21.5 ;5;32;163;0;5;2;3;3;2;0;0;5
5831; 16.4 ; 32.8 ; 2.1 ;2;37;190;0;2;0;2;0;2;2;0;0
5832; 45.8 ; 183.1 ; 2.1 ;4;53;239;0;4;1;3;2;2;0;4;0
5833; 26.4 ; 131.8 ; 13.9 ;5;37;67;0;5;1;4;2;3;3;2;0
5834; 32.3 ; 64.7 ; 3.2 ;2;4;287;0;2;1;1;0;2;1;1;0
5835; 27.1 ; 81.4 ; 15.7 ;3;1;3;0;3;2;1;1;2;2;1;0
5836; 23.6 ; 47.1 ; 12.8 ;2;4;133;0;2;1;1;0;2;1;1;0
5837; 32.8 ; 98.4 ; 5.1 ;3;148;19;0;3;3;0;0;3;1;2;0
5838; 46.5 ; 139.6 ; 4.1 ;3;4;141;0;3;0;3;1;2;0;3;0
5839; 45.1 ; 90.3 ; 2.4 ;2;28;175;0;2;2;0;1;1;0;2;0
5840; 108.1 ; 432.3 ; 54.0 ;4;32;197;0;4;1;3;4;0;0;0;4
5841; 33.1 ; 297.5 ; 7.2 ;9;37;4;0;9;5;4;7;2;3;6;0
5842; 15.4 ; 30.8 ; -   ;2;15;245;0;2;2;0;2;0;2;0;0
5843; 48.2 ; 96.3 ; 2.1 ;2;13;125;0;2;2;0;0;2;0;2;0
5844; 40.6 ; 202.9 ; 15.7 ;5;5;3;0;5;5;0;4;1;2;1;2
5845; 36.6 ; 146.4 ; -   ;4;36;20;4;0;0;4;4;0;0;4;0
5846; 26.7 ; 213.5 ; 12.2 ;8;17;99;0;8;3;5;3;5;5;3;0
5847; 41.2 ; 535.3 ; 10.0 ;13;12;26;0;13;0;13;13;0;0;13;0
5848; 32.5 ; 195.1 ; 33.0 ;6;50;29;0;6;6;0;5;1;2;2;2
5849; 43.3 ; 130.0 ; 8.7 ;3;98;121;0;3;0;3;3;0;0;3;0
5850; 42.8 ; 299.8 ; 10.7 ;7;38;18;0;7;2;5;3;4;0;7;0
5851; 17.7 ; 35.4 ; 4.1 ;2;8;266;0;2;1;1;0;2;2;0;0
5852; 40.6 ; 81.2 ; 15.6 ;2;83;146;0;2;0;2;2;0;1;0;1
5853; 30.0 ; 89.9 ; 5.5 ;3;40;155;0;3;2;1;1;2;2;1;0
5854; 38.4 ; 76.8 ; 12.5 ;2;19;94;0;2;0;2;2;0;1;1;0
5855; 19.7 ; 217.1 ; 8.0 ;11;23;48;0;11;5;6;4;7;11;0;0
5856; 52.4 ; 209.7 ; 2.5 ;4;47;95;0;4;1;3;1;3;0;4;0
5857; 33.7 ; 202.3 ; 4.4 ;6;23;3;0;6;5;1;5;1;2;4;0
5858; 51.9 ; 103.9 ; 1.4 ;2;69;205;0;2;0;2;2;0;0;2;0
5859; 43.0 ; 86.1 ; 26.9 ;2;77;304;0;2;0;2;2;0;1;0;1
5860; 30.9 ; 61.7 ; 23.8 ;2;17;254;0;2;1;1;0;2;1;1;0
5861; 32.5 ; 97.5 ; 23.5 ;3;25;31;0;3;0;3;1;2;1;1;1
5862; 25.5 ; 102.0 ; 14.6 ;4;13;235;0;4;3;1;2;2;3;1;0
5863; 31.8 ; 159.1 ; 3.1 ;5;32;160;0;5;0;5;5;0;2;3;0
5864; 51.1 ; 1,635.8 ; 27.8 ;32;10;77;0;32;13;19;14;18;11;10;11
5865; 43.2 ; 86.4 ; 0.5 ;2;44;74;0;2;0;2;2;0;0;2;0
5866; 87.8 ; 175.7 ; 22.0 ;2;58;215;0;2;0;2;1;1;0;0;2
5867; 29.8 ; 59.6 ; 0.6 ;2;12;345;0;2;2;0;0;2;1;1;0
5868; 38.5 ; 76.9 ; 12.4 ;2;10;260;0;2;1;1;1;1;1;1;0
5869; 38.3 ; 650.5 ; 45.4 ;17;10;17;0;17;3;14;4;13;6;5;6
5870; 22.4 ; 156.6 ; 6.9 ;7;25;232;0;7;0;7;4;3;7;0;0
5871; 51.9 ; 415.3 ; 40.8 ;8;50;5;0;8;2;6;5;3;3;2;3
5872; 45.3 ; 136.0 ; 26.3 ;3;58;5;0;3;1;2;3;0;1;1;1
5873; 15.0 ; 30.0 ; -   ;2;59;86;0;2;2;0;1;1;2;0;0
5874; 44.7 ; 89.5 ; 15.4 ;2;105;11;0;2;0;2;1;1;1;0;1
5875; 54.6 ; 109.2 ; 10.7 ;2;32;78;0;2;0;2;2;0;0;1;1
5876; 21.2 ; 106.2 ; 6.1 ;5;5;267;0;5;1;4;1;4;5;0;0
5877; 30.1 ; 60.2 ; 22.6 ;2;172;131;0;2;1;1;0;2;1;1;0
5878; 42.4 ; 127.3 ; 30.5 ;3;56;101;0;3;1;2;1;2;1;1;1
5879; 34.5 ; 103.4 ; 3.9 ;3;116;78;2;1;0;3;2;1;0;3;0
5880; 92.6 ; 185.2 ; 20.8 ;2;38;38;2;0;2;0;2;0;0;0;2
5881; 29.0 ; 57.9 ; 1.5 ;2;31;326;0;2;0;2;2;0;1;1;0
5882; 15.0 ; 30.0 ; -   ;2;12;160;0;2;2;0;1;1;2;0;0
5883; 74.9 ; 149.8 ; 2.6 ;2;221;162;0;2;0;2;1;1;0;0;2
5884; 27.5 ; 109.9 ; 5.8 ;4;25;3;0;4;3;1;4;0;3;1;0
5885; 31.7 ; 444.5 ; 13.4 ;14;16;17;0;14;5;9;9;5;5;9;0
5886; 26.4 ; 184.9 ; 6.4 ;7;27;35;0;7;7;0;1;6;5;2;0
5887; 44.4 ; 177.6 ; 5.5 ;4;87;49;1;3;1;3;4;0;0;4;0
5888; 19.3 ; 38.6 ; -   ;2;5;68;0;2;0;2;2;0;2;0;0
5889; 40.6 ; 365.0 ; 30.2 ;9;24;146;0;9;0;9;8;1;3;3;3
5890; 50.4 ; 100.7 ; 4.3 ;2;32;47;0;2;0;2;2;0;0;2;0
5891; 36.8 ; 110.4 ; 17.8 ;3;164;52;0;3;0;3;3;0;1;2;0
5892; 46.8 ; 93.5 ; -   ;2;11;160;0;2;1;1;2;0;0;2;0
5893; 56.9 ; 625.4 ; 28.6 ;11;35;20;0;11;0;11;11;0;4;0;7
5894; 37.0 ; 740.2 ; 17.5 ;20;15;13;0;20;11;9;4;16;7;13;0
5895; 48.2 ; 771.1 ; 18.0 ;16;26;26;0;16;0;16;11;5;0;11;5
5896; 42.6 ; 894.1 ; 23.6 ;21;8;8;0;21;9;12;11;10;7;7;7
5897; 63.7 ; 318.6 ; 9.8 ;5;6;52;0;5;0;5;1;4;0;0;5
5898; 21.1 ; 63.3 ; 1.3 ;3;5;206;0;3;0;3;3;0;3;0;0
5899; 47.1 ; 94.2 ; 0.5 ;2;136;47;0;2;1;1;2;0;0;2;0
5900; 67.4 ; 337.2 ; 17.0 ;5;18;6;0;5;1;4;3;2;0;0;5
5901; 43.8 ; 87.6 ; 4.4 ;2;113;141;0;2;0;2;1;1;0;2;0
5902; 58.6 ; 234.5 ; 21.1 ;4;86;68;0;4;1;3;3;1;0;0;4
5903; 45.2 ; 135.6 ; 15.7 ;3;67;20;0;3;1;2;1;2;1;1;1
5904; 35.6 ; 71.2 ; 26.4 ;2;38;68;0;2;0;2;1;1;1;0;1
5905; 34.0 ; 67.9 ; 13.3 ;2;112;153;0;2;0;2;1;1;1;1;0
5906; 41.2 ; 123.5 ; 10.3 ;3;40;69;3;0;0;3;2;1;0;3;0
5907; 32.8 ; 360.3 ; 13.0 ;11;17;234;0;11;7;4;4;7;4;7;0
5908; 28.8 ; 661.8 ; 13.5 ;23;9;2;0;23;9;14;4;19;15;8;0
5909; 33.6 ; 268.9 ; 10.9 ;8;25;38;0;8;3;5;2;6;3;5;0
5910; 53.8 ; 107.7 ; 34.5 ;2;30;180;1;1;1;1;1;1;1;0;1
5911; 15.0 ; 30.0 ; -   ;2;3;127;0;2;1;1;1;1;2;0;0
5912; 53.2 ; 1,010.7 ; 25.3 ;19;17;31;0;19;3;16;16;3;6;7;6
5913; 33.6 ; 100.9 ; 6.7 ;3;70;149;0;3;3;0;1;2;1;2;0
5914; 28.7 ; 143.4 ; 14.3 ;5;12;209;1;4;0;5;4;1;3;2;0
5915; 30.7 ; 307.4 ; 8.6 ;10;23;88;0;10;4;6;3;7;3;7;0
5916; 44.9 ; 269.4 ; 6.9 ;6;31;5;0;6;0;6;1;5;0;6;0
5917; 35.6 ; 106.7 ; 27.1 ;3;119;68;0;3;0;3;1;2;1;1;1
5918; 15.0 ; 30.0 ; -   ;2;29;244;0;2;1;1;0;2;2;0;0
5919; 22.6 ; 45.2 ; 11.4 ;2;87;199;0;2;0;2;1;1;1;1;0
5920; 49.3 ; 345.1 ; 31.1 ;7;26;267;0;7;1;6;3;4;2;3;2
5921; 26.9 ; 322.9 ; 9.7 ;12;26;52;0;12;6;6;10;2;8;4;0
5922; 20.4 ; 142.9 ; 3.7 ;7;10;181;0;7;3;4;7;0;7;0;0
5923; 34.9 ; 139.7 ; 12.2 ;4;134;20;0;4;0;4;2;2;1;3;0
5924; 18.6 ; 37.2 ; -   ;2;5;393;0;2;1;1;1;1;2;0;0
5925; 53.9 ; 107.9 ; -   ;2;19;0;0;2;0;2;2;0;0;2;0
5926; 32.8 ; 262.6 ; 24.1 ;8;10;206;0;8;5;3;4;4;3;2;3
5927; 19.9 ; 39.8 ; 2.3 ;2;232;84;0;2;0;2;0;2;2;0;0
5928; 21.5 ; 64.4 ; 11.9 ;3;119;172;0;3;3;0;3;0;2;1;0
5929; 47.1 ; 94.2 ; 0.5 ;2;270;58;0;2;0;2;2;0;0;2;0
5930; 50.4 ; 403.4 ; 20.2 ;8;36;28;0;8;2;6;5;3;0;5;3
5931; 28.5 ; 228.2 ; 21.7 ;8;35;5;0;8;1;7;2;6;5;3;0
5932; 38.4 ; 76.7 ; 17.7 ;2;203;37;0;2;1;1;1;1;1;0;1
5933; 50.1 ; 150.2 ; 2.4 ;3;55;39;0;3;1;2;0;3;0;3;0
5934; 16.2 ; 113.7 ; 3.8 ;7;32;101;0;7;1;6;1;6;7;0;0
5935; 21.6 ; 64.8 ; 6.1 ;3;104;149;0;3;3;0;3;0;3;0;0
5936; 38.3 ; 191.7 ; 17.0 ;5;44;33;3;2;3;2;3;2;2;1;2
5937; 21.4 ; 150.0 ; 7.5 ;7;29;34;7;0;3;4;5;2;7;0;0
5938; 49.2 ; 492.2 ; 21.6 ;10;44;10;0;10;1;9;6;4;3;4;3
5939; 98.0 ; 588.0 ; 93.9 ;6;47;35;0;6;3;3;4;2;2;0;4
5940; 34.8 ; 139.2 ; 20.8 ;4;38;56;0;4;4;0;1;3;1;2;1
5941; 18.7 ; 74.6 ; 2.8 ;4;23;95;0;4;0;4;2;2;4;0;0
5942; 28.5 ; 85.4 ; 3.1 ;3;39;291;0;3;3;0;0;3;2;1;0
5943; 27.2 ; 599.3 ; 11.9 ;22;21;12;0;22;5;17;9;13;15;7;0
5944; 40.1 ; 80.1 ; 32.1 ;2;25;267;0;2;0;2;2;0;1;0;1
5945; 15.0 ; 45.0 ; -   ;3;23;114;0;3;2;1;1;2;3;0;0
5946; 34.2 ; 205.1 ; 12.6 ;6;32;107;0;6;3;3;1;5;2;4;0
5947; 37.8 ; 189.1 ; 16.1 ;5;44;239;0;5;3;2;5;0;2;3;0
5948; 47.7 ; 95.4 ; 1.4 ;2;1;251;0;2;0;2;1;1;0;2;0
5949; 30.0 ; 59.9 ; -   ;2;437;25;0;2;1;1;1;1;2;0;0
5950; 26.5 ; 105.9 ; 16.3 ;4;65;107;0;4;2;2;1;3;3;1;0
5951; 33.4 ; 100.3 ; 12.8 ;3;58;42;3;0;2;1;3;0;1;2;0
5952; 31.2 ; 436.7 ; 18.8 ;14;28;32;0;14;1;13;13;1;5;9;0
5953; 74.3 ; 148.7 ; -   ;2;100;53;0;2;0;2;2;0;0;0;2
5954; 36.2 ; 108.6 ; 11.4 ;3;25;46;0;3;1;2;1;2;1;2;0
5955; 21.0 ; 105.0 ; 6.1 ;5;45;5;0;5;0;5;4;1;5;0;0
5956; 33.1 ; 132.3 ; 10.5 ;4;74;94;0;4;0;4;2;2;1;3;0
5957; 32.5 ; 260.2 ; 11.9 ;8;36;112;2;6;4;4;2;6;3;5;0
5958; 38.7 ; 77.4 ; 13.1 ;2;76;9;0;2;1;1;2;0;1;1;0
5959; 38.8 ; 77.7 ; 12.9 ;2;2;85;0;2;1;1;1;1;1;1;0
5960; 33.4 ; 1,503.6 ; 23.1 ;45;7;16;0;45;16;29;17;28;15;15;15
5961; 28.0 ; 140.0 ; 13.2 ;5;15;22;0;5;0;5;3;2;3;2;0
5962; 55.7 ; 222.8 ; 12.8 ;4;10;105;0;4;2;2;2;2;0;0;4
5963; 51.5 ; 360.5 ; 12.6 ;7;24;138;0;7;4;3;0;7;0;5;2
5964; 37.6 ; 525.9 ; 11.0 ;14;17;1;0;14;2;12;12;2;5;9;0
5965; 42.9 ; 429.2 ; 13.6 ;10;30;1;0;10;1;9;6;4;3;4;3
5966; 15.0 ; 45.0 ; -   ;3;6;31;0;3;0;3;1;2;3;0;0
5967; 16.0 ; 48.0 ; 1.9 ;3;25;97;0;3;3;0;0;3;3;0;0
5968; 53.8 ; 268.8 ; 7.0 ;5;49;54;0;5;2;3;3;2;0;3;2
5969; 39.2 ; 509.0 ; 9.1 ;13;22;7;0;13;8;5;3;10;0;13;0
5970; 25.1 ; 50.1 ; -   ;2;55;85;0;2;0;2;1;1;2;0;0
5971; 21.5 ; 43.1 ; 9.8 ;2;4;75;2;0;1;1;0;2;1;1;0
5972; 22.5 ; 44.9 ; 11.2 ;2;5;160;0;2;2;0;0;2;1;1;0
5973; 70.1 ; 140.3 ; 35.0 ;2;8;110;0;2;1;1;1;1;0;0;2
5974; 65.1 ; 260.3 ; 24.0 ;4;111;5;0;4;2;2;3;1;0;0;4
5975; 43.4 ; 217.2 ; 7.8 ;5;53;107;0;5;3;2;2;3;0;5;0
5976; 26.7 ; 400.0 ; 12.5 ;15;25;26;0;15;6;9;4;11;10;5;0
5977; 23.6 ; 897.0 ; 8.6 ;38;8;4;0;38;11;27;22;16;25;13;0
5978; 37.7 ; 415.2 ; 20.5 ;11;25;11;0;11;5;6;5;6;4;3;4
5979; 50.5 ; 151.4 ; 23.7 ;3;90;68;0;3;1;2;2;1;1;1;1
5980; 46.8 ; 140.3 ; -   ;3;22;110;0;3;0;3;3;0;0;3;0
5981; 29.2 ; 116.9 ; 15.0 ;4;11;0;0;4;1;3;2;2;3;1;0
5982; 32.3 ; 64.5 ; 14.7 ;2;23;211;0;2;1;1;1;1;1;1;0
5983; 112.3 ; 224.7 ; 9.5 ;2;5;247;0;2;0;2;2;0;0;0;2
5984; 45.9 ; 779.9 ; 21.4 ;17;21;40;0;17;4;13;8;9;6;5;6
5985; 22.7 ; 339.8 ; 10.1 ;15;10;19;0;15;9;6;3;12;10;5;0
5986; 42.6 ; 383.1 ; 15.8 ;9;20;2;0;9;7;2;2;7;3;3;3
5987; 61.0 ; 183.0 ; 22.4 ;3;25;136;0;3;1;2;1;2;0;0;3
5988; 48.1 ; 240.7 ; 1.2 ;5;50;15;1;4;3;2;2;3;0;5;0
5989; 52.9 ; 105.8 ; 0.5 ;2;139;50;0;2;2;0;0;2;0;2;0
5990; 32.5 ; 97.6 ; 13.7 ;3;122;35;0;3;3;0;1;2;1;2;0
5991; 25.1 ; 100.3 ; -   ;4;39;32;0;4;1;3;2;2;4;0;0
5992; 49.8 ; 697.8 ; 18.1 ;14;17;10;0;14;3;11;10;4;0;9;5
5993; 32.5 ; 227.6 ; 11.3 ;7;36;133;0;7;6;1;4;3;2;5;0
5994; 73.9 ; 517.2 ; 21.0 ;7;41;7;1;6;3;4;0;7;0;0;7
5995; 25.3 ; 101.2 ; 16.6 ;4;116;5;0;4;2;2;3;1;3;1;0
5996; 40.4 ; 282.9 ; 21.3 ;7;27;34;0;7;2;5;4;3;2;3;2
5997; 45.9 ; 458.7 ; 34.1 ;10;20;99;0;10;2;8;6;4;3;4;3
5998; 97.4 ; 194.7 ; 5.8 ;2;37;231;0;2;0;2;1;1;0;0;2
5999; 71.2 ; 142.5 ; 30.3 ;2;15;250;0;2;1;1;2;0;0;0;2
6000; 30.2 ; 211.2 ; 13.7 ;7;38;101;0;7;1;6;6;1;2;5;0
6001; 20.0 ; 40.1 ; 7.6 ;2;26;10;2;0;0;2;0;2;2;0;0
6002; 28.4 ; 199.1 ; 11.9 ;7;19;105;0;7;0;7;6;1;5;2;0
6003; 26.3 ; 551.7 ; 9.5 ;21;14;2;0;21;13;8;15;6;14;7;0
6004; 40.0 ; 200.2 ; 25.1 ;5;2;269;0;5;5;0;1;4;2;1;2
6005; 18.8 ; 206.3 ; 6.0 ;11;4;254;0;11;9;2;5;6;11;0;0
6006; 43.1 ; 129.3 ; 16.0 ;3;18;86;0;3;2;1;2;1;1;1;1
6007; 46.8 ; 93.5 ; -   ;2;30;184;0;2;0;2;2;0;0;2;0
6008; 34.7 ; 208.4 ; 19.8 ;6;8;1;0;6;2;4;0;6;2;4;0
6009; 26.1 ; 130.6 ; 15.9 ;5;35;101;0;5;3;2;3;2;3;2;0
6010; 19.3 ; 96.7 ; 6.2 ;5;72;5;0;5;0;5;4;1;5;0;0
6011; 87.1 ; 1,220.0 ; 19.0 ;14;18;147;0;14;0;14;7;7;0;0;14
6012; 42.1 ; 126.4 ; 11.0 ;3;67;76;0;3;1;2;3;0;0;3;0
6013; 25.1 ; 50.1 ; -   ;2;57;50;0;2;2;0;2;0;2;0;0
6014; 23.6 ; 212.8 ; 15.0 ;9;25;73;0;9;4;5;3;6;6;3;0
6015; 30.5 ; 182.8 ; 12.9 ;6;23;167;0;6;0;6;3;3;2;4;0
6016; 56.5 ; 169.4 ; 28.8 ;3;76;26;0;3;0;3;2;1;1;0;2
6017; 31.2 ; 62.3 ; 16.0 ;2;12;257;0;2;1;1;1;1;1;1;0
6018; 22.6 ; 611.2 ; 10.8 ;27;10;2;0;27;16;11;13;14;18;9;0
6019; 25.7 ; 128.6 ; 8.4 ;5;54;26;0;5;3;2;0;5;3;2;0
6020; 41.4 ; 82.7 ; 16.7 ;2;120;173;0;2;0;2;2;0;1;0;1
6021; 51.1 ; 664.7 ; 58.2 ;13;11;270;0;13;13;0;12;1;4;5;4
6022; 20.0 ; 80.1 ; 0.8 ;4;16;238;0;4;2;2;1;3;4;0;0
6023; 30.4 ; 425.4 ; 8.4 ;14;23;6;0;14;6;8;12;2;5;9;0
6024; 36.0 ; 72.0 ; 26.9 ;2;157;5;0;2;0;2;2;0;1;0;1
6025; 43.1 ; 215.3 ; 16.6 ;5;45;21;0;5;4;1;2;3;2;1;2
6026; 15.0 ; 329.7 ; -   ;22;18;0;0;22;12;10;2;20;22;0;0
6027; 38.7 ; 348.5 ; 10.0 ;9;15;152;0;9;3;6;7;2;3;6;0
6028; 16.6 ; 631.1 ; 4.1 ;38;7;18;0;38;26;12;29;9;38;0;0
6029; 19.8 ; 59.5 ; 7.6 ;3;43;89;0;3;2;1;1;2;3;0;0
6030; 29.0 ; 57.9 ; 14.5 ;2;23;29;1;1;2;0;2;0;1;1;0
6031; 33.2 ; 265.6 ; 16.2 ;8;39;22;0;8;5;3;5;3;3;5;0
6032; 15.0 ; 74.9 ; -   ;5;38;24;0;5;5;0;4;1;5;0;0
6033; 44.4 ; 310.6 ; 12.7 ;7;38;61;0;7;4;3;5;2;0;5;2
6034; 48.8 ; 97.5 ; 1.9 ;2;32;0;0;2;0;2;1;1;0;2;0
6035; 38.2 ; 76.4 ; 12.3 ;2;5;45;0;2;2;0;2;0;1;1;0
6036; 25.1 ; 653.5 ; 9.8 ;26;11;13;0;26;14;12;11;15;17;9;0
6037; 21.3 ; 106.5 ; 13.5 ;5;57;5;1;4;1;4;2;3;3;2;0
6038; 43.8 ; 263.0 ; 14.7 ;6;11;62;0;6;6;0;0;6;2;2;2
6039; 39.8 ; 119.3 ; 13.5 ;3;58;76;0;3;1;2;3;0;1;2;0
6040; 20.9 ; 62.7 ; 4.3 ;3;11;250;0;3;2;1;2;1;3;0;0
6041; 21.1 ; 126.7 ; 12.1 ;6;8;236;0;6;0;6;4;2;4;2;0
6042; 27.6 ; 662.0 ; 9.3 ;24;12;5;0;24;7;17;5;19;16;8;0
6043; 18.6 ; 55.7 ; -   ;3;27;12;0;3;1;2;1;2;3;0;0
6044; 19.1 ; 381.5 ; 7.3 ;20;17;5;3;17;10;10;10;10;20;0;0
6045; 26.4 ; 131.8 ; 12.1 ;5;60;61;0;5;1;4;3;2;3;2;0
6046; 15.0 ; 45.0 ; -   ;3;21;17;3;0;1;2;1;2;3;0;0
6047; 57.1 ; 228.3 ; 20.0 ;4;21;100;4;0;0;4;2;2;0;0;4
6048; 53.7 ; 107.3 ; 15.2 ;2;23;210;0;2;1;1;1;1;0;1;1
6049; 61.7 ; 185.1 ; 4.8 ;3;121;5;0;3;1;2;2;1;0;0;3
6050; 22.2 ; 66.6 ; 6.7 ;3;70;11;0;3;2;1;1;2;3;0;0
6051; 37.7 ; 1,205.2 ; 18.9 ;32;9;0;0;32;3;29;14;18;11;10;11
6052; 25.1 ; 50.1 ; -   ;2;95;99;0;2;0;2;2;0;2;0;0
6053; 46.8 ; 93.5 ; -   ;2;18;137;0;2;0;2;2;0;0;2;0
6054; 64.6 ; 516.5 ; 42.8 ;8;20;93;0;8;4;4;3;5;3;0;5
6055; 22.5 ; 179.7 ; 15.9 ;8;39;8;0;8;4;4;6;2;5;3;0
6056; 29.0 ; 376.8 ; 21.4 ;13;33;0;0;13;2;11;10;3;9;4;0
6057; 30.5 ; 457.5 ; 12.4 ;15;8;49;0;15;5;10;7;8;5;10;0
6058; 26.8 ; 241.0 ; 10.0 ;9;18;91;0;9;4;5;5;4;6;3;0
6059; 44.9 ; 404.5 ; 15.3 ;9;32;31;0;9;1;8;7;2;3;3;3
6060; 31.2 ; 218.4 ; 29.2 ;7;38;150;0;7;4;3;5;2;2;3;2
6061; 24.9 ; 124.5 ; 9.7 ;5;27;26;0;5;0;5;2;3;3;2;0
6062; 52.5 ; 157.5 ; -   ;3;40;113;0;3;2;1;1;2;0;3;0
6063; 17.9 ; 197.3 ; 5.8 ;11;33;46;0;11;9;2;10;1;11;0;0
6064; 35.7 ; 107.1 ; 12.3 ;3;113;35;0;3;2;1;1;2;1;2;0
6065; 35.3 ; 105.8 ; 11.6 ;3;58;78;0;3;1;2;1;2;1;2;0
6066; 44.9 ; 179.5 ; 7.4 ;4;67;79;0;4;0;4;3;1;0;4;0
6067; 21.4 ; 107.0 ; 3.2 ;5;21;182;0;5;2;3;2;3;5;0;0
6068; 24.1 ; 120.5 ; 8.8 ;5;22;132;0;5;3;2;3;2;3;2;0
6069; 16.7 ; 83.3 ; 4.4 ;5;60;21;0;5;0;5;1;4;5;0;0
6070; 23.3 ; 349.1 ; 9.4 ;15;23;2;0;15;12;3;8;7;10;5;0
6071; 38.5 ; 809.1 ; 11.8 ;21;19;4;0;21;9;12;10;11;7;14;0
6072; 28.1 ; 506.6 ; 11.0 ;18;16;56;0;18;5;13;17;1;12;6;0
6073; 40.7 ; 122.1 ; 12.4 ;3;92;199;0;3;1;2;2;1;1;2;0
6074; 41.9 ; 251.4 ; 31.1 ;6;50;5;0;6;0;6;5;1;2;2;2
6075; 20.0 ; 40.1 ; 7.6 ;2;157;116;0;2;0;2;2;0;2;0;0
6076; 26.1 ; 130.7 ; -   ;5;37;7;0;5;3;2;1;4;5;0;0
6077; 28.6 ; 629.6 ; 19.2 ;22;13;0;0;22;7;15;12;10;15;7;0
6078; 39.7 ; 119.1 ; 3.7 ;3;34;194;0;3;0;3;3;0;0;3;0
6079; 19.6 ; 98.2 ; 6.6 ;5;3;279;0;5;1;4;3;2;5;0;0
6080; 52.9 ; 528.9 ; 9.6 ;10;23;8;0;10;5;5;6;4;0;7;3
6081; 17.1 ; 51.2 ; -   ;3;9;41;0;3;0;3;1;2;3;0;0
6082; 30.8 ; 61.7 ; 8.6 ;2;11;135;2;0;2;0;0;2;1;1;0
6083; 60.4 ; 120.7 ; 19.3 ;2;6;94;0;2;0;2;2;0;0;0;2
6084; 24.0 ; 120.1 ; 9.1 ;5;5;241;0;5;3;2;2;3;3;2;0
6085; 62.6 ; 187.7 ; 28.4 ;3;107;99;1;2;0;3;3;0;0;0;3
6086; 31.5 ; 315.3 ; 11.8 ;10;29;24;0;10;4;6;2;8;3;7;0
6087; 32.0 ; 224.2 ; 8.9 ;7;34;36;0;7;0;7;5;2;2;5;0
6088; 29.2 ; 350.5 ; 13.7 ;12;14;142;0;12;6;6;12;0;8;4;0
6089; 49.6 ; 99.3 ; 4.3 ;2;100;131;0;2;0;2;2;0;0;2;0
6090; 30.4 ; 121.7 ; 32.7 ;4;15;237;0;4;2;2;4;0;1;2;1
6091; 21.5 ; 42.9 ; 7.6 ;2;6;5;0;2;0;2;2;0;2;0;0
6092; 46.8 ; 93.5 ; -   ;2;13;157;0;2;0;2;1;1;0;2;0
6093; 55.9 ; 279.7 ; 19.2 ;5;32;42;0;5;1;4;2;3;0;0;5
6094; 31.8 ; 63.6 ; 25.2 ;2;11;117;0;2;1;1;0;2;1;0;1
6095; 42.3 ; 126.8 ; 5.5 ;3;13;165;0;3;2;1;1;2;0;3;0
6096; 27.1 ; 54.2 ; -   ;2;46;119;0;2;1;1;1;1;2;0;0
6097; 36.4 ; 363.7 ; 14.6 ;10;23;80;0;10;6;4;4;6;3;7;0
6098; 50.5 ; 151.6 ; 4.6 ;3;63;147;0;3;0;3;2;1;0;2;1
6099; 24.3 ; 243.0 ; 6.9 ;10;34;12;0;10;4;6;7;3;7;3;0
6100; 44.3 ; 177.3 ; 24.1 ;4;10;5;0;4;1;3;1;3;1;2;1
6101; 17.1 ; 34.2 ; 3.2 ;2;21;246;0;2;0;2;1;1;2;0;0
6102; 36.4 ; 109.3 ; 19.9 ;3;65;169;0;3;0;3;2;1;1;1;1
6103; 18.0 ; 36.0 ; -   ;2;6;89;0;2;0;2;1;1;2;0;0
6104; 58.7 ; 117.4 ; 10.4 ;2;44;68;1;1;0;2;2;0;0;0;2
6105; 34.9 ; 209.3 ; 8.4 ;6;30;80;0;6;2;4;1;5;2;4;0
6106; 26.3 ; 105.2 ; 10.9 ;4;19;52;0;4;1;3;3;1;3;1;0
6107; 31.3 ; 501.0 ; 14.7 ;16;14;17;0;16;7;9;3;13;5;11;0
6108; 21.6 ; 151.2 ; 5.9 ;7;21;34;0;7;5;2;2;5;7;0;0
6109; 60.2 ; 180.6 ; 31.8 ;3;126;99;0;3;0;3;3;0;1;0;2
6110; 30.0 ; 659.2 ; 11.5 ;22;14;1;0;22;4;18;12;10;15;7;0
6111; 45.3 ; 181.1 ; 3.1 ;4;33;119;4;0;4;0;1;3;0;4;0
6112; 35.9 ; 71.8 ; 17.4 ;2;197;99;0;2;1;1;1;1;1;1;0
6113; 29.9 ; 149.5 ; 10.4 ;5;43;131;0;5;3;2;2;3;3;2;0
6114; 56.8 ; 2,839.9 ; 30.6 ;50;6;2;0;50;34;16;29;21;17;0;33
6115; 32.0 ; 128.1 ; 18.9 ;4;17;215;0;4;2;2;2;2;1;3;0
6116; 36.8 ; 221.0 ; 8.8 ;6;38;56;0;6;2;4;3;3;2;4;0
6117; 19.2 ; 134.2 ; 7.3 ;7;34;25;0;7;1;6;4;3;7;0;0
6118; 44.6 ; 133.7 ; 22.3 ;3;149;13;0;3;2;1;0;3;1;1;1
6119; 76.6 ; 153.2 ; 4.1 ;2;52;180;0;2;2;0;0;2;0;0;2
6120; 30.5 ; 122.2 ; 20.6 ;4;7;202;0;4;2;2;2;2;1;3;0
6121; 15.4 ; 261.8 ; 1.2 ;17;14;3;0;17;12;5;8;9;17;0;0
6122; 27.4 ; 109.4 ; 4.7 ;4;87;16;0;4;0;4;2;2;3;1;0
6123; 114.6 ; 573.0 ; 65.2 ;5;42;162;0;5;0;5;5;0;0;0;5
6124; 56.5 ; 338.8 ; 19.0 ;6;24;53;6;0;0;6;6;0;0;0;6
6125; 18.5 ; 55.5 ; 0.7 ;3;12;14;0;3;2;1;1;2;3;0;0
6126; 51.1 ; 153.4 ; 3.8 ;3;31;20;3;0;0;3;1;2;0;3;0
6127; 35.7 ; 285.7 ; 13.9 ;8;39;16;0;8;3;5;5;3;3;5;0
6128; 82.0 ; 1,886.6 ; 55.7 ;23;18;8;0;23;10;13;7;16;8;0;15
6129; 46.6 ; 93.2 ; 0.2 ;2;7;389;0;2;1;1;2;0;0;2;0
6130; 146.8 ; 440.5 ; 123.7 ;3;104;83;0;3;1;2;3;0;1;0;2
6131; 67.3 ; 269.3 ; 17.0 ;4;73;83;0;4;2;2;4;0;0;0;4
6132; 52.5 ; 105.0 ; -   ;2;43;362;0;2;0;2;1;1;0;2;0
6133; 52.6 ; 737.1 ; 40.8 ;14;23;11;0;14;4;10;5;9;5;4;5
6134; 42.0 ; 210.0 ; 19.7 ;5;67;33;0;5;1;4;2;3;2;1;2
6135; 31.2 ; 218.4 ; 25.0 ;7;12;287;0;7;4;3;7;0;2;3;2
6136; 15.8 ; 253.1 ; 1.6 ;16;15;54;0;16;13;3;7;9;16;0;0
6137; 47.0 ; 234.9 ; 20.7 ;5;27;184;0;5;2;3;3;2;2;1;2
6138; 62.7 ; 188.0 ; 18.2 ;3;45;99;0;3;1;2;0;3;0;0;3
6139; 56.8 ; 340.8 ; 26.7 ;6;33;32;0;6;0;6;5;1;0;0;6
6140; 51.8 ; 103.6 ; 6.5 ;2;78;83;0;2;1;1;2;0;0;1;1
6141; 22.3 ; 445.1 ; 10.2 ;20;6;37;0;20;1;19;8;12;13;7;0
6142; 36.8 ; 147.1 ; 4.7 ;4;101;21;0;4;1;3;2;2;0;4;0
6143; 65.1 ; 130.2 ; 8.6 ;2;34;250;0;2;1;1;2;0;0;0;2
6144; 24.5 ; 122.6 ; 12.8 ;5;27;194;0;5;0;5;3;2;3;2;0
6145; 50.4 ; 100.7 ; 3.2 ;2;209;5;0;2;0;2;2;0;0;2;0
6146; 34.0 ; 68.0 ; -   ;2;37;231;0;2;0;2;1;1;0;2;0
6147; 322.1 ; 644.3 ; 33.7 ;2;5;38;2;0;0;2;2;0;0;0;2
6148; 93.5 ; 467.5 ; 47.9 ;5;45;105;0;5;0;5;4;1;0;0;5
6149; 25.8 ; 51.6 ; 16.2 ;2;239;73;0;2;0;2;1;1;1;1;0
6150; 29.5 ; 413.6 ; 17.8 ;14;23;9;0;14;2;12;11;3;9;5;0
6151; 48.2 ; 144.5 ; 2.6 ;3;31;189;0;3;0;3;3;0;0;3;0
6152; 43.1 ; 215.5 ; 0.4 ;5;22;53;0;5;3;2;1;4;0;5;0
6153; 65.2 ; 260.9 ; 48.3 ;4;63;62;0;4;0;4;4;0;1;0;3
6154; 19.2 ; 403.6 ; 5.5 ;21;13;11;0;21;16;5;21;0;21;0;0
6155; 60.7 ; 121.4 ; 20.9 ;2;47;229;0;2;1;1;1;1;0;0;2
6156; 57.0 ; 114.0 ; 10.1 ;2;111;2;0;2;1;1;1;1;0;0;2
6157; 31.6 ; 63.2 ; 24.9 ;2;10;7;0;2;1;1;1;1;1;0;1
6158; 22.5 ; 44.9 ; 11.2 ;2;11;381;0;2;2;0;0;2;1;1;0
6159; 46.8 ; 93.5 ; -   ;2;183;110;0;2;0;2;2;0;0;2;0
6160; 19.3 ; 96.5 ; 10.2 ;5;6;26;0;5;2;3;2;3;5;0;0
6161; 39.7 ; 79.5 ; 4.7 ;2;28;242;0;2;1;1;2;0;0;2;0
6162; 36.3 ; 290.0 ; 7.4 ;8;24;119;1;7;3;5;2;6;3;5;0
6163; 114.8 ; 229.5 ; 114.6 ;2;19;248;0;2;1;1;1;1;1;0;1
6164; 43.6 ; 87.2 ; 12.2 ;2;76;93;0;2;1;1;2;0;0;1;1
6165; 67.0 ; 133.9 ; 27.5 ;2;140;14;0;2;2;0;0;2;0;0;2
6166; 27.6 ; 110.4 ; 7.8 ;4;114;40;0;4;2;2;2;2;3;1;0
6167; 55.4 ; 110.9 ; 9.1 ;2;80;69;2;0;0;2;2;0;0;0;2
6168; 32.8 ; 98.3 ; 7.0 ;3;45;53;0;3;1;2;1;2;1;2;0
6169; 20.0 ; 40.1 ; 7.6 ;2;2;314;0;2;1;1;1;1;2;0;0
6170; 43.5 ; 87.0 ; 20.0 ;2;19;65;2;0;2;0;0;2;1;0;1
6171; 38.0 ; 75.9 ; 34.4 ;2;55;233;0;2;1;1;0;2;1;0;1
6172; 44.2 ; 88.3 ; 26.3 ;2;6;104;0;2;0;2;2;0;1;0;1
6173; 47.4 ; 142.1 ; 1.1 ;3;81;131;0;3;2;1;1;2;0;3;0
6174; 77.0 ; 1,154.8 ; 23.9 ;15;27;10;0;15;4;11;8;7;0;0;15
6175; 42.0 ; 84.1 ; 8.1 ;2;19;40;2;0;2;0;1;1;0;2;0
6176; 44.4 ; 88.9 ; 11.8 ;2;7;257;0;2;0;2;1;1;0;1;1
6177; 32.8 ; 459.0 ; 6.1 ;14;17;69;0;14;6;8;8;6;5;9;0
6178; 41.9 ; 167.5 ; 24.7 ;4;79;105;0;4;0;4;2;2;1;2;1
6179; 35.5 ; 71.0 ; 1.6 ;2;42;200;0;2;0;2;0;2;0;2;0
6180; 40.8 ; 285.4 ; 6.8 ;7;17;22;0;7;3;4;1;6;0;7;0
6181; 46.8 ; 93.5 ; -   ;2;20;173;0;2;0;2;2;0;0;2;0
6182; 85.6 ; 171.2 ; 82.9 ;2;1;257;0;2;0;2;1;1;1;0;1
6183; 19.3 ; 57.9 ; 5.5 ;3;47;272;0;3;0;3;1;2;3;0;0
6184; 20.8 ; 270.6 ; 9.3 ;13;14;5;0;13;9;4;2;11;9;4;0
6185; 33.3 ; 99.9 ; 12.4 ;3;106;80;0;3;1;2;1;2;1;2;0
6186; 29.4 ; 117.4 ; 8.9 ;4;54;14;0;4;3;1;1;3;3;1;0
6187; 27.6 ; 110.6 ; 18.1 ;4;13;139;0;4;4;0;2;2;3;1;0
6188; 35.7 ; 107.1 ; 10.1 ;3;34;108;0;3;3;0;0;3;1;2;0
6189; 30.9 ; 123.6 ; 17.2 ;4;16;306;0;4;1;3;3;1;1;3;0
6190; 18.6 ; 37.2 ; -   ;2;6;357;0;2;0;2;0;2;2;0;0
6191; 47.5 ; 189.9 ; 0.6 ;4;41;11;0;4;0;4;2;2;0;4;0
6192; 18.3 ; 55.0 ; 6.2 ;3;5;239;0;3;1;2;2;1;3;0;0
6193; 17.4 ; 52.1 ; 2.2 ;3;34;15;2;1;0;3;3;0;3;0;0
6194; 62.5 ; 187.6 ; 30.5 ;3;164;110;0;3;0;3;3;0;0;0;3
6195; 26.0 ; 129.9 ; 14.1 ;5;58;8;0;5;3;2;3;2;3;2;0
6196; 27.1 ; 947.5 ; 18.9 ;35;11;10;0;35;16;19;29;6;23;12;0
6197; 95.6 ; 191.2 ; 41.1 ;2;28;158;0;2;1;1;0;2;0;0;2
6198; 35.1 ; 70.2 ; 7.4 ;2;30;113;2;0;2;0;0;2;1;1;0
6199; 52.2 ; 522.0 ; 26.9 ;10;28;10;5;5;0;10;6;4;3;4;3
6200; 46.9 ; 93.9 ; 6.1 ;2;7;206;0;2;1;1;2;0;0;2;0
6201; 24.4 ; 121.8 ; 6.7 ;5;18;296;0;5;1;4;2;3;3;2;0
6202; 32.2 ; 96.5 ; 19.5 ;3;34;152;0;3;0;3;1;2;1;2;0
6203; 18.4 ; 903.8 ; 5.7 ;49;7;5;0;49;29;20;37;12;49;0;0
6204; 76.2 ; 1,296.0 ; 32.9 ;17;12;7;0;17;4;13;2;15;0;0;17
6205; 37.5 ; 2,250.6 ; 11.3 ;60;7;5;0;60;23;37;29;31;20;40;0
6206; 16.1 ; 32.1 ; 1.6 ;2;149;138;0;2;1;1;1;1;2;0;0
6207; 84.4 ; 337.6 ; 23.7 ;4;21;73;0;4;1;3;3;1;0;0;4
6208; 34.2 ; 68.4 ; 21.7 ;2;41;242;0;2;1;1;1;1;1;0;1
6209; 52.1 ; 208.5 ; 1.0 ;4;49;78;1;3;0;4;4;0;0;4;0
6210; 57.5 ; 115.0 ; 2.1 ;2;18;104;0;2;0;2;2;0;0;0;2
6211; 30.2 ; 60.4 ; -   ;2;126;104;0;2;0;2;0;2;0;2;0
6212; 81.3 ; 975.1 ; 41.6 ;12;24;21;0;12;2;10;1;11;0;0;12
6213; 24.5 ; 73.4 ; 3.1 ;3;22;215;0;3;0;3;1;2;3;0;0
6214; 47.0 ; 141.0 ; 0.4 ;3;103;74;0;3;1;2;3;0;0;3;0
6215; 24.9 ; 99.6 ; 5.5 ;4;39;35;0;4;4;0;3;1;3;1;0
6216; 45.9 ; 183.5 ; 6.8 ;4;88;73;0;4;1;3;1;3;0;4;0
6217; 21.7 ; 65.1 ; 6.2 ;3;71;177;0;3;2;1;1;2;3;0;0
6218; 39.3 ; 78.6 ; 36.4 ;2;56;348;0;2;2;0;1;1;1;0;1
6219; 50.3 ; 100.6 ; 1.1 ;2;32;199;0;2;0;2;2;0;0;2;0
6220; 20.0 ; 40.0 ; 7.5 ;2;11;266;0;2;2;0;1;1;2;0;0
6221; 50.6 ; 101.2 ; 2.9 ;2;207;99;0;2;0;2;0;2;0;2;0
6222; 52.8 ; 105.7 ; 8.0 ;2;32;31;0;2;0;2;2;0;0;1;1
6223; 37.3 ; 74.7 ; 28.1 ;2;228;22;0;2;1;1;0;2;1;0;1
6224; 15.3 ; 337.0 ; 1.2 ;22;9;17;0;22;13;9;7;15;22;0;0
6225; 24.7 ; 99.0 ; 18.6 ;4;31;89;0;4;2;2;1;3;3;1;0
6226; 45.1 ; 135.2 ; 14.6 ;3;5;257;0;3;0;3;3;0;0;2;1
6227; 24.1 ; 698.6 ; 18.2 ;29;9;5;0;29;1;28;29;0;19;10;0
6228; 33.4 ; 100.1 ; 12.4 ;3;157;0;0;3;2;1;1;2;1;2;0
6229; 38.7 ; 116.2 ; 12.6 ;3;7;238;0;3;2;1;1;2;1;2;0
6230; 51.3 ; 102.6 ; 2.9 ;2;50;41;1;1;2;0;1;1;0;2;0
6231; 80.2 ; 320.9 ; 1.8 ;4;30;199;0;4;0;4;2;2;0;0;4
6232; 58.7 ; 1,349.1 ; 15.6 ;23;7;141;0;23;8;15;14;9;0;0;23
6233; 50.6 ; 202.3 ; 14.1 ;4;20;167;0;4;2;2;1;3;0;3;1
6234; 53.2 ; 106.5 ; 6.9 ;2;16;127;2;0;1;1;2;0;0;1;1
6235; 37.5 ; 150.0 ; 9.1 ;4;24;290;0;4;2;2;3;1;1;3;0
6236; 27.2 ; 136.1 ; 17.7 ;5;13;212;0;5;3;2;4;1;3;2;0
6237; 19.1 ; 38.3 ; 0.8 ;2;6;296;0;2;2;0;2;0;2;0;0
6238; 81.1 ; 162.1 ; 42.8 ;2;72;204;0;2;1;1;1;1;0;0;2
6239; 35.5 ; 71.0 ; 21.1 ;2;29;226;0;2;1;1;1;1;1;0;1
6240; 21.3 ; 42.7 ; 0.4 ;2;31;106;0;2;0;2;2;0;2;0;0
6241; 19.3 ; 57.9 ; -   ;3;85;20;0;3;1;2;2;1;3;0;0
6242; 29.1 ; 87.2 ; 1.7 ;3;49;75;0;3;1;2;2;1;2;1;0
6243; 71.9 ; 215.8 ; 86.4 ;3;169;10;0;3;1;2;2;1;1;0;2
6244; 48.7 ; 292.0 ; 1.0 ;6;24;32;0;6;0;6;5;1;0;6;0
6245; 63.0 ; 125.9 ; 4.5 ;2;82;204;0;2;0;2;1;1;0;0;2
6246; 15.0 ; 269.7 ; -   ;18;13;9;0;18;12;6;4;14;18;0;0
6247; 77.6 ; 465.8 ; 18.4 ;6;31;0;0;6;0;6;6;0;0;0;6
6248; 20.2 ; 101.0 ; 2.3 ;5;30;228;0;5;5;0;5;0;5;0;0
6249; 59.8 ; 299.2 ; 19.9 ;5;15;219;0;5;4;1;2;3;0;0;5
6250; 53.1 ; 265.4 ; 23.6 ;5;41;252;0;5;1;4;1;4;2;1;2
6251; 78.1 ; 234.2 ; 29.0 ;3;22;3;0;3;3;0;1;2;0;0;3
6252; 15.0 ; 45.0 ; -   ;3;31;110;0;3;1;2;3;0;3;0;0
6253; 46.9 ; 140.8 ; 3.8 ;3;20;77;0;3;2;1;2;1;0;3;0
6254; 79.6 ; 557.1 ; 26.5 ;7;41;110;0;7;0;7;5;2;0;0;7
6255; 33.3 ; 66.6 ; 22.0 ;2;41;86;1;1;1;1;1;1;1;0;1
6256; 55.8 ; 279.1 ; 25.7 ;5;18;320;0;5;3;2;3;2;0;0;5
6257; 53.4 ; 160.3 ; 24.8 ;3;150;22;0;3;0;3;3;0;1;1;1
6258; 35.3 ; 176.3 ; 9.8 ;5;34;22;0;5;1;4;1;4;2;3;0
6259; 60.2 ; 120.4 ; 3.0 ;2;57;18;0;2;2;0;0;2;0;0;2
6260; 32.8 ; 98.3 ; 17.4 ;3;38;2;3;0;3;0;3;0;1;2;0
6261; 21.3 ; 361.5 ; 12.1 ;17;19;66;0;17;0;17;13;4;11;6;0
6262; 19.2 ; 76.9 ; 3.2 ;4;19;139;4;0;4;0;4;0;4;0;0
6263; 57.8 ; 289.1 ; 14.2 ;5;68;26;0;5;1;4;3;2;0;0;5
6264; 35.4 ; 177.1 ; 22.7 ;5;22;99;0;5;1;4;1;4;2;1;2
6265; 50.5 ; 101.1 ; 10.4 ;2;4;53;0;2;0;2;0;2;0;1;1
6266; 57.6 ; 288.0 ; 20.8 ;5;24;14;0;5;2;3;3;2;0;0;5
6267; 25.1 ; 150.7 ; 17.2 ;6;12;48;0;6;1;5;6;0;4;2;0
6268; 60.8 ; 121.6 ; 18.1 ;2;19;90;0;2;0;2;0;2;0;0;2
6269; 65.1 ; 325.6 ; 6.5 ;5;45;79;0;5;0;5;3;2;0;0;5
6270; 15.4 ; 30.8 ; 0.6 ;2;32;30;2;0;2;0;2;0;2;0;0
6271; 21.9 ; 175.4 ; 7.0 ;8;35;16;0;8;3;5;1;7;8;0;0
6272; 27.6 ; 110.5 ; 3.1 ;4;66;236;0;4;1;3;1;3;3;1;0
6273; 16.8 ; 33.6 ; 2.7 ;2;14;134;0;2;2;0;2;0;2;0;0
6274; 21.4 ; 85.7 ; 5.9 ;4;29;69;0;4;0;4;4;0;4;0;0
6275; 53.0 ; 794.3 ; 17.0 ;15;18;7;0;15;5;10;3;12;0;10;5
6276; 41.1 ; 164.5 ; 11.1 ;4;36;112;4;0;4;0;1;3;1;3;0
6277; 37.9 ; 189.6 ; 10.5 ;5;50;98;0;5;2;3;2;3;2;3;0
6278; 46.8 ; 93.5 ; -   ;2;57;320;0;2;0;2;1;1;0;2;0
6279; 42.3 ; 169.3 ; 16.2 ;4;80;94;0;4;0;4;3;1;1;2;1
6280; 48.5 ; 242.5 ; 0.9 ;5;15;10;0;5;1;4;3;2;0;5;0
6281; 47.2 ; 141.7 ; 0.4 ;3;18;89;0;3;2;1;3;0;0;3;0
6282; 65.4 ; 196.1 ; 17.4 ;3;21;244;0;3;2;1;1;2;0;0;3
6283; 39.8 ; 79.6 ; 12.6 ;2;58;20;0;2;0;2;2;0;1;1;0
6284; 46.1 ; 230.4 ; 20.7 ;5;5;244;0;5;4;1;3;2;2;1;2
6285; 45.2 ; 180.8 ; 18.2 ;4;40;29;0;4;3;1;1;3;1;2;1
6286; 47.0 ; 94.1 ; 6.3 ;2;11;126;0;2;0;2;2;0;0;2;0
6287; 80.2 ; 401.2 ; 46.2 ;5;59;84;0;5;3;2;2;3;0;0;5
6288; 46.1 ; 230.5 ; 31.1 ;5;34;26;0;5;2;3;3;2;2;1;2
6289; 32.4 ; 161.8 ; 7.7 ;5;14;138;0;5;3;2;3;2;2;3;0
6290; 25.1 ; 75.2 ; -   ;3;78;113;0;3;2;1;1;2;3;0;0
6291; 39.5 ; 118.6 ; 13.3 ;3;14;257;0;3;1;2;1;2;1;2;0
6292; 44.7 ; 134.1 ; 9.9 ;3;19;248;0;3;0;3;1;2;0;3;0
6293; 51.4 ; 256.8 ; 19.8 ;5;20;76;0;5;2;3;2;3;0;3;2
6294; 47.5 ; 854.2 ; 11.1 ;18;10;11;0;18;3;15;4;14;0;12;6
6295; 21.6 ; 237.2 ; 3.1 ;11;9;31;0;11;3;8;9;2;11;0;0
6296; 46.8 ; 93.5 ; -   ;2;104;163;0;2;1;1;0;2;0;2;0
6297; 85.3 ; 170.5 ; 42.6 ;2;52;50;0;2;2;0;1;1;0;0;2
6298; 115.7 ; 347.0 ; 80.7 ;3;65;248;0;3;0;3;3;0;0;0;3
6299; 42.2 ; 633.4 ; 5.8 ;15;15;53;0;15;4;11;6;9;0;15;0
6300; 38.8 ; 77.7 ; 12.9 ;2;233;63;1;1;0;2;1;1;1;1;0
6301; 49.3 ; 98.7 ; -   ;2;6;59;0;2;0;2;2;0;0;2;0
6302; 38.9 ; 155.6 ; 15.9 ;4;8;247;0;4;2;2;2;2;1;3;0
6303; 37.5 ; 112.5 ; 20.7 ;3;18;21;2;1;0;3;3;0;1;1;1
6304; 33.2 ; 166.0 ; 7.0 ;5;19;113;0;5;4;1;0;5;2;3;0
6305; 50.6 ; 151.7 ; 7.0 ;3;73;99;0;3;1;2;3;0;0;2;1
6306; 78.0 ; 233.9 ; 46.2 ;3;14;5;0;3;1;2;2;1;0;0;3
6307; 54.6 ; 163.7 ; 26.2 ;3;13;77;0;3;1;2;3;0;1;1;1
6308; 105.0 ; 210.1 ; 4.3 ;2;3;11;2;0;1;1;0;2;0;0;2
6309; 40.2 ; 160.9 ; 12.6 ;4;4;89;0;4;2;2;1;3;1;3;0
6310; 19.1 ; 133.4 ; 7.2 ;7;32;1;0;7;3;4;7;0;7;0;0
6311; 21.3 ; 340.7 ; 7.0 ;16;26;28;0;16;11;5;7;9;16;0;0
6312; 41.5 ; 1,329.0 ; 15.2 ;32;8;19;0;32;24;8;5;27;11;10;11
6313; 18.0 ; 36.1 ; 4.6 ;2;18;37;0;2;0;2;1;1;2;0;0
6314; 75.1 ; 150.3 ; 24.1 ;2;183;152;0;2;0;2;1;1;0;0;2
6315; 52.0 ; 103.9 ; 13.6 ;2;68;65;0;2;1;1;0;2;0;1;1
6316; 27.6 ; 331.2 ; 12.4 ;12;16;2;0;12;3;9;7;5;8;4;0
6317; 20.0 ; 720.9 ; 7.5 ;36;9;1;0;36;23;13;18;18;36;0;0
6318; 34.0 ; 441.9 ; 13.8 ;13;14;22;13;0;11;2;1;12;4;9;0
6319; 21.8 ; 43.7 ; -   ;2;49;4;0;2;2;0;1;1;2;0;0
6320; 54.2 ; 216.7 ; 9.5 ;4;59;15;0;4;0;4;4;0;0;3;1
6321; 26.6 ; 372.7 ; 11.6 ;14;25;40;0;14;3;11;3;11;9;5;0
6322; 82.0 ; 902.2 ; 37.3 ;11;24;69;0;11;2;9;9;2;0;0;11
6323; 47.8 ; 95.7 ; 0.5 ;2;50;5;2;0;0;2;0;2;0;2;0
6324; 50.7 ; 253.5 ; 5.2 ;5;42;11;0;5;0;5;0;5;0;3;2
6325; 38.8 ; 465.0 ; 16.6 ;12;25;0;0;12;2;10;8;4;4;4;4
6326; 18.6 ; 37.2 ; -   ;2;16;206;0;2;1;1;2;0;2;0;0
6327; 33.3 ; 166.3 ; 12.3 ;5;19;120;0;5;1;4;3;2;2;3;0
6328; 49.1 ; 245.6 ; 5.2 ;5;28;41;0;5;3;2;5;0;0;5;0
6329; 52.0 ; 104.1 ; 0.7 ;2;140;152;0;2;0;2;2;0;0;2;0
6330; 31.1 ; 93.3 ; 21.0 ;3;73;65;0;3;2;1;1;2;1;2;0
6331; 42.8 ; 171.3 ; 7.2 ;4;7;275;0;4;3;1;0;4;0;4;0
6332; 60.9 ; 121.9 ; 29.1 ;2;68;205;0;2;0;2;2;0;0;0;2
6333; 116.4 ; 581.8 ; 105.1 ;5;76;37;0;5;0;5;4;1;2;0;3
6334; 37.1 ; 111.4 ; 9.1 ;3;31;209;0;3;1;2;0;3;1;2;0
6335; 56.4 ; 169.3 ; 4.9 ;3;38;200;0;3;0;3;3;0;0;0;3
6336; 45.1 ; 180.4 ; 8.1 ;4;62;111;0;4;1;3;2;2;0;4;0
6337; 31.3 ; 188.1 ; 27.0 ;6;35;31;0;6;0;6;1;5;2;2;2
6338; 26.3 ; 1,130.5 ; 3.0 ;43;5;0;0;43;18;25;14;29;43;0;0
6339; 43.6 ; 130.8 ; 6.4 ;3;38;83;0;3;0;3;1;2;0;3;0
6340; 46.8 ; 93.5 ; -   ;2;23;164;0;2;0;2;0;2;0;2;0
6341; 46.0 ; 137.9 ; 5.7 ;3;5;356;0;3;0;3;3;0;0;3;0
6342; 27.4 ; 137.0 ; 8.4 ;5;23;9;0;5;3;2;1;4;3;2;0
6343; 16.3 ; 81.4 ; 1.9 ;5;5;5;0;5;0;5;3;2;5;0;0
6344; 46.8 ; 93.5 ; -   ;2;31;252;0;2;0;2;0;2;0;2;0
6345; 24.3 ; 510.5 ; 7.8 ;21;18;3;0;21;9;12;5;16;14;7;0
6346; 66.9 ; 334.6 ; 28.2 ;5;34;20;5;0;4;1;2;3;0;0;5
6347; 44.4 ; 177.4 ; 10.6 ;4;52;230;0;4;2;2;2;2;0;4;0
6348; 51.6 ; 206.2 ; 7.5 ;4;25;311;0;4;1;3;1;3;0;3;1
6349; 46.8 ; 93.5 ; -   ;2;13;265;0;2;2;0;0;2;0;2;0
6350; 45.9 ; 91.8 ; 3.4 ;2;51;20;2;0;0;2;0;2;0;2;0
6351; 27.9 ; 306.5 ; 12.1 ;11;19;57;0;11;2;9;3;8;7;4;0
6352; 26.1 ; 78.2 ; 14.8 ;3;41;99;0;3;2;1;1;2;2;1;0
6353; 146.8 ; 293.6 ; 36.5 ;2;5;180;2;0;2;0;0;2;0;0;2
6354; 47.6 ; 95.2 ; 7.2 ;2;29;173;0;2;1;1;2;0;0;2;0
6355; 23.8 ; 119.0 ; 3.4 ;5;5;85;5;0;2;3;2;3;5;0;0
6356; 26.5 ; 238.9 ; 8.8 ;9;18;105;0;9;7;2;6;3;6;3;0
6357; 19.3 ; 135.3 ; 6.4 ;7;10;6;1;6;1;6;1;6;7;0;0
6358; 47.3 ; 331.4 ; 30.3 ;7;37;5;0;7;1;6;6;1;2;3;2
6359; 73.5 ; 147.0 ; 40.1 ;2;38;241;0;2;0;2;0;2;0;0;2
6360; 28.7 ; 143.4 ; 3.0 ;5;13;200;0;5;0;5;0;5;3;2;0
6361; 33.9 ; 169.7 ; 10.3 ;5;40;0;0;5;1;4;1;4;2;3;0
6362; 52.9 ; 158.8 ; 9.6 ;3;95;108;0;3;1;2;3;0;0;2;1
6363; 33.8 ; 101.3 ; 6.6 ;3;59;89;3;0;0;3;2;1;1;2;0
6364; 40.4 ; 484.3 ; 12.5 ;12;26;10;0;12;0;12;9;3;4;8;0
6365; 54.2 ; 542.4 ; 8.6 ;10;16;26;0;10;0;10;10;0;0;7;3
6366; 84.7 ; 254.2 ; 36.5 ;3;88;52;0;3;0;3;3;0;0;0;3
6367; 25.1 ; 50.1 ; -   ;2;12;89;0;2;0;2;2;0;2;0;0
6368; 71.0 ; 212.9 ; 21.5 ;3;52;42;3;0;1;2;3;0;0;0;3
6369; 57.3 ; 172.0 ; 0.8 ;3;137;10;0;3;2;1;2;1;0;0;3
6370; 43.3 ; 86.6 ; 13.2 ;2;1;322;0;2;2;0;0;2;0;1;1
6371; 30.9 ; 556.9 ; 13.5 ;18;6;5;0;18;3;15;12;6;6;12;0
6372; 17.4 ; 312.7 ; 3.8 ;18;19;0;0;18;0;18;15;3;18;0;0
6373; 38.9 ; 544.2 ; 20.7 ;14;10;156;0;14;5;9;5;9;5;4;5
6374; 44.8 ; 89.6 ; 2.9 ;2;23;142;0;2;0;2;2;0;0;2;0
6375; 109.8 ; 219.6 ; 54.8 ;2;12;264;0;2;1;1;1;1;0;0;2
6376; 33.6 ; 67.3 ; 12.8 ;2;119;83;0;2;0;2;0;2;1;1;0
6377; 16.8 ; 83.9 ; 2.1 ;5;5;161;0;5;1;4;5;0;5;0;0
6378; 48.8 ; 683.2 ; 2.5 ;14;13;31;0;14;0;14;2;12;0;14;0
6379; 16.8 ; 33.6 ; 2.7 ;2;181;242;0;2;0;2;2;0;2;0;0
6380; 55.0 ; 659.7 ; 20.7 ;12;21;10;0;12;2;10;10;2;0;8;4
6381; 65.5 ; 131.0 ; 28.1 ;2;25;257;0;2;0;2;0;2;0;0;2
6382; 58.0 ; 116.0 ; 7.0 ;2;17;252;0;2;0;2;0;2;0;0;2
6383; 69.8 ; 418.6 ; 19.7 ;6;43;47;0;6;1;5;4;2;0;0;6
6384; 49.1 ; 442.2 ; 28.7 ;9;11;116;0;9;1;8;5;4;3;3;3
6385; 46.8 ; 93.7 ; 2.8 ;2;2;152;2;0;1;1;1;1;0;2;0
6386; 50.2 ; 201.0 ; 20.2 ;4;35;265;0;4;2;2;1;3;0;3;1
6387; 45.0 ; 224.8 ; 13.3 ;5;36;69;3;2;0;5;2;3;0;3;2
6388; 47.5 ; 142.4 ; -   ;3;25;42;0;3;1;2;1;2;0;3;0
6389; 52.7 ; 105.3 ; 24.1 ;2;246;10;0;2;0;2;0;2;1;0;1
6390; 36.7 ; 256.7 ; 14.8 ;7;24;23;0;7;2;5;6;1;2;5;0
6391; 78.3 ; 156.5 ; 47.2 ;2;175;132;0;2;0;2;0;2;0;0;2
6392; 42.8 ; 128.4 ; 38.0 ;3;112;12;0;3;3;0;1;2;1;1;1
6393; 57.3 ; 343.7 ; 11.3 ;6;37;10;0;6;1;5;3;3;0;0;6
6394; 60.9 ; 121.9 ; 20.2 ;2;43;26;2;0;0;2;2;0;0;0;2
6395; 24.4 ; 121.9 ; 15.0 ;5;41;99;0;5;4;1;4;1;3;2;0
6396; 16.1 ; 32.1 ; 1.6 ;2;20;329;0;2;1;1;1;1;2;0;0
6397; 15.0 ; 45.0 ; -   ;3;5;137;0;3;0;3;2;1;3;0;0
6398; 52.1 ; 416.8 ; 50.5 ;8;22;26;8;0;1;7;5;3;3;2;3
6399; 128.6 ; 385.7 ; 55.2 ;3;1;237;0;3;1;2;2;1;0;0;3
6400; 54.7 ; 273.5 ; 5.8 ;5;29;40;0;5;1;4;5;0;0;3;2
6401; 30.8 ; 61.7 ; 8.6 ;2;139;47;0;2;0;2;1;1;1;1;0
6402; 42.8 ; 342.6 ; 6.1 ;8;23;5;0;8;2;6;6;2;0;8;0
6403; 26.0 ; 129.8 ; 10.7 ;5;27;35;0;5;5;0;2;3;3;2;0
6404; 66.7 ; 400.3 ; 47.1 ;6;49;29;0;6;3;3;5;1;2;0;4
6405; 46.8 ; 654.5 ; 23.4 ;14;18;152;0;14;3;11;8;6;5;4;5
6406; 20.0 ; 40.1 ; 7.6 ;2;28;27;0;2;1;1;2;0;2;0;0
6407; 32.8 ; 98.3 ; 14.1 ;3;25;2;0;3;2;1;0;3;1;2;0
6408; 28.1 ; 112.4 ; 12.6 ;4;59;6;0;4;1;3;2;2;3;1;0
6409; 20.0 ; 40.1 ; 7.6 ;2;12;248;0;2;0;2;0;2;2;0;0
6410; 41.3 ; 82.6 ; 24.3 ;2;6;367;0;2;0;2;1;1;1;0;1
6411; 43.2 ; 86.4 ; 9.0 ;2;54;149;0;2;1;1;2;0;0;2;0
6412; 18.3 ; 36.6 ; 3.7 ;2;93;29;0;2;1;1;2;0;2;0;0
6413; 43.3 ; 173.2 ; 13.2 ;4;68;1;0;4;0;4;3;1;0;3;1
6414; 33.0 ; 164.9 ; 11.9 ;5;49;35;0;5;2;3;2;3;2;3;0
6415; 47.5 ; 380.3 ; 1.3 ;8;33;26;0;8;5;3;2;6;0;8;0
6416; 30.8 ; 123.1 ; 4.1 ;4;38;257;0;4;1;3;4;0;1;3;0
6417; 27.9 ; 83.6 ; 15.4 ;3;13;65;0;3;3;0;3;0;2;1;0
6418; 27.6 ; 771.8 ; 16.4 ;28;14;4;0;28;13;15;4;24;19;9;0
6419; 38.3 ; 76.5 ; 1.6 ;2;3;284;0;2;1;1;1;1;0;2;0
6420; 40.2 ; 120.5 ; 13.9 ;3;41;126;0;3;0;3;1;2;1;2;0
6421; 21.0 ; 146.7 ; 8.4 ;7;21;114;0;7;2;5;1;6;7;0;0
6422; 28.9 ; 86.8 ; 17.2 ;3;59;211;0;3;2;1;1;2;2;1;0
6423; 19.5 ; 195.2 ; 3.4 ;10;21;1;0;10;5;5;6;4;10;0;0
6424; 34.3 ; 342.9 ; 29.7 ;10;34;118;1;9;9;1;8;2;3;4;3
6425; 47.1 ; 188.5 ; 0.4 ;4;89;32;2;2;1;3;2;2;0;4;0
6426; 36.8 ; 331.0 ; 28.8 ;9;25;40;0;9;5;4;6;3;3;3;3
6427; 31.2 ; 62.5 ; 24.3 ;2;23;40;0;2;2;0;0;2;1;0;1
6428; 80.4 ; 241.3 ; 18.0 ;3;78;269;0;3;0;3;2;1;0;0;3
6429; 29.1 ; 87.2 ; 21.7 ;3;40;283;0;3;1;2;2;1;2;1;0
6430; 24.5 ; 220.1 ; 6.2 ;9;24;7;9;0;6;3;2;7;6;3;0
6431; 46.8 ; 140.3 ; -   ;3;16;126;3;0;0;3;2;1;0;3;0
6432; 18.0 ; 1,278.8 ; 8.6 ;71;5;4;0;71;35;36;30;41;71;0;0
6433; 48.8 ; 244.0 ; 16.1 ;5;108;17;0;5;3;2;2;3;0;3;2
6434; 30.3 ; 666.1 ; 6.2 ;22;14;15;1;21;11;11;14;8;7;15;0
6435; 24.5 ; 49.0 ; 7.8 ;2;2;233;0;2;2;0;1;1;1;1;0
6436; 54.2 ; 108.4 ; 15.4 ;2;6;260;0;2;2;0;0;2;0;1;1
6437; 42.1 ; 126.2 ; 5.4 ;3;37;63;0;3;0;3;3;0;0;3;0
6438; 23.0 ; 45.9 ; 11.9 ;2;4;4;2;0;2;0;2;0;1;1;0
6439; 18.9 ; 623.6 ; 5.7 ;33;12;1;0;33;24;9;25;8;33;0;0
6440; 35.0 ; 140.0 ; 15.7 ;4;16;189;0;4;1;3;2;2;1;3;0
6441; 33.7 ; 134.7 ; 20.3 ;4;29;10;0;4;2;2;1;3;1;3;0
6442; 39.9 ; 199.7 ; 18.1 ;5;40;173;0;5;0;5;5;0;2;1;2
6443; 67.1 ; 335.4 ; 33.6 ;5;67;0;0;5;2;3;2;3;0;0;5
6444; 38.7 ; 77.4 ; 13.1 ;2;86;28;0;2;1;1;0;2;1;1;0
6445; 74.3 ; 148.6 ; 27.5 ;2;42;57;1;1;1;1;2;0;0;0;2
6446; 25.8 ; 154.7 ; 11.6 ;6;30;59;0;6;4;2;6;0;4;2;0
6447; 31.7 ; 63.5 ; 0.8 ;2;44;4;0;2;1;1;0;2;0;2;0
6448; 36.0 ; 179.9 ; 25.2 ;5;93;35;1;4;3;2;5;0;2;1;2
6449; 31.2 ; 62.3 ; 17.5 ;2;36;248;0;2;1;1;1;1;1;1;0
6450; 30.9 ; 61.7 ; 23.8 ;2;5;326;0;2;0;2;1;1;1;1;0
6451; 36.2 ; 253.4 ; 14.5 ;7;32;31;7;0;1;6;2;5;2;5;0
6452; 42.1 ; 336.5 ; 11.1 ;8;14;5;0;8;3;5;4;4;0;8;0
6453; 48.4 ; 96.7 ; 6.2 ;2;35;251;0;2;1;1;0;2;0;2;0
6454; 42.5 ; 85.1 ; 19.5 ;2;26;35;2;0;1;1;0;2;1;0;1
6455; 33.0 ; 429.0 ; 10.8 ;13;27;99;0;13;2;11;10;3;4;9;0
6456; 19.2 ; 211.7 ; 7.1 ;11;27;18;0;11;7;4;10;1;11;0;0
6457; 39.7 ; 1,308.8 ; 13.0 ;33;8;3;0;33;19;14;23;10;11;22;0
6458; 47.7 ; 95.4 ; 1.4 ;2;27;194;2;0;0;2;1;1;0;2;0
6459; 15.0 ; 30.0 ; -   ;2;104;30;0;2;2;0;2;0;2;0;0
6460; 23.1 ; 46.2 ; 3.0 ;2;3;17;2;0;1;1;0;2;2;0;0
6461; 48.2 ; 192.8 ; 3.1 ;4;42;110;0;4;0;4;4;0;0;4;0
6462; 54.7 ; 273.3 ; 19.0 ;5;16;32;0;5;2;3;2;3;0;3;2
6463; 74.9 ; 149.8 ; 33.5 ;2;5;147;0;2;0;2;1;1;0;0;2
6464; 41.3 ; 165.3 ; 11.5 ;4;108;93;0;4;3;1;2;2;1;3;0
6465; 23.3 ; 46.7 ; 3.3 ;2;106;262;0;2;1;1;2;0;2;0;0
6466; 24.4 ; 121.9 ; 12.5 ;5;23;236;0;5;2;3;3;2;3;2;0
6467; 44.8 ; 134.4 ; 14.6 ;3;141;32;0;3;0;3;2;1;0;2;1
6468; 38.7 ; 193.5 ; 9.9 ;5;62;15;0;5;2;3;3;2;2;3;0
6469; 21.9 ; 65.8 ; 8.0 ;3;50;69;0;3;0;3;1;2;3;0;0
6470; 32.8 ; 65.6 ; 3.9 ;2;166;151;0;2;1;1;0;2;1;1;0
6471; 32.2 ; 483.4 ; 7.5 ;15;19;4;0;15;10;5;5;10;5;10;0
6472; 22.2 ; 333.7 ; 8.8 ;15;14;106;0;15;6;9;15;0;10;5;0
6473; 44.6 ; 624.3 ; 21.6 ;14;21;13;0;14;4;10;10;4;5;4;5
6474; 23.4 ; 70.1 ; 11.3 ;3;28;10;0;3;1;2;2;1;2;1;0
6475; 63.2 ; 189.7 ; 8.5 ;3;25;209;0;3;0;3;3;0;0;0;3
6476; 54.0 ; 216.1 ; 7.0 ;4;41;170;0;4;1;3;4;0;0;3;1
6477; 46.2 ; 277.3 ; 10.8 ;6;56;10;0;6;0;6;2;4;0;4;2
6478; 51.7 ; 103.4 ; 39.9 ;2;100;16;0;2;0;2;0;2;1;0;1
6479; 41.4 ; 413.5 ; 50.1 ;10;17;53;0;10;6;4;9;1;3;4;3
6480; 110.4 ; 551.9 ; 44.4 ;5;57;46;0;5;1;4;1;4;0;0;5
6481; 17.9 ; 71.7 ; 3.5 ;4;73;80;0;4;3;1;1;3;4;0;0
6482; 31.3 ; 312.9 ; 13.3 ;10;22;54;0;10;1;9;2;8;3;7;0
6483; 67.1 ; 1,207.3 ; 26.4 ;18;15;19;0;18;4;14;5;13;0;0;18
6484; 51.5 ; 103.1 ; 7.2 ;2;33;350;0;2;1;1;1;1;0;1;1
6485; 18.3 ; 55.0 ; 6.2 ;3;18;115;0;3;0;3;3;0;3;0;0
6486; 77.9 ; 389.6 ; 38.8 ;5;65;184;0;5;2;3;3;2;0;0;5
6487; 16.2 ; 65.0 ; 2.7 ;4;36;36;0;4;0;4;2;2;4;0;0
6488; 42.3 ; 169.0 ; 4.4 ;4;104;7;0;4;3;1;2;2;0;4;0
6489; 29.6 ; 59.3 ; 2.3 ;2;8;47;2;0;0;2;0;2;1;1;0
6490; 36.9 ; 664.9 ; 15.6 ;18;7;5;0;18;5;13;9;9;6;12;0
6491; 47.8 ; 95.7 ; 0.5 ;2;113;5;1;1;0;2;2;0;0;2;0
6492; 31.3 ; 562.9 ; 13.8 ;18;23;38;0;18;6;12;6;12;6;12;0
6493; 31.4 ; 156.9 ; 19.8 ;5;64;5;0;5;2;3;2;3;2;3;0
6494; 50.9 ; 101.9 ; 17.8 ;2;7;166;0;2;2;0;2;0;0;1;1
6495; 69.0 ; 275.9 ; 47.3 ;4;23;0;0;4;0;4;3;1;1;0;3
6496; 18.3 ; 127.9 ; 1.5 ;7;26;4;2;5;0;7;4;3;7;0;0
6497; 62.7 ; 313.6 ; 13.0 ;5;40;116;0;5;0;5;5;0;0;0;5
6498; 28.7 ; 372.6 ; 11.1 ;13;6;20;0;13;8;5;1;12;9;4;0
6499; 62.4 ; 436.8 ; 30.7 ;7;17;65;0;7;2;5;5;2;0;0;7
6500; 21.4 ; 85.6 ; 5.5 ;4;73;14;1;3;4;0;4;0;4;0;0
6501; 29.5 ; 295.3 ; 10.7 ;10;30;29;0;10;7;3;8;2;7;3;0
6502; 69.5 ; 208.5 ; 20.2 ;3;23;10;0;3;1;2;2;1;0;0;3
6503; 38.6 ; 655.6 ; 9.6 ;17;16;74;0;17;1;16;2;15;6;11;0
6504; 38.4 ; 76.7 ; 3.8 ;2;17;126;1;1;0;2;2;0;0;2;0
6505; 49.5 ; 247.3 ; 16.0 ;5;50;63;0;5;0;5;5;0;0;3;2
6506; 38.5 ; 76.9 ; 12.4 ;2;32;158;2;0;0;2;2;0;1;1;0
6507; 26.8 ; 750.4 ; 6.9 ;28;14;0;0;28;19;9;28;0;19;9;0
6508; 57.1 ; 228.6 ; 25.2 ;4;5;90;1;3;2;2;1;3;0;0;4
6509; 36.3 ; 72.5 ; 16.8 ;2;200;28;0;2;1;1;0;2;1;1;0
6510; 15.0 ; 30.0 ; -   ;2;50;87;2;0;2;0;0;2;2;0;0
6511; 22.5 ; 44.9 ; 11.2 ;2;185;98;0;2;1;1;2;0;1;1;0
6512; 31.0 ; 123.9 ; 5.6 ;4;28;16;0;4;1;3;2;2;1;3;0
6513; 53.8 ; 430.5 ; 21.0 ;8;36;41;0;8;3;5;1;7;0;5;3
6514; 27.5 ; 55.0 ; 3.7 ;2;68;5;0;2;0;2;1;1;1;1;0
6515; 21.1 ; 105.5 ; -   ;5;8;92;0;5;4;1;0;5;5;0;0
6516; 16.9 ; 84.4 ; 2.1 ;5;88;1;0;5;2;3;3;2;5;0;0
6517; 47.8 ; 95.7 ; 0.5 ;2;25;5;0;2;0;2;2;0;0;2;0
6518; 40.6 ; 81.1 ; 3.4 ;2;52;116;0;2;1;1;2;0;0;2;0
6519; 59.9 ; 119.9 ; 19.7 ;2;75;142;0;2;0;2;1;1;0;0;2
6520; 15.0 ; 45.0 ; -   ;3;25;202;0;3;2;1;1;2;3;0;0
6521; 26.6 ; 53.2 ; 2.3 ;2;82;84;0;2;0;2;2;0;2;0;0
6522; 47.9 ; 335.3 ; 32.3 ;7;26;150;0;7;2;5;4;3;2;3;2
6523; 31.3 ; 93.9 ; 3.7 ;3;89;100;0;3;1;2;3;0;1;2;0
6524; 49.6 ; 99.3 ; 4.3 ;2;49;215;0;2;0;2;0;2;0;2;0
6525; 34.0 ; 204.0 ; 26.5 ;6;71;61;0;6;1;5;4;2;2;2;2
6526; 24.1 ; 216.6 ; 4.6 ;9;23;98;1;8;5;4;6;3;9;0;0
6527; 66.7 ; 333.4 ; 81.6 ;5;69;10;0;5;1;4;2;3;2;0;3
6528; 15.0 ; 59.9 ; -   ;4;51;29;0;4;3;1;2;2;4;0;0
6529; 49.5 ; 99.1 ; 4.2 ;2;32;125;0;2;0;2;2;0;0;2;0
6530; 34.0 ; 67.9 ; 13.3 ;2;32;247;0;2;1;1;0;2;1;1;0
6531; 44.3 ; 310.4 ; 9.8 ;7;51;59;0;7;3;4;0;7;0;7;0
6532; 16.1 ; 80.3 ; 1.8 ;5;29;89;0;5;0;5;4;1;5;0;0
6533; 20.0 ; 40.1 ; 7.6 ;2;163;85;0;2;0;2;2;0;2;0;0
6534; 43.5 ; 130.5 ; 17.4 ;3;23;121;0;3;1;2;2;1;1;1;1
6535; 40.1 ; 280.7 ; 25.6 ;7;27;2;0;7;5;2;2;5;2;3;2
6536; 37.3 ; 559.1 ; 10.5 ;15;29;11;0;15;1;14;14;1;5;10;0
6537; 49.6 ; 247.8 ; 22.5 ;5;20;16;0;5;1;4;4;1;2;1;2
6538; 55.8 ; 446.7 ; 29.4 ;8;28;15;0;8;0;8;7;1;3;0;5
6539; 43.8 ; 131.5 ; 6.7 ;3;114;2;1;2;2;1;0;3;0;3;0
6540; 45.0 ; 225.1 ; 15.3 ;5;71;89;0;5;1;4;2;3;2;1;2
6541; 49.6 ; 99.3 ; 4.3 ;2;170;136;0;2;0;2;2;0;0;2;0
6542; 28.2 ; 56.5 ; 12.8 ;2;14;253;0;2;1;1;0;2;1;1;0
6543; 18.6 ; 37.2 ; -   ;2;68;82;0;2;2;0;2;0;2;0;0
6544; 25.1 ; 50.1 ; -   ;2;351;5;0;2;0;2;2;0;2;0;0
6545; 22.6 ; 45.2 ; 11.4 ;2;11;75;0;2;1;1;2;0;1;1;0
6546; 24.5 ; 318.8 ; 5.7 ;13;20;21;0;13;0;13;13;0;9;4;0
6547; 47.7 ; 858.0 ; 3.7 ;18;18;10;0;18;6;12;10;8;0;18;0
6548; 36.6 ; 73.3 ; 23.8 ;2;86;189;0;2;0;2;1;1;1;0;1
6549; 18.0 ; 71.9 ; 2.2 ;4;14;236;0;4;1;3;1;3;4;0;0
6550; 64.8 ; 1,489.9 ; 38.4 ;23;13;52;0;23;5;18;13;10;8;0;15
6551; 51.1 ; 102.3 ; 6.6 ;2;6;171;0;2;2;0;0;2;0;1;1
6552; 38.3 ; 115.0 ; 21.7 ;3;74;69;1;2;0;3;3;0;1;1;1
6553; 33.8 ; 67.5 ; 28.1 ;2;85;184;0;2;1;1;0;2;1;0;1
6554; 61.7 ; 246.7 ; 31.4 ;4;55;225;0;4;0;4;2;2;0;0;4
6555; 56.8 ; 795.3 ; 28.9 ;14;23;31;0;14;0;14;14;0;5;0;9
6556; 21.1 ; 105.4 ; 5.6 ;5;48;102;0;5;2;3;0;5;5;0;0
6557; 54.3 ; 217.2 ; 37.9 ;4;1;263;0;4;2;2;2;2;1;2;1
6558; 30.1 ; 120.4 ; 11.7 ;4;48;166;0;4;3;1;4;0;1;3;0
6559; 37.9 ; 75.7 ; 19.2 ;2;6;242;0;2;0;2;2;0;1;0;1
6560; 50.4 ; 201.6 ; 3.9 ;4;134;16;0;4;0;4;3;1;0;4;0
6561; 71.0 ; 1,633.8 ; 24.4 ;23;10;0;0;23;1;22;2;21;0;0;23
6562; 16.5 ; 98.9 ; 2.0 ;6;25;18;0;6;3;3;2;4;6;0;0
6563; 15.0 ; 74.9 ; -   ;5;37;55;0;5;3;2;1;4;5;0;0
6564; 42.9 ; 171.5 ; 48.9 ;4;14;10;0;4;1;3;3;1;1;2;1
6565; 25.4 ; 76.1 ; 5.3 ;3;70;98;0;3;1;2;2;1;2;1;0
6566; 26.1 ; 339.2 ; 12.2 ;13;18;23;0;13;1;12;5;8;9;4;0
6567; 61.0 ; 609.6 ; 27.9 ;10;44;10;0;10;0;10;6;4;0;0;10
6568; 33.5 ; 167.4 ; 22.8 ;5;41;103;0;5;3;2;3;2;2;1;2
6569; 69.2 ; 276.7 ; 27.4 ;4;44;238;0;4;1;3;1;3;0;0;4
6570; 18.3 ; 55.0 ; 3.1 ;3;108;109;0;3;2;1;3;0;3;0;0
6571; 55.1 ; 275.3 ; 20.3 ;5;72;22;0;5;0;5;4;1;0;0;5
6572; 21.4 ; 42.7 ; 9.5 ;2;10;71;0;2;1;1;0;2;1;1;0
6573; 57.6 ; 230.5 ; 5.2 ;4;88;43;0;4;0;4;4;0;0;0;4
6574; 51.4 ; 102.7 ; 8.1 ;2;38;251;0;2;1;1;0;2;0;1;1
6575; 46.9 ; 938.6 ; 2.9 ;20;21;5;0;20;5;15;12;8;0;20;0
6576; 34.5 ; 448.5 ; 16.8 ;13;29;19;0;13;7;6;7;6;4;9;0
6577; 31.5 ; 63.0 ; 9.6 ;2;6;59;0;2;0;2;0;2;1;1;0
6578; 52.0 ; 416.1 ; 19.1 ;8;25;8;0;8;3;5;4;4;0;5;3
6579; 29.7 ; 178.4 ; 7.0 ;6;59;5;0;6;0;6;4;2;4;2;0
6580; 31.2 ; 686.1 ; 14.2 ;22;10;53;0;22;9;13;10;12;7;15;0
6581; 53.0 ; 212.1 ; 13.3 ;4;23;320;0;4;1;3;4;0;0;3;1
6582; 119.5 ; 358.4 ; 30.7 ;3;65;28;0;3;2;1;1;2;0;0;3
6583; 25.8 ; 77.4 ; 19.9 ;3;22;32;0;3;0;3;3;0;2;1;0
6584; 16.5 ; 33.0 ; 2.3 ;2;2;136;0;2;1;1;1;1;2;0;0
6585; 32.3 ; 64.5 ; 10.8 ;2;11;234;0;2;2;0;0;2;1;1;0
6586; 19.5 ; 273.6 ; 5.9 ;14;25;10;7;7;6;8;1;13;14;0;0
6587; 36.2 ; 181.0 ; 9.3 ;5;10;59;0;5;1;4;1;4;2;3;0
6588; 61.7 ; 246.9 ; 25.3 ;4;34;89;0;4;0;4;4;0;0;0;4
6589; 22.3 ; 357.4 ; 7.9 ;16;20;2;0;16;7;9;5;11;11;5;0
6590; 25.0 ; 324.6 ; 5.6 ;13;22;11;0;13;5;8;12;1;9;4;0
6591; 63.4 ; 253.4 ; 15.1 ;4;29;16;0;4;0;4;3;1;0;0;4
6592; 54.5 ; 490.6 ; 34.8 ;9;30;131;0;9;0;9;9;0;3;3;3
6593; 38.5 ; 385.2 ; 8.4 ;10;12;239;0;10;3;7;8;2;0;10;0
6594; 28.6 ; 171.9 ; 7.2 ;6;3;4;0;6;1;5;2;4;4;2;0
6595; 34.4 ; 103.3 ; -   ;3;5;342;0;3;0;3;3;0;0;3;0
6596; 28.5 ; 85.4 ; 3.1 ;3;52;86;2;1;2;1;1;2;2;1;0
6597; 43.6 ; 87.2 ; 4.3 ;2;38;230;0;2;0;2;2;0;0;2;0
6598; 48.4 ; 96.7 ; 6.7 ;2;328;10;0;2;0;2;0;2;0;1;1
6599; 45.7 ; 274.3 ; 4.3 ;6;17;83;0;6;0;6;6;0;0;6;0
6600; 37.0 ; 110.9 ; 22.5 ;3;23;121;0;3;1;2;2;1;1;1;1
6601; 39.2 ; 78.3 ; 21.1 ;2;198;99;0;2;1;1;1;1;1;0;1
6602; 32.9 ; 230.0 ; 14.4 ;7;15;6;0;7;1;6;1;6;2;5;0
6603; 43.0 ; 473.0 ; 13.6 ;11;27;33;0;11;9;2;3;8;4;3;4
6604; 20.6 ; 41.1 ; 8.4 ;2;219;194;0;2;1;1;2;0;2;0;0
6605; 40.7 ; 325.3 ; 13.2 ;8;34;42;0;8;1;7;6;2;3;5;0
6606; 35.0 ; 105.1 ; 9.8 ;3;16;4;0;3;3;0;2;1;1;2;0
6607; 46.8 ; 93.7 ; 19.0 ;2;119;0;1;1;0;2;1;1;1;0;1
6608; 27.1 ; 135.6 ; 13.3 ;5;22;90;0;5;1;4;2;3;3;2;0
6609; 34.2 ; 170.9 ; 18.8 ;5;41;35;0;5;3;2;1;4;2;3;0
6610; 35.2 ; 457.9 ; 20.8 ;13;16;56;0;13;4;9;5;8;4;5;4
6611; 18.0 ; 521.1 ; 4.6 ;29;6;3;0;29;21;8;14;15;29;0;0
6612; 27.7 ; 194.1 ; 14.4 ;7;26;5;0;7;0;7;3;4;5;2;0
6613; 34.5 ; 103.6 ; 7.1 ;3;32;162;0;3;1;2;3;0;1;2;0
6614; 52.7 ; 158.0 ; 19.8 ;3;13;20;0;3;1;2;1;2;0;2;1
6615; 33.2 ; 66.4 ; 22.4 ;2;5;5;0;2;0;2;1;1;1;0;1
6616; 95.9 ; 287.8 ; 9.8 ;3;9;188;3;0;0;3;1;2;0;0;3
6617; 23.7 ; 355.1 ; 6.1 ;15;10;20;0;15;1;14;8;7;15;0;0
6618; 64.3 ; 192.9 ; 19.2 ;3;104;173;0;3;1;2;2;1;0;0;3
6619; 75.2 ; 526.6 ; 44.9 ;7;64;4;1;6;2;5;5;2;0;0;7
6620; 30.2 ; 90.6 ; -   ;3;28;57;0;3;0;3;1;2;0;3;0
6621; 42.9 ; 214.4 ; 8.2 ;5;23;80;0;5;2;3;0;5;0;5;0
6622; 29.6 ; 384.2 ; 2.1 ;13;20;20;0;13;7;6;12;1;9;4;0
6623; 32.5 ; 65.1 ; 12.6 ;2;14;156;0;2;1;1;1;1;1;1;0
6624; 39.0 ; 195.0 ; 24.6 ;5;18;79;0;5;1;4;3;2;2;1;2
6625; 38.7 ; 193.5 ; 17.0 ;5;39;125;0;5;5;0;0;5;2;1;2
6626; 51.0 ; 102.0 ; -   ;2;50;183;0;2;0;2;2;0;0;2;0
6627; 25.7 ; 77.1 ; 3.5 ;3;6;57;0;3;0;3;2;1;3;0;0
6628; 32.6 ; 65.1 ; 11.2 ;2;19;251;0;2;0;2;0;2;1;1;0
6629; 59.6 ; 119.3 ; 18.2 ;2;100;94;1;1;0;2;2;0;0;0;2
6630; 54.9 ; 109.8 ; 27.4 ;2;10;117;2;0;1;1;2;0;1;0;1
6631; 42.4 ; 211.9 ; 25.8 ;5;50;36;0;5;0;5;3;2;2;1;2
6632; 25.6 ; 358.3 ; 9.4 ;14;11;167;0;14;9;5;12;2;9;5;0
6633; 34.0 ; 67.9 ; 13.3 ;2;123;163;0;2;1;1;1;1;1;1;0
6634; 28.3 ; 113.3 ; 14.9 ;4;23;1;0;4;2;2;0;4;3;1;0
6635; 51.4 ; 771.0 ; 13.5 ;15;24;27;0;15;4;11;3;12;0;10;5
6636; 15.0 ; 59.9 ; -   ;4;33;60;0;4;4;0;2;2;4;0;0
6637; 22.9 ; 68.7 ; 4.0 ;3;16;57;0;3;1;2;2;1;3;0;0
6638; 48.7 ; 97.3 ; 0.1 ;2;123;64;0;2;0;2;1;1;0;2;0
6639; 56.4 ; 451.1 ; 36.7 ;8;32;5;0;8;2;6;4;4;3;0;5
6640; 81.5 ; 244.5 ; 11.4 ;3;104;10;0;3;0;3;3;0;0;0;3
6641; 50.2 ; 150.7 ; 32.1 ;3;140;113;0;3;2;1;3;0;1;1;1
6642; 95.3 ; 190.5 ; 56.6 ;2;1;162;0;2;0;2;2;0;0;0;2
6643; 50.3 ; 905.3 ; 24.6 ;18;22;8;0;18;12;6;7;11;6;6;6
6644; 43.0 ; 86.1 ; 19.6 ;2;46;275;0;2;1;1;2;0;1;0;1
6645; 46.2 ; 92.4 ; 46.8 ;2;7;20;0;2;0;2;2;0;1;0;1
6646; 22.9 ; 91.7 ; 16.8 ;4;17;236;0;4;2;2;2;2;3;1;0
6647; 32.4 ; 485.5 ; 13.9 ;15;12;32;0;15;6;9;5;10;5;10;0
6648; 48.3 ; 531.0 ; 14.3 ;11;16;39;11;0;9;2;1;10;0;7;4
6649; 30.2 ; 60.4 ; -   ;2;61;48;0;2;0;2;1;1;0;2;0
6650; 35.2 ; 70.3 ; 7.8 ;2;59;120;0;2;0;2;1;1;1;1;0
6651; 43.4 ; 173.7 ; 14.1 ;4;69;100;0;4;1;3;1;3;1;2;1
6652; 49.5 ; 346.3 ; 24.2 ;7;63;14;0;7;6;1;3;4;2;3;2
6653; 15.0 ; 30.0 ; -   ;2;290;5;0;2;0;2;2;0;2;0;0
6654; 30.2 ; 60.4 ; -   ;2;33;203;0;2;1;1;0;2;0;2;0
6655; 58.4 ; 584.1 ; 18.9 ;10;23;13;0;10;8;2;2;8;0;0;10
6656; 23.0 ; 69.1 ; 6.6 ;3;7;297;0;3;1;2;1;2;3;0;0
6657; 48.5 ; 485.4 ; 6.0 ;10;23;31;0;10;1;9;10;0;0;10;0
6658; 23.7 ; 47.3 ; 9.8 ;2;12;354;0;2;2;0;0;2;1;1;0
6659; 48.4 ; 483.9 ; 2.5 ;10;27;36;0;10;3;7;9;1;0;10;0
6660; 106.2 ; 531.0 ; 48.2 ;5;1;292;0;5;1;4;1;4;0;0;5
6661; 24.2 ; 121.0 ; 5.2 ;5;41;65;0;5;2;3;1;4;5;0;0
6662; 46.8 ; 93.5 ; -   ;2;9;107;0;2;2;0;0;2;0;2;0
6663; 29.1 ; 58.3 ; 1.6 ;2;2;155;0;2;1;1;2;0;1;1;0
6664; 43.9 ; 175.5 ; 33.8 ;4;53;148;0;4;1;3;3;1;1;2;1
6665; 27.7 ; 138.6 ; 10.1 ;5;22;110;0;5;0;5;4;1;3;2;0
6666; 44.4 ; 177.8 ; 37.9 ;4;104;0;0;4;3;1;3;1;1;2;1
6667; 19.9 ; 436.8 ; 4.3 ;22;12;0;0;22;6;16;4;18;22;0;0
6668; 40.8 ; 122.5 ; 24.2 ;3;19;5;0;3;0;3;1;2;1;1;1
6669; 45.2 ; 135.7 ; 8.2 ;3;113;37;0;3;0;3;3;0;0;3;0
6670; 31.8 ; 63.7 ; 25.2 ;2;221;84;0;2;0;2;1;1;1;0;1
6671; 24.9 ; 224.4 ; 2.9 ;9;36;5;0;9;3;6;3;6;9;0;0
6672; 42.6 ; 213.1 ; 25.5 ;5;41;131;0;5;0;5;3;2;2;1;2
6673; 102.4 ; 511.9 ; 42.6 ;5;44;20;0;5;0;5;5;0;0;0;5
6674; 41.7 ; 83.4 ; 7.6 ;2;1;248;0;2;2;0;0;2;0;2;0
6675; 33.2 ; 132.8 ; 8.7 ;4;16;5;0;4;1;3;2;2;1;3;0
6676; 48.1 ; 288.4 ; 8.1 ;6;36;5;0;6;2;4;5;1;0;4;2
6677; 31.0 ; 92.9 ; 11.4 ;3;54;45;0;3;1;2;3;0;1;2;0
6678; 25.2 ; 226.7 ; 9.9 ;9;41;44;0;9;8;1;8;1;6;3;0
6679; 23.4 ; 210.5 ; 15.1 ;9;47;41;1;8;5;4;4;5;6;3;0
6680; 38.5 ; 76.9 ; 12.4 ;2;25;272;0;2;0;2;1;1;1;1;0
6681; 32.3 ; 97.0 ; 24.6 ;3;7;131;0;3;0;3;1;2;1;1;1
6682; 38.2 ; 573.4 ; 8.7 ;15;18;72;0;15;7;8;7;8;5;10;0
6683; 19.0 ; 457.2 ; 8.6 ;24;12;8;0;24;12;12;4;20;24;0;0
6684; 45.3 ; 181.4 ; 18.1 ;4;69;158;0;4;0;4;2;2;1;2;1
6685; 55.1 ; 275.7 ; 24.5 ;5;54;92;1;4;2;3;3;2;0;0;5
6686; 18.1 ; 307.1 ; 6.2 ;17;11;81;0;17;11;6;6;11;17;0;0
6687; 28.6 ; 171.8 ; 13.5 ;6;34;103;0;6;4;2;5;1;4;2;0
6688; 38.8 ; 77.7 ; 12.9 ;2;3;88;0;2;2;0;1;1;1;1;0
6689; 25.8 ; 51.6 ; 16.2 ;2;86;5;0;2;1;1;0;2;1;1;0
6690; 51.3 ; 615.8 ; 14.2 ;12;23;141;0;12;4;8;5;7;0;8;4
6691; 27.3 ; 109.3 ; 17.3 ;4;84;59;0;4;2;2;1;3;3;1;0
6692; 15.0 ; 30.0 ; -   ;2;6;152;0;2;0;2;2;0;2;0;0
6693; 26.1 ; 130.4 ; 13.1 ;5;80;10;0;5;1;4;1;4;3;2;0
6694; 33.0 ; 99.0 ; 27.3 ;3;155;5;0;3;0;3;1;2;1;1;1
6695; 70.5 ; 564.3 ; 15.4 ;8;56;17;0;8;2;6;4;4;0;0;8
6696; 61.3 ; 183.8 ; 42.1 ;3;50;16;0;3;0;3;1;2;1;0;2
6697; 20.4 ; 470.2 ; 11.5 ;23;14;3;0;23;14;9;5;18;15;8;0
6698; 92.1 ; 276.2 ; 5.4 ;3;44;251;0;3;1;2;1;2;0;0;3
6699; 85.1 ; 170.2 ; 39.9 ;2;38;136;0;2;0;2;1;1;0;0;2
6700; 30.8 ; 215.7 ; 11.3 ;7;13;5;0;7;1;6;5;2;2;5;0
6701; 19.1 ; 248.0 ; 8.3 ;13;24;22;0;13;1;12;6;7;13;0;0
6702; 22.6 ; 45.2 ; 11.4 ;2;14;104;0;2;1;1;1;1;1;1;0
6703; 49.1 ; 98.2 ; 9.3 ;2;5;169;0;2;0;2;2;0;0;1;1
6704; 84.4 ; 337.4 ; 18.1 ;4;80;5;0;4;0;4;4;0;0;0;4
6705; 38.8 ; 1,086.9 ; 17.2 ;28;11;173;0;28;17;11;12;16;9;10;9
6706; 40.5 ; 202.3 ; 17.0 ;5;6;398;0;5;2;3;0;5;2;1;2
6707; 58.6 ; 117.3 ; 22.5 ;2;22;102;0;2;1;1;1;1;0;0;2
6708; 36.3 ; 72.5 ; 26.5 ;2;76;2;0;2;2;0;0;2;1;0;1
6709; 23.2 ; 115.8 ; 3.5 ;5;81;95;0;5;0;5;2;3;5;0;0
6710; 36.3 ; 181.5 ; 6.2 ;5;56;78;0;5;1;4;4;1;0;5;0
6711; 59.9 ; 119.9 ; 0.5 ;2;100;103;0;2;2;0;0;2;0;0;2
6712; 64.5 ; 386.8 ; 15.6 ;6;75;10;0;6;0;6;6;0;0;0;6
6713; 37.6 ; 150.4 ; 15.4 ;4;40;35;0;4;3;1;1;3;1;3;0
6714; 29.9 ; 149.6 ; 12.9 ;5;37;93;0;5;0;5;4;1;3;2;0
6715; 37.5 ; 112.4 ; 20.6 ;3;40;58;0;3;1;2;3;0;1;1;1
6716; 26.1 ; 78.2 ; 1.9 ;3;47;89;0;3;0;3;3;0;3;0;0
6717; 42.9 ; 85.7 ; -   ;2;19;178;0;2;0;2;2;0;0;2;0
6718; 46.8 ; 93.5 ; -   ;2;25;105;0;2;0;2;2;0;0;2;0
6719; 40.1 ; 200.4 ; 9.3 ;5;37;113;0;5;1;4;1;4;0;5;0
6720; 73.3 ; 366.5 ; 47.1 ;5;42;184;0;5;0;5;5;0;2;0;3
6721; 80.1 ; 240.4 ; 21.4 ;3;65;257;0;3;2;1;1;2;0;0;3
6722; 25.1 ; 50.1 ; -   ;2;6;89;0;2;0;2;0;2;2;0;0
6723; 29.6 ; 59.1 ; 6.7 ;2;157;157;0;2;0;2;2;0;1;1;0
6724; 62.4 ; 249.5 ; 24.2 ;4;23;11;4;0;3;1;2;2;0;0;4
6725; 16.6 ; 149.5 ; 3.8 ;9;15;29;9;0;8;1;7;2;9;0;0
6726; 81.6 ; 163.2 ; 22.2 ;2;51;11;1;1;1;1;2;0;0;0;2
6727; 15.0 ; 74.9 ; -   ;5;21;0;0;5;0;5;1;4;5;0;0
6728; 46.7 ; 1,493.0 ; 17.6 ;32;9;2;0;32;19;13;7;25;11;10;11
6729; 45.9 ; 321.4 ; 25.8 ;7;62;22;0;7;1;6;3;4;2;3;2
6730; 49.0 ; 98.0 ; 7.5 ;2;19;251;0;2;0;2;2;0;0;1;1
6731; 36.4 ; 763.6 ; 9.6 ;21;10;2;1;20;11;10;11;10;7;14;0
6732; 34.4 ; 309.6 ; 10.2 ;9;10;147;0;9;0;9;7;2;3;6;0
6733; 74.8 ; 374.1 ; 26.7 ;5;45;17;0;5;2;3;5;0;0;0;5
6734; 25.6 ; 76.9 ; 5.2 ;3;11;182;0;3;1;2;1;2;2;1;0
6735; 34.8 ; 417.4 ; 20.8 ;12;24;19;0;12;5;7;6;6;4;4;4
6736; 51.6 ; 412.5 ; 13.2 ;8;28;26;0;8;4;4;3;5;0;5;3
6737; 15.7 ; 31.4 ; 1.1 ;2;11;38;0;2;0;2;2;0;2;0;0
6738; 44.0 ; 351.6 ; 11.3 ;8;53;1;0;8;3;5;8;0;0;5;3
6739; 39.7 ; 158.8 ; 9.2 ;4;54;52;0;4;2;2;1;3;0;4;0
6740; 56.3 ; 112.7 ; 6.5 ;2;5;110;0;2;1;1;2;0;0;0;2
6741; 58.1 ; 116.1 ; 8.3 ;2;32;167;0;2;0;2;2;0;0;0;2
6742; 34.5 ; 344.9 ; 19.4 ;10;36;87;0;10;3;7;8;2;3;7;0
6743; 36.2 ; 325.4 ; 22.4 ;9;30;3;0;9;4;5;3;6;3;3;3
6744; 33.0 ; 263.8 ; 9.2 ;8;41;8;0;8;7;1;8;0;3;5;0
6745; 80.5 ; 161.1 ; 22.9 ;2;31;204;0;2;1;1;2;0;0;0;2
6746; 35.2 ; 140.9 ; 6.6 ;4;49;146;0;4;1;3;4;0;1;3;0
6747; 36.5 ; 73.0 ; 9.5 ;2;42;326;0;2;0;2;2;0;1;1;0
6748; 49.2 ; 98.3 ; 12.5 ;2;182;99;0;2;0;2;2;0;0;1;1
6749; 46.4 ; 92.7 ; 10.8 ;2;11;81;0;2;1;1;0;2;0;1;1
6750; 20.7 ; 124.2 ; 5.2 ;6;50;16;0;6;0;6;6;0;6;0;0
6751; 55.5 ; 333.3 ; 34.4 ;6;36;8;0;6;0;6;4;2;2;0;4
6752; 59.4 ; 356.5 ; 23.2 ;6;20;0;0;6;0;6;6;0;0;0;6
6753; 41.4 ; 827.6 ; 19.3 ;20;12;0;0;20;9;11;16;4;7;6;7
6754; 39.4 ; 78.9 ; 13.9 ;2;201;16;0;2;0;2;2;0;1;1;0
6755; 27.9 ; 111.8 ; 6.1 ;4;56;35;0;4;2;2;1;3;3;1;0
6756; 52.2 ; 469.6 ; 4.8 ;9;26;73;0;9;4;5;2;7;0;6;3
6757; 37.6 ; 150.4 ; 15.3 ;4;74;31;0;4;1;3;2;2;1;3;0
6758; 51.6 ; 154.7 ; 6.9 ;3;160;0;0;3;0;3;2;1;0;2;1
6759; 60.3 ; 361.9 ; 24.0 ;6;71;5;0;6;1;5;4;2;0;0;6
6760; 45.0 ; 134.9 ; 14.1 ;3;88;116;0;3;1;2;1;2;0;2;1
6761; 31.7 ; 95.2 ; 18.6 ;3;151;11;0;3;2;1;2;1;1;2;0
6762; 36.7 ; 587.8 ; 14.3 ;16;7;65;0;16;8;8;5;11;5;11;0
6763; 53.6 ; 160.8 ; 7.9 ;3;12;179;0;3;1;2;0;3;0;2;1
6764; 39.3 ; 432.5 ; 17.8 ;11;41;10;0;11;4;7;11;0;4;3;4
6765; 36.3 ; 72.5 ; 16.8 ;2;25;20;2;0;0;2;0;2;1;1;0
6766; 48.1 ; 144.3 ; 1.1 ;3;25;32;0;3;0;3;3;0;0;3;0
6767; 18.7 ; 74.9 ; 7.9 ;4;40;184;0;4;3;1;1;3;4;0;0
6768; 55.7 ; 167.1 ; 15.7 ;3;63;100;0;3;0;3;2;1;0;0;3
6769; 116.6 ; 582.9 ; 26.7 ;5;23;47;0;5;1;4;4;1;0;0;5
6770; 42.5 ; 85.0 ; 6.4 ;2;18;104;0;2;0;2;2;0;0;2;0
6771; 79.5 ; 159.0 ; 40.4 ;2;130;69;0;2;0;2;1;1;0;0;2
6772; 18.3 ; 55.0 ; 6.2 ;3;5;38;0;3;0;3;1;2;3;0;0
6773; 35.1 ; 105.4 ; 11.6 ;3;68;110;0;3;1;2;2;1;1;2;0
6774; 39.6 ; 158.2 ; 36.8 ;4;7;240;0;4;4;0;3;1;1;2;1
6775; 75.4 ; 377.1 ; 43.2 ;5;35;42;0;5;0;5;4;1;0;0;5
6776; 30.5 ; 61.0 ; 3.6 ;2;41;95;0;2;0;2;1;1;1;1;0
6777; 34.1 ; 68.2 ; 28.6 ;2;16;59;0;2;0;2;2;0;1;0;1
6778; 25.6 ; 51.3 ; -   ;2;2;222;0;2;2;0;0;2;2;0;0
6779; 26.1 ; 209.2 ; -   ;8;45;38;0;8;2;6;3;5;8;0;0
6780; 42.4 ; 339.5 ; 11.8 ;8;19;111;0;8;2;6;7;1;0;8;0
6781; 16.5 ; 49.6 ; 2.9 ;3;122;56;0;3;3;0;3;0;3;0;0
6782; 73.6 ; 368.0 ; 22.1 ;5;49;110;0;5;0;5;2;3;0;0;5
6783; 37.1 ; 334.2 ; 13.8 ;9;23;99;0;9;2;7;4;5;3;6;0
6784; 24.3 ; 121.3 ; 7.9 ;5;26;91;0;5;5;0;0;5;3;2;0
6785; 54.6 ; 109.3 ; 3.2 ;2;86;195;0;2;0;2;1;1;0;1;1
6786; 44.8 ; 89.6 ; 15.5 ;2;14;252;0;2;0;2;0;2;1;0;1
6787; 46.8 ; 93.5 ; -   ;2;80;279;0;2;0;2;1;1;0;2;0
6788; 36.2 ; 108.5 ; 19.4 ;3;14;270;0;3;1;2;2;1;1;1;1
6789; 53.4 ; 160.1 ; 3.8 ;3;17;228;0;3;1;2;1;2;0;2;1
6790; 56.0 ; 280.2 ; 2.6 ;5;47;73;0;5;1;4;2;3;0;0;5
6791; 40.5 ; 121.4 ; 7.1 ;3;56;6;0;3;0;3;1;2;0;3;0
6792; 36.2 ; 217.0 ; 22.6 ;6;19;284;0;6;2;4;4;2;2;2;2
6793; 82.9 ; 165.8 ; 48.0 ;2;49;266;0;2;2;0;2;0;0;0;2
6794; 37.3 ; 186.4 ; 15.9 ;5;47;68;0;5;1;4;1;4;2;3;0
6795; 42.3 ; 211.5 ; 14.5 ;5;49;239;0;5;4;1;2;3;2;1;2
6796; 57.1 ; 285.4 ; 5.7 ;5;10;57;0;5;0;5;5;0;0;0;5
6797; 24.4 ; 48.8 ; 8.7 ;2;83;28;2;0;2;0;0;2;1;1;0
6798; 22.7 ; 68.0 ; 3.7 ;3;17;236;0;3;2;1;0;3;3;0;0
6799; 19.7 ; 39.3 ; -   ;2;77;263;0;2;1;1;0;2;2;0;0
6800; 47.8 ; 95.7 ; 0.5 ;2;34;2;0;2;1;1;1;1;0;2;0
6801; 41.9 ; 335.1 ; 21.7 ;8;17;172;0;8;1;7;3;5;3;2;3
6802; 25.1 ; 50.1 ; -   ;2;25;246;0;2;0;2;1;1;2;0;0
6803; 47.7 ; 95.4 ; 1.4 ;2;207;131;0;2;0;2;2;0;0;2;0
6804; 47.5 ; 94.9 ; -   ;2;9;53;0;2;1;1;2;0;0;2;0
6805; 53.9 ; 107.8 ; 2.1 ;2;84;113;0;2;1;1;0;2;0;1;1
6806; 61.6 ; 184.8 ; 43.8 ;3;35;42;3;0;0;3;1;2;1;0;2
6807; 20.6 ; 638.5 ; 7.7 ;31;12;14;0;31;18;13;11;20;31;0;0
6808; 33.0 ; 65.9 ; 7.6 ;2;68;5;0;2;0;2;1;1;1;1;0
6809; 47.5 ; 190.0 ; 3.0 ;4;38;22;0;4;1;3;2;2;0;4;0
6810; 42.1 ; 126.3 ; 17.3 ;3;22;47;0;3;0;3;3;0;1;1;1
6811; 36.3 ; 108.9 ; 39.1 ;3;7;255;0;3;1;2;1;2;1;1;1
6812; 60.8 ; 1,945.3 ; 15.5 ;32;10;0;0;32;0;32;31;1;0;0;32
6813; 28.6 ; 142.9 ; 16.0 ;5;6;205;0;5;1;4;1;4;3;2;0
6814; 72.1 ; 144.1 ; 8.2 ;2;103;92;0;2;1;1;2;0;0;0;2
6815; 44.2 ; 176.6 ; 37.8 ;4;16;247;0;4;2;2;2;2;1;2;1
6816; 104.5 ; 313.6 ; 34.1 ;3;88;209;0;3;0;3;3;0;0;0;3
6817; 36.7 ; 110.2 ; 12.0 ;3;16;255;0;3;2;1;3;0;1;2;0
6818; 51.6 ; 309.4 ; 5.5 ;6;42;50;0;6;2;4;5;1;0;4;2
6819; 25.4 ; 457.3 ; 13.4 ;18;16;9;2;16;3;15;16;2;12;6;0
6820; 32.1 ; 352.9 ; 25.7 ;11;17;59;0;11;5;6;5;6;4;3;4
6821; 52.7 ; 105.4 ; 33.7 ;2;31;164;2;0;0;2;2;0;1;0;1
6822; 27.3 ; 82.0 ; 11.6 ;3;23;80;0;3;2;1;3;0;2;1;0
6823; 44.7 ; 670.5 ; 6.9 ;15;26;20;2;13;6;9;8;7;0;15;0
6824; 66.3 ; 199.0 ; 27.3 ;3;44;278;0;3;1;2;1;2;0;0;3
6825; 30.2 ; 90.6 ; -   ;3;13;73;0;3;0;3;3;0;0;3;0
6826; 49.8 ; 99.6 ; 4.6 ;2;50;126;0;2;0;2;1;1;0;2;0
6827; 46.2 ; 415.6 ; 16.7 ;9;37;16;0;9;1;8;4;5;3;3;3
6828; 43.4 ; 130.2 ; 17.9 ;3;16;269;0;3;1;2;1;2;1;1;1
6829; 35.7 ; 356.6 ; 16.7 ;10;31;0;0;10;3;7;8;2;3;7;0
6830; 41.2 ; 82.3 ; 2.1 ;2;1;317;0;2;2;0;0;2;0;2;0
6831; 19.8 ; 376.5 ; 9.9 ;19;10;2;0;19;8;11;5;14;19;0;0
6832; 47.7 ; 95.5 ; 1.5 ;2;93;196;0;2;1;1;2;0;0;2;0
6833; 35.6 ; 71.1 ; 8.0 ;2;3;281;0;2;1;1;0;2;1;1;0
6834; 23.4 ; 117.1 ; 11.0 ;5;21;145;0;5;3;2;4;1;3;2;0
6835; 22.8 ; 114.0 ; 6.3 ;5;80;44;0;5;2;3;1;4;5;0;0
6836; 47.7 ; 95.4 ; 1.4 ;2;104;160;0;2;1;1;1;1;0;2;0
6837; 26.8 ; 240.9 ; 9.2 ;9;45;5;3;6;7;2;1;8;6;3;0
6838; 25.0 ; 200.3 ; 11.9 ;8;61;7;0;8;3;5;1;7;5;3;0
6839; 18.2 ; 36.4 ; 0.6 ;2;4;216;0;2;0;2;1;1;2;0;0
6840; 87.9 ; 175.8 ; 36.4 ;2;15;343;0;2;1;1;2;0;0;0;2
6841; 48.7 ; 97.5 ; 5.7 ;2;210;35;0;2;1;1;1;1;0;2;0
6842; 46.8 ; 93.5 ; -   ;2;9;307;0;2;1;1;0;2;0;2;0
6843; 15.0 ; 209.8 ; -   ;14;16;2;14;0;7;7;7;7;14;0;0
6844; 52.2 ; 261.1 ; 21.5 ;5;12;8;0;5;3;2;1;4;0;3;2
6845; 33.8 ; 101.4 ; 17.3 ;3;70;84;0;3;1;2;2;1;1;2;0
6846; 47.1 ; 94.2 ; 0.5 ;2;38;78;2;0;0;2;2;0;0;2;0
6847; 32.2 ; 419.1 ; 7.6 ;13;16;14;1;12;7;6;9;4;4;9;0
6848; 23.2 ; 46.5 ; 2.7 ;2;259;62;0;2;1;1;2;0;2;0;0
6849; 25.2 ; 352.2 ; 6.8 ;14;17;8;0;14;9;5;2;12;9;5;0
6850; 15.0 ; 30.0 ; -   ;2;56;234;0;2;2;0;1;1;2;0;0
6851; 28.6 ; 85.9 ; 1.2 ;3;133;4;0;3;1;2;3;0;3;0;0
6852; 98.1 ; 196.1 ; 38.1 ;2;75;173;0;2;0;2;1;1;0;0;2
6853; 22.6 ; 45.1 ; 3.8 ;2;55;90;0;2;0;2;1;1;2;0;0
6854; 35.6 ; 142.3 ; 13.9 ;4;21;52;0;4;1;3;2;2;1;3;0
6855; 56.2 ; 224.8 ; 3.3 ;4;30;264;0;4;4;0;1;3;0;0;4
6856; 36.2 ; 181.0 ; 8.8 ;5;14;246;0;5;2;3;1;4;2;3;0
6857; 17.5 ; 104.7 ; 2.5 ;6;31;116;0;6;4;2;6;0;6;0;0
6858; 51.5 ; 309.2 ; 3.5 ;6;45;45;0;6;3;3;3;3;0;4;2
6859; 63.0 ; 188.9 ; 21.3 ;3;149;15;0;3;2;1;2;1;0;0;3
6860; 43.5 ; 87.0 ; 3.9 ;2;77;123;0;2;2;0;1;1;0;2;0
6861; 46.7 ; 140.0 ; 0.2 ;3;95;250;0;3;1;2;2;1;0;3;0
6862; 34.8 ; 139.2 ; 25.0 ;4;87;6;0;4;0;4;1;3;1;2;1
6863; 25.6 ; 51.2 ; 9.4 ;2;5;89;0;2;0;2;2;0;1;1;0
6864; 91.4 ; 182.8 ; 65.3 ;2;13;46;0;2;1;1;2;0;1;0;1
6865; 20.7 ; 434.6 ; 15.2 ;21;12;13;1;20;7;14;12;9;14;7;0
6866; 36.2 ; 181.0 ; 17.6 ;5;72;1;0;5;3;2;3;2;2;3;0
6867; 17.9 ; 197.2 ; 9.7 ;11;18;63;0;11;3;8;6;5;11;0;0
6868; 17.3 ; 172.8 ; 5.5 ;10;13;4;10;0;7;3;4;6;10;0;0
6869; 15.0 ; 45.0 ; -   ;3;85;244;0;3;2;1;3;0;3;0;0
6870; 29.4 ; 117.4 ; 27.0 ;4;60;28;0;4;3;1;4;0;3;0;1
6871; 47.5 ; 94.9 ; -   ;2;3;86;2;0;1;1;1;1;0;2;0
6872; 25.2 ; 126.0 ; 19.4 ;5;24;11;0;5;1;4;4;1;3;2;0
6873; 102.6 ; 410.2 ; 123.9 ;4;88;50;0;4;3;1;3;1;1;0;3
6874; 19.1 ; 38.3 ; 0.8 ;2;20;193;0;2;1;1;0;2;2;0;0
6875; 51.7 ; 413.4 ; 9.0 ;8;33;45;0;8;2;6;1;7;0;5;3
6876; 24.5 ; 122.4 ; 3.3 ;5;23;92;5;0;3;2;3;2;5;0;0
6877; 46.8 ; 93.5 ; -   ;2;131;174;0;2;0;2;0;2;0;2;0
6878; 45.5 ; 91.1 ; 2.9 ;2;37;32;0;2;0;2;0;2;0;2;0
6879; 24.8 ; 74.5 ; 3.4 ;3;59;280;0;3;2;1;1;2;3;0;0
6880; 23.2 ; 185.9 ; 10.0 ;8;41;15;0;8;4;4;2;6;5;3;0
6881; 66.3 ; 132.7 ; 12.7 ;2;82;41;1;1;0;2;1;1;0;0;2
6882; 53.1 ; 212.4 ; 5.5 ;4;70;5;0;4;2;2;2;2;0;3;1
6883; 45.1 ; 360.4 ; 19.5 ;8;16;35;2;6;2;6;4;4;3;2;3
6884; 27.0 ; 81.0 ; 1.8 ;3;50;101;0;3;0;3;1;2;3;0;0
6885; 51.7 ; 413.4 ; 17.7 ;8;59;11;0;8;2;6;6;2;0;5;3
6886; 15.0 ; 89.9 ; -   ;6;28;246;0;6;0;6;1;5;6;0;0
6887; 32.7 ; 261.5 ; 13.1 ;8;28;14;0;8;3;5;3;5;3;5;0
6888; 23.1 ; 207.8 ; 12.2 ;9;14;26;0;9;5;4;2;7;6;3;0
6889; 50.5 ; 100.9 ; 20.8 ;2;32;83;0;2;1;1;2;0;1;0;1
6890; 64.7 ; 129.5 ; 18.3 ;2;52;258;0;2;1;1;0;2;0;0;2
6891; 25.1 ; 50.1 ; -   ;2;50;111;0;2;0;2;2;0;2;0;0
6892; 41.2 ; 988.2 ; 42.2 ;24;5;16;24;0;10;14;9;15;8;8;8
6893; 42.2 ; 463.9 ; 14.3 ;11;30;10;0;11;1;10;10;1;4;3;4
6894; 39.4 ; 196.8 ; 13.9 ;5;20;28;0;5;3;2;2;3;2;3;0
6895; 51.8 ; 518.1 ; 53.0 ;10;29;4;0;10;8;2;9;1;3;4;3
6896; 44.8 ; 492.3 ; 12.2 ;11;39;36;0;11;1;10;2;9;0;7;4
6897; 42.9 ; 772.8 ; 16.5 ;18;19;2;0;18;6;12;6;12;6;6;6
6898; 28.9 ; 115.6 ; 2.7 ;4;42;67;1;3;3;1;4;0;3;1;0
6899; 33.4 ; 66.8 ; 4.8 ;2;46;233;0;2;2;0;1;1;1;1;0
6900; 15.0 ; 74.9 ; -   ;5;18;86;1;4;1;4;3;2;5;0;0
6901; 25.1 ; 75.4 ; 9.3 ;3;29;29;3;0;2;1;3;0;2;1;0
6902; 42.4 ; 84.9 ; 17.3 ;2;3;18;2;0;1;1;1;1;1;0;1
6903; 43.6 ; 174.5 ; 24.0 ;4;82;7;3;1;4;0;1;3;1;2;1
6904; 34.2 ; 136.9 ; 14.9 ;4;58;224;0;4;3;1;1;3;1;3;0
6905; 47.6 ; 95.2 ; 1.2 ;2;11;239;0;2;1;1;1;1;0;2;0
6906; 16.4 ; 49.3 ; 2.6 ;3;54;53;0;3;1;2;3;0;3;0;0
6907; 29.3 ; 615.1 ; 14.2 ;21;17;63;0;21;4;17;8;13;14;7;0
6908; 15.0 ; 45.0 ; -   ;3;14;350;0;3;2;1;3;0;3;0;0
6909; 44.7 ; 223.6 ; 4.8 ;5;30;263;0;5;0;5;3;2;0;5;0
6910; 32.5 ; 64.9 ; 12.7 ;2;7;79;0;2;1;1;1;1;1;1;0
6911; 55.0 ; 110.0 ; 3.7 ;2;284;56;0;2;1;1;2;0;0;0;2
6912; 47.5 ; 142.4 ; -   ;3;25;58;1;2;0;3;1;2;0;3;0
6913; 67.7 ; 270.7 ; 48.1 ;4;16;2;0;4;2;2;3;1;1;0;3
6914; 46.0 ; 184.1 ; 15.6 ;4;15;182;0;4;3;1;2;2;0;3;1
6915; 15.7 ; 31.5 ; 0.2 ;2;18;164;0;2;2;0;2;0;2;0;0
6916; 41.1 ; 246.8 ; 11.4 ;6;41;1;1;5;2;4;6;0;2;4;0
6917; 80.5 ; 161.0 ; 92.7 ;2;2;123;0;2;1;1;2;0;1;0;1
6918; 39.2 ; 78.4 ; 13.5 ;2;87;2;0;2;1;1;1;1;1;1;0
6919; 48.6 ; 242.9 ; 7.0 ;5;59;15;0;5;1;4;1;4;0;3;2
6920; 22.6 ; 45.2 ; 11.4 ;2;33;234;0;2;1;1;2;0;1;1;0
6921; 29.9 ; 89.7 ; 18.4 ;3;105;40;0;3;2;1;1;2;2;1;0
6922; 23.5 ; 211.2 ; 12.1 ;9;10;239;0;9;2;7;3;6;6;3;0
6923; 91.9 ; 459.7 ; 36.3 ;5;29;128;0;5;2;3;1;4;0;0;5
6924; 32.5 ; 162.6 ; 13.6 ;5;28;52;0;5;1;4;0;5;2;3;0
6925; 65.2 ; 195.7 ; 33.2 ;3;162;99;0;3;1;2;2;1;0;0;3
6926; 33.6 ; 168.2 ; 13.8 ;5;81;5;0;5;1;4;3;2;2;3;0
6927; 68.8 ; 137.7 ; 19.0 ;2;76;236;0;2;0;2;0;2;0;0;2
6928; 27.2 ; 54.5 ; 3.2 ;2;8;374;0;2;2;0;0;2;1;1;0
6929; 74.9 ; 149.8 ; -   ;2;113;43;0;2;0;2;2;0;0;0;2
6930; 40.2 ; 120.5 ; 5.5 ;3;25;230;0;3;0;3;2;1;0;3;0
6931; 19.1 ; 38.3 ; 0.8 ;2;118;11;0;2;0;2;1;1;2;0;0
6932; 52.1 ; 416.8 ; 18.4 ;8;35;55;0;8;2;6;6;2;0;5;3
6933; 43.2 ; 172.8 ; 7.9 ;4;14;63;0;4;3;1;0;4;0;4;0
6934; 36.6 ; 402.1 ; 8.7 ;11;17;12;0;11;2;9;11;0;4;7;0
6935; 60.5 ; 362.9 ; 54.3 ;6;32;10;0;6;2;4;3;3;2;0;4
6936; 141.2 ; 2,541.0 ; 49.8 ;18;18;15;0;18;0;18;16;2;0;0;18
6937; 60.3 ; 361.9 ; 9.6 ;6;50;37;0;6;0;6;3;3;0;0;6
6938; 27.4 ; 54.8 ; 18.5 ;2;18;184;0;2;0;2;0;2;1;1;0
6939; 16.5 ; 82.5 ; 2.0 ;5;22;78;0;5;0;5;1;4;5;0;0
6940; 59.5 ; 476.2 ; 28.2 ;8;41;59;0;8;4;4;5;3;0;0;8
6941; 43.3 ; 216.5 ; 34.1 ;5;25;35;0;5;3;2;3;2;2;1;2
6942; 61.4 ; 982.9 ; 19.3 ;16;19;5;0;16;0;16;16;0;0;0;16
6943; 49.1 ; 98.1 ; 2.9 ;2;118;152;0;2;1;1;1;1;0;2;0
6944; 48.4 ; 145.2 ; 2.4 ;3;34;89;0;3;0;3;3;0;0;3;0
6945; 35.2 ; 246.2 ; 17.7 ;7;28;68;0;7;1;6;4;3;2;5;0
6946; 51.8 ; 362.9 ; 3.3 ;7;50;0;0;7;0;7;5;2;0;5;2
6947; 34.6 ; 831.3 ; 13.4 ;24;12;17;0;24;4;20;24;0;8;16;0
6948; 32.4 ; 129.5 ; 28.1 ;4;20;162;0;4;3;1;0;4;1;2;1
6949; 33.4 ; 66.8 ; 4.8 ;2;33;15;0;2;1;1;1;1;1;1;0
6950; 29.3 ; 175.8 ; 18.9 ;6;31;11;0;6;0;6;3;3;4;2;0
6951; 62.1 ; 310.3 ; 12.9 ;5;46;15;0;5;0;5;5;0;0;0;5
6952; 15.0 ; 59.9 ; -   ;4;29;276;0;4;3;1;1;3;4;0;0
6953; 28.5 ; 85.4 ; 3.1 ;3;9;153;0;3;0;3;2;1;2;1;0
6954; 31.1 ; 62.2 ; -   ;2;11;164;0;2;1;1;0;2;0;2;0
6955; 39.9 ; 319.0 ; 8.3 ;8;15;30;0;8;7;1;7;1;0;8;0
6956; 25.1 ; 50.1 ; -   ;2;49;16;0;2;0;2;0;2;2;0;0
6957; 31.8 ; 63.7 ; 25.2 ;2;31;74;0;2;0;2;1;1;1;0;1
6958; 15.0 ; 119.9 ; -   ;8;18;131;0;8;0;8;8;0;8;0;0
6959; 51.7 ; 982.9 ; 4.9 ;19;12;10;0;19;1;18;6;13;0;13;6
6960; 40.3 ; 80.6 ; 22.8 ;2;9;160;0;2;1;1;1;1;1;0;1
6961; 32.2 ; 64.4 ; 9.1 ;2;65;244;0;2;2;0;1;1;1;1;0
6962; 47.2 ; 141.7 ; 6.6 ;3;18;74;3;0;0;3;1;2;0;3;0
6963; 55.9 ; 111.8 ; 2.9 ;2;19;199;0;2;0;2;2;0;0;0;2
6964; 49.5 ; 99.0 ; 19.3 ;2;81;146;0;2;0;2;2;0;0;1;1
6965; 54.2 ; 108.3 ; 2.5 ;2;75;152;0;2;0;2;2;0;0;1;1
6966; 64.1 ; 1,474.3 ; 14.8 ;23;14;5;0;23;0;23;23;0;0;0;23
6967; 27.5 ; 137.6 ; 29.7 ;5;54;95;0;5;3;2;4;1;3;0;2
6968; 81.2 ; 324.7 ; 28.9 ;4;94;41;0;4;3;1;3;1;0;0;4
6969; 42.7 ; 554.6 ; 17.1 ;13;25;5;0;13;9;4;12;1;4;5;4
6970; 20.1 ; 60.2 ; 0.6 ;3;90;0;0;3;1;2;2;1;3;0;0
6971; 25.8 ; 180.4 ; 7.5 ;7;34;2;0;7;3;4;0;7;5;2;0
6972; 26.7 ; 133.3 ; 13.1 ;5;7;44;0;5;1;4;3;2;3;2;0
6973; 17.0 ; 102.3 ; 2.0 ;6;22;86;0;6;4;2;4;2;6;0;0
6974; 39.7 ; 635.4 ; 18.7 ;16;20;15;0;16;4;12;4;12;5;6;5
6975; 28.2 ; 84.6 ; 5.3 ;3;126;11;0;3;0;3;2;1;2;1;0
6976; 23.7 ; 261.0 ; 10.6 ;11;42;6;5;6;2;9;3;8;7;4;0
6977; 18.0 ; 36.0 ; 2.9 ;2;18;155;0;2;2;0;0;2;2;0;0
6978; 25.6 ; 76.8 ; 7.4 ;3;66;85;0;3;0;3;0;3;2;1;0
6979; 50.3 ; 301.9 ; 3.1 ;6;28;74;0;6;1;5;3;3;0;6;0
6980; 37.9 ; 75.8 ; 27.3 ;2;93;74;0;2;0;2;2;0;1;0;1
6981; 47.7 ; 143.1 ; 0.4 ;3;14;16;1;2;1;2;3;0;0;3;0
6982; 42.3 ; 169.0 ; 12.2 ;4;50;99;0;4;0;4;1;3;0;4;0
6983; 30.5 ; 121.9 ; 19.2 ;4;50;110;0;4;2;2;3;1;1;3;0
6984; 24.4 ; 48.8 ; 2.6 ;2;5;29;0;2;2;0;1;1;2;0;0
6985; 25.6 ; 51.3 ; 6.8 ;2;19;246;0;2;0;2;0;2;1;1;0
6986; 29.0 ; 145.0 ; 10.2 ;5;46;12;0;5;3;2;1;4;3;2;0
6987; 24.9 ; 49.9 ; 6.7 ;2;10;195;2;0;0;2;0;2;1;1;0
6988; 35.1 ; 70.2 ; 5.9 ;2;39;356;0;2;0;2;1;1;1;1;0
6989; 56.4 ; 225.5 ; 21.4 ;4;71;115;0;4;1;3;2;2;0;0;4
6990; 25.1 ; 50.1 ; -   ;2;7;98;0;2;1;1;1;1;2;0;0
6991; 21.7 ; 152.1 ; 3.3 ;7;23;119;0;7;0;7;7;0;7;0;0
6992; 63.0 ; 189.0 ; 28.0 ;3;97;131;0;3;1;2;3;0;0;0;3
6993; 22.6 ; 430.2 ; 7.8 ;19;12;11;0;19;7;12;9;10;13;6;0
6994; 25.1 ; 75.2 ; -   ;3;40;138;0;3;2;1;2;1;3;0;0
6995; 22.5 ; 44.9 ; 11.2 ;2;43;278;0;2;0;2;0;2;1;1;0
6996; 20.6 ; 885.6 ; 9.2 ;43;5;196;0;43;22;21;12;31;43;0;0
6997; 93.5 ; 187.0 ; -   ;2;5;248;0;2;0;2;1;1;0;0;2
6998; 47.5 ; 142.5 ; 57.1 ;3;49;99;0;3;2;1;3;0;1;1;1
6999; 20.0 ; 40.1 ; 7.6 ;2;248;41;0;2;1;1;1;1;2;0;0
7000; 22.3 ; 111.3 ; 12.9 ;5;43;13;0;5;0;5;3;2;3;2;0
7001; 59.2 ; 295.8 ; 19.9 ;5;52;49;0;5;1;4;4;1;0;0;5
7002; 45.3 ; 135.8 ; 13.1 ;3;76;20;0;3;0;3;3;0;0;2;1
7003; 26.3 ; 210.7 ; 13.5 ;8;38;26;0;8;2;6;6;2;5;3;0
7004; 23.8 ; 47.7 ; 6.1 ;2;14;229;0;2;2;0;2;0;2;0;0
7005; 104.7 ; 523.6 ; 40.6 ;5;62;27;0;5;1;4;3;2;0;0;5
7006; 28.4 ; 113.5 ; 7.3 ;4;34;128;0;4;2;2;3;1;3;1;0
7007; 66.6 ; 133.1 ; 54.5 ;2;28;55;0;2;1;1;2;0;1;0;1
7008; 24.0 ; 167.9 ; 6.3 ;7;14;274;0;7;1;6;1;6;5;2;0
7009; 114.5 ; 343.5 ; 61.1 ;3;98;22;0;3;1;2;1;2;0;0;3
7010; 29.7 ; 89.2 ; 3.1 ;3;61;139;0;3;2;1;1;2;2;1;0
7011; 48.0 ; 671.4 ; 3.9 ;14;29;15;0;14;0;14;10;4;0;14;0
7012; 48.1 ; 865.2 ; 6.0 ;18;22;11;0;18;3;15;2;16;0;18;0
7013; 29.6 ; 177.7 ; 17.1 ;6;53;52;0;6;1;5;0;6;4;2;0
7014; 35.4 ; 318.9 ; 3.1 ;9;33;1;0;9;1;8;5;4;0;9;0
7015; 48.1 ; 336.9 ; 13.9 ;7;9;257;0;7;2;5;2;5;0;5;2
7016; 39.1 ; 195.6 ; 15.3 ;5;26;162;0;5;1;4;2;3;2;3;0
7017; 31.1 ; 93.3 ; 10.0 ;3;14;312;0;3;3;0;1;2;1;2;0
7018; 44.8 ; 89.6 ; 2.9 ;2;51;120;0;2;0;2;0;2;0;2;0
7019; 73.3 ; 1,611.6 ; 31.0 ;22;15;14;0;22;5;17;16;6;0;0;22
7020; 31.5 ; 94.5 ; 18.4 ;3;4;281;0;3;3;0;3;0;1;2;0
7021; 35.2 ; 316.4 ; 24.5 ;9;52;0;0;9;0;9;8;1;3;3;3
7022; 65.8 ; 131.7 ; 6.7 ;2;1;248;0;2;1;1;2;0;0;0;2
7023; 30.2 ; 60.4 ; -   ;2;24;94;0;2;0;2;2;0;0;2;0
7024; 27.2 ; 517.4 ; 10.8 ;19;17;11;0;19;12;7;18;1;13;6;0
7025; 33.3 ; 299.8 ; 23.2 ;9;22;213;0;9;7;2;6;3;3;3;3
7026; 78.7 ; 472.2 ; 37.1 ;6;33;89;0;6;0;6;3;3;0;0;6
7027; 38.5 ; 384.5 ; 17.0 ;10;39;2;0;10;1;9;3;7;3;4;3
7028; 58.7 ; 293.3 ; 32.9 ;5;57;65;0;5;4;1;1;4;2;0;3
7029; 36.6 ; 73.2 ; -   ;2;169;121;0;2;0;2;2;0;0;2;0
7030; 23.5 ; 376.0 ; 7.7 ;16;17;30;0;16;10;6;5;11;11;5;0
7031; 50.9 ; 254.6 ; 4.5 ;5;22;5;0;5;0;5;5;0;0;3;2
7032; 19.2 ; 268.5 ; 4.1 ;14;14;11;0;14;6;8;10;4;14;0;0
7033; 59.2 ; 177.6 ; 12.2 ;3;65;170;0;3;2;1;0;3;0;0;3
7034; 57.7 ; 115.4 ; 7.8 ;2;2;294;0;2;1;1;0;2;0;0;2
7035; 44.1 ; 220.4 ; 4.8 ;5;49;99;0;5;0;5;5;0;0;5;0
7036; 69.6 ; 417.8 ; 22.5 ;6;50;26;0;6;0;6;3;3;0;0;6
7037; 16.1 ; 177.1 ; 1.9 ;11;13;3;0;11;1;10;1;10;11;0;0
7038; 18.4 ; 36.8 ; 5.1 ;2;265;104;0;2;0;2;0;2;2;0;0
7039; 37.6 ; 112.9 ; 11.1 ;3;121;73;0;3;1;2;0;3;1;2;0
7040; 40.5 ; 81.0 ; 14.3 ;2;13;0;0;2;0;2;1;1;1;1;0
7041; 24.0 ; 48.0 ; 9.3 ;2;5;200;0;2;0;2;2;0;1;1;0
7042; 34.0 ; 136.0 ; 12.0 ;4;57;133;0;4;3;1;0;4;1;3;0
7043; 40.0 ; 120.0 ; 13.7 ;3;11;69;0;3;1;2;1;2;1;2;0
7044; 50.6 ; 253.2 ; 5.6 ;5;61;62;0;5;1;4;4;1;0;3;2
7045; 46.1 ; 184.5 ; 11.8 ;4;17;52;4;0;1;3;4;0;0;3;1
7046; 29.7 ; 148.3 ; 9.2 ;5;44;65;0;5;3;2;2;3;3;2;0
7047; 20.3 ; 182.4 ; 7.7 ;9;6;1;0;9;0;9;6;3;9;0;0
7048; 47.1 ; 94.2 ; 0.5 ;2;273;31;1;1;1;1;2;0;0;2;0
7049; 62.5 ; 312.5 ; 48.3 ;5;14;52;0;5;0;5;5;0;2;0;3
7050; 15.6 ; 77.9 ; 1.4 ;5;50;70;2;3;4;1;5;0;5;0;0
7051; 24.3 ; 72.8 ; 8.3 ;3;9;221;0;3;0;3;1;2;2;1;0
7052; 47.5 ; 94.9 ; -   ;2;88;26;2;0;0;2;2;0;0;2;0
7053; 36.3 ; 834.8 ; 30.2 ;23;17;32;0;23;10;13;8;15;8;7;8
7054; 22.5 ; 202.2 ; 10.3 ;9;23;35;0;9;4;5;4;5;6;3;0
7055; 22.4 ; 44.8 ; 4.0 ;2;5;268;0;2;0;2;2;0;2;0;0
7056; 36.2 ; 760.9 ; 26.9 ;21;15;110;0;21;9;12;19;2;7;7;7
7057; 55.3 ; 276.6 ; 9.8 ;5;39;8;0;5;4;1;1;4;0;0;5
7058; 54.6 ; 109.3 ; 7.6 ;2;13;146;0;2;0;2;2;0;0;1;1
7059; 72.3 ; 144.6 ; 36.1 ;2;1;9;0;2;1;1;1;1;0;0;2
7060; 23.1 ; 46.2 ; 12.1 ;2;11;47;0;2;1;1;1;1;1;1;0
7061; 15.0 ; 30.0 ; -   ;2;75;224;0;2;2;0;2;0;2;0;0
7062; 33.5 ; 970.7 ; 31.4 ;29;12;5;0;29;0;29;29;0;10;9;10
7063; 46.3 ; 231.6 ; 19.7 ;5;7;246;0;5;1;4;5;0;2;1;2
7064; 44.3 ; 265.8 ; 19.3 ;6;19;15;0;6;1;5;2;4;2;2;2
7065; 58.9 ; 117.8 ; 9.6 ;2;76;199;0;2;0;2;2;0;0;0;2
7066; 30.5 ; 152.7 ; 9.1 ;5;44;6;1;4;0;5;3;2;2;3;0
7067; 36.6 ; 73.2 ; -   ;2;5;221;0;2;0;2;0;2;0;2;0
7068; 24.8 ; 372.3 ; 2.9 ;15;17;33;0;15;7;8;11;4;15;0;0
7069; 46.4 ; 139.3 ; 20.2 ;3;122;101;0;3;0;3;2;1;1;1;1
7070; 57.1 ; 228.2 ; 8.9 ;4;8;215;0;4;1;3;1;3;0;0;4
7071; 22.4 ; 469.5 ; 9.4 ;21;14;17;0;21;13;8;13;8;14;7;0
7072; 30.8 ; 61.7 ; 8.6 ;2;220;16;0;2;0;2;0;2;1;1;0
7073; 81.2 ; 568.6 ; 30.9 ;7;26;15;0;7;2;5;6;1;0;0;7
7074; 53.9 ; 809.2 ; 41.1 ;15;18;11;0;15;0;15;12;3;5;5;5
7075; 46.8 ; 140.5 ; 18.8 ;3;117;89;0;3;0;3;2;1;1;1;1
7076; 39.7 ; 79.5 ; 27.1 ;2;4;259;0;2;1;1;0;2;1;0;1
7077; 51.3 ; 205.3 ; 34.9 ;4;72;69;0;4;2;2;3;1;1;2;1
7078; 24.3 ; 194.7 ; 11.0 ;8;30;17;0;8;2;6;1;7;5;3;0
7079; 41.0 ; 573.3 ; 21.3 ;14;29;13;0;14;4;10;6;8;5;4;5
7080; 30.5 ; 274.5 ; 19.9 ;9;24;80;0;9;3;6;6;3;3;6;0
7081; 27.4 ; 1,178.0 ; 7.9 ;43;7;3;0;43;17;26;5;38;29;14;0
7082; 45.4 ; 590.6 ; 12.2 ;13;19;101;0;13;8;5;5;8;0;9;4
7083; 34.6 ; 242.3 ; 12.6 ;7;14;109;7;0;5;2;6;1;2;5;0
7084; 28.0 ; 336.4 ; 12.8 ;12;9;86;0;12;8;4;5;7;8;4;0
7085; 15.0 ; 45.0 ; -   ;3;61;8;0;3;1;2;1;2;3;0;0
7086; 17.3 ; 121.0 ; 3.5 ;7;8;153;0;7;0;7;2;5;7;0;0
7087; 49.8 ; 199.2 ; 5.9 ;4;113;26;0;4;0;4;4;0;0;3;1
7088; 44.9 ; 448.7 ; 22.6 ;10;15;2;0;10;7;3;1;9;3;4;3
7089; 28.9 ; 86.6 ; 12.8 ;3;14;251;0;3;3;0;2;1;2;1;0
7090; 71.6 ; 214.9 ; 49.4 ;3;43;115;0;3;2;1;1;2;1;0;2
7091; 15.0 ; 30.0 ; -   ;2;143;104;0;2;1;1;0;2;2;0;0
7092; 85.0 ; 254.9 ; 35.6 ;3;29;47;0;3;1;2;3;0;0;0;3
7093; 15.0 ; 134.9 ; -   ;9;8;5;0;9;3;6;6;3;9;0;0
7094; 46.0 ; 184.0 ; 7.1 ;4;94;21;0;4;1;3;2;2;0;4;0
7095; 46.0 ; 92.0 ; 2.2 ;2;6;32;0;2;0;2;0;2;0;2;0
7096; 25.1 ; 125.3 ; -   ;5;13;137;0;5;2;3;2;3;5;0;0
7097; 35.7 ; 107.1 ; 10.1 ;3;94;116;0;3;0;3;0;3;1;2;0
7098; 42.9 ; 128.8 ; 4.0 ;3;16;396;0;3;2;1;1;2;0;3;0
7099; 45.6 ; 91.1 ; 13.4 ;2;131;99;2;0;0;2;2;0;0;1;1
7100; 59.3 ; 118.6 ; 18.8 ;2;1;204;0;2;0;2;0;2;0;0;2
7101; 19.9 ; 338.7 ; 10.3 ;17;10;2;0;17;9;8;10;7;11;6;0
7102; 90.4 ; 632.5 ; 50.9 ;7;41;36;0;7;1;6;7;0;0;0;7
7103; 47.5 ; 237.4 ; 8.9 ;5;28;1;5;0;1;4;1;4;0;3;2
7104; 44.3 ; 133.0 ; 13.9 ;3;10;256;0;3;1;2;3;0;0;2;1
7105; 35.9 ; 71.8 ; 16.2 ;2;83;200;0;2;1;1;2;0;1;1;0
7106; 62.4 ; 311.8 ; 23.6 ;5;24;98;0;5;3;2;2;3;0;0;5
7107; 34.4 ; 68.9 ; -   ;2;17;169;0;2;0;2;0;2;0;2;0
7108; 25.3 ; 1,216.7 ; 6.9 ;48;7;55;0;48;16;32;32;16;32;16;0
7109; 15.0 ; 30.0 ; -   ;2;270;47;1;1;0;2;1;1;2;0;0
7110; 33.4 ; 66.8 ; 4.8 ;2;50;117;0;2;1;1;1;1;1;1;0
7111; 31.4 ; 534.1 ; 9.3 ;17;15;2;0;17;12;5;3;14;6;11;0
7112; 54.7 ; 164.2 ; 27.3 ;3;5;185;0;3;2;1;2;1;1;1;1
7113; 36.0 ; 288.0 ; 14.2 ;8;33;67;0;8;1;7;2;6;3;5;0
7114; 45.4 ; 90.8 ; 22.8 ;2;189;152;0;2;0;2;0;2;1;0;1
7115; 46.9 ; 234.5 ; 0.3 ;5;63;74;0;5;0;5;1;4;0;5;0
7116; 53.2 ; 159.7 ; 0.8 ;3;82;20;0;3;0;3;3;0;0;3;0
7117; 37.9 ; 303.2 ; 8.7 ;8;14;16;0;8;1;7;1;7;3;5;0
7118; 54.6 ; 273.1 ; 22.9 ;5;23;153;0;5;1;4;4;1;0;3;2
7119; 57.7 ; 346.3 ; 51.0 ;6;55;5;0;6;1;5;4;2;2;0;4
7120; 34.0 ; 135.9 ; 10.7 ;4;22;25;0;4;3;1;2;2;1;3;0
7121; 21.5 ; 43.1 ; 5.3 ;2;7;158;0;2;1;1;1;1;2;0;0
7122; 20.1 ; 60.2 ; 9.3 ;3;4;272;0;3;1;2;1;2;3;0;0
7123; 49.7 ; 99.4 ; 0.5 ;2;107;10;0;2;0;2;2;0;0;2;0
7124; 58.0 ; 116.0 ; 22.7 ;2;27;372;0;2;0;2;2;0;0;0;2
7125; 23.9 ; 429.6 ; 6.0 ;18;15;31;0;18;5;13;6;12;18;0;0
7126; 19.5 ; 39.0 ; 2.3 ;2;20;37;0;2;0;2;2;0;2;0;0
7127; 33.4 ; 66.8 ; 4.8 ;2;42;48;0;2;0;2;1;1;1;1;0
7128; 65.1 ; 130.2 ; 3.6 ;2;50;158;0;2;0;2;2;0;0;0;2
7129; 62.7 ; 125.3 ; 15.0 ;2;266;60;0;2;1;1;2;0;0;0;2
7130; 16.5 ; 33.0 ; 2.3 ;2;100;173;0;2;0;2;2;0;2;0;0
7131; 18.7 ; 93.7 ; 2.2 ;5;72;26;0;5;2;3;2;3;5;0;0
7132; 38.8 ; 77.7 ; 12.9 ;2;78;27;0;2;1;1;2;0;1;1;0
7133; 56.5 ; 225.9 ; 75.4 ;4;52;123;0;4;3;1;3;1;1;0;3
7134; 39.8 ; 119.3 ; 13.5 ;3;121;59;0;3;3;0;1;2;1;2;0
7135; 45.1 ; 270.6 ; 27.3 ;6;40;62;0;6;1;5;4;2;2;2;2
7136; 49.6 ; 99.1 ; -   ;2;76;105;0;2;0;2;0;2;0;2;0
7137; 31.2 ; 62.5 ; 24.3 ;2;27;69;2;0;1;1;1;1;1;0;1
7138; 55.3 ; 221.3 ; 13.5 ;4;50;3;0;4;1;3;2;2;0;0;4
7139; 60.0 ; 1,260.0 ; 26.0 ;21;21;7;0;21;2;19;18;3;0;0;21
7140; 51.4 ; 205.7 ; 20.6 ;4;63;10;0;4;1;3;4;0;0;3;1
7141; 43.6 ; 261.4 ; 14.1 ;6;46;2;0;6;1;5;2;4;2;2;2
7142; 15.0 ; 30.0 ; -   ;2;66;208;0;2;1;1;1;1;2;0;0
7143; 24.0 ; 48.0 ; 10.7 ;2;24;256;0;2;2;0;2;0;1;1;0
7144; 39.2 ; 627.9 ; 21.2 ;16;14;62;0;16;8;8;7;9;5;6;5
7145; 20.0 ; 40.1 ; 7.6 ;2;59;57;1;1;1;1;1;1;2;0;0
7146; 18.7 ; 74.9 ; 7.9 ;4;35;128;0;4;1;3;2;2;4;0;0
7147; 54.1 ; 162.2 ; 13.4 ;3;40;189;0;3;2;1;1;2;0;2;1
7148; 33.7 ; 67.4 ; 19.4 ;2;76;125;1;1;0;2;1;1;1;1;0
7149; 72.6 ; 145.1 ; 63.5 ;2;210;194;0;2;1;1;1;1;1;0;1
7150; 34.8 ; 174.0 ; 14.5 ;5;31;22;0;5;0;5;2;3;2;3;0
7151; 32.3 ; 64.6 ; 3.2 ;2;9;229;0;2;1;1;2;0;1;1;0
7152; 15.0 ; 30.0 ; -   ;2;15;239;0;2;1;1;2;0;2;0;0
7153; 57.6 ; 115.3 ; -   ;2;25;57;0;2;0;2;0;2;0;0;2
7154; 60.8 ; 364.7 ; 36.8 ;6;47;33;0;6;0;6;3;3;2;0;4
7155; 52.5 ; 210.1 ; -   ;4;33;104;4;0;0;4;4;0;0;4;0
7156; 77.6 ; 155.2 ; 46.2 ;2;4;170;0;2;1;1;0;2;0;0;2
7157; 33.8 ; 506.9 ; 12.5 ;15;18;5;0;15;2;13;4;11;5;10;0
7158; 80.2 ; 401.2 ; 48.4 ;5;41;56;0;5;3;2;4;1;0;0;5
7159; 50.4 ; 151.3 ; 6.8 ;3;5;160;3;0;1;2;2;1;0;2;1
7160; 26.8 ; 107.0 ; 6.8 ;4;31;143;0;4;3;1;2;2;3;1;0
7161; 44.2 ; 132.6 ; 26.5 ;3;106;11;0;3;0;3;1;2;1;1;1
7162; 32.8 ; 131.0 ; 18.9 ;4;7;5;1;3;2;2;4;0;1;3;0
7163; 81.6 ; 408.1 ; 42.1 ;5;77;18;0;5;2;3;4;1;0;0;5
7164; 47.7 ; 95.5 ; 1.5 ;2;24;252;0;2;0;2;2;0;0;2;0
7165; 59.4 ; 178.3 ; 14.4 ;3;29;314;0;3;0;3;0;3;0;0;3
7166; 46.9 ; 328.4 ; 1.9 ;7;47;106;0;7;0;7;4;3;0;7;0
7167; 47.5 ; 94.9 ; -   ;2;22;77;0;2;1;1;0;2;0;2;0
7168; 48.0 ; 720.4 ; 8.3 ;15;18;53;0;15;4;11;5;10;0;10;5
7169; 28.9 ; 86.7 ; 7.0 ;3;70;5;0;3;2;1;2;1;2;1;0
7170; 35.9 ; 71.8 ; 16.2 ;2;147;228;0;2;1;1;0;2;1;1;0
7171; 52.5 ; 105.0 ; 7.4 ;2;83;78;0;2;0;2;2;0;0;1;1
7172; 68.0 ; 340.0 ; 17.7 ;5;51;5;0;5;0;5;5;0;0;0;5
7173; 23.7 ; 71.2 ; 3.3 ;3;62;146;0;3;2;1;3;0;3;0;0
7174; 35.1 ; 737.2 ; 14.2 ;21;18;8;0;21;8;13;9;12;7;14;0
7175; 55.6 ; 111.3 ; 2.7 ;2;212;36;0;2;1;1;0;2;0;0;2
7176; 44.0 ; 175.9 ; 13.6 ;4;148;7;0;4;2;2;1;3;0;3;1
7177; 63.5 ; 126.9 ; 19.5 ;2;79;233;0;2;1;1;1;1;0;0;2
7178; 25.4 ; 152.1 ; 6.8 ;6;20;11;0;6;3;3;1;5;4;2;0
7179; 25.3 ; 354.0 ; 14.4 ;14;25;62;0;14;1;13;9;5;9;5;0
7180; 34.0 ; 170.0 ; 14.8 ;5;25;1;1;4;4;1;4;1;2;3;0
7181; 15.0 ; 74.9 ; -   ;5;34;31;0;5;1;4;3;2;5;0;0
7182; 46.8 ; 140.3 ; -   ;3;31;186;0;3;2;1;1;2;0;3;0
7183; 56.4 ; 169.1 ; 15.9 ;3;28;215;0;3;0;3;3;0;0;0;3
7184; 41.6 ; 83.1 ; 16.4 ;2;23;242;0;2;0;2;1;1;1;0;1
7185; 25.3 ; 75.9 ; 11.0 ;3;9;74;0;3;0;3;2;1;2;1;0
7186; 185.0 ; 370.0 ; 204.9 ;2;158;20;0;2;0;2;1;1;1;0;1
7187; 40.5 ; 80.9 ; 0.6 ;2;14;74;0;2;1;1;1;1;0;2;0
7188; 37.2 ; 148.9 ; 12.7 ;4;80;70;0;4;3;1;2;2;1;3;0
7189; 18.4 ; 238.9 ; 5.6 ;13;27;3;0;13;6;7;6;7;13;0;0
7190; 57.6 ; 172.9 ; 9.3 ;3;14;65;3;0;2;1;3;0;0;0;3
7191; 15.0 ; 74.9 ; -   ;5;41;5;0;5;0;5;2;3;5;0;0
7192; 30.0 ; 60.1 ; 15.0 ;2;63;125;0;2;0;2;0;2;1;1;0
7193; 42.2 ; 84.4 ; 3.2 ;2;30;158;0;2;0;2;1;1;0;2;0
7194; 26.7 ; 53.4 ; 1.6 ;2;2;165;2;0;2;0;2;0;2;0;0
7195; 46.8 ; 93.5 ; -   ;2;18;273;0;2;0;2;2;0;0;2;0
7196; 40.1 ; 320.8 ; 13.9 ;8;56;2;0;8;7;1;2;6;3;5;0
7197; 24.7 ; 49.4 ; 0.6 ;2;107;115;1;1;0;2;2;0;2;0;0
7198; 29.5 ; 177.2 ; 12.7 ;6;49;52;0;6;0;6;6;0;4;2;0
7199; 48.0 ; 432.1 ; 7.8 ;9;32;21;0;9;2;7;6;3;0;6;3
7200; 46.5 ; 92.9 ; 24.4 ;2;85;50;1;1;1;1;1;1;1;0;1
7201; 31.2 ; 93.6 ; -   ;3;27;165;0;3;2;1;2;1;0;3;0
7202; 63.3 ; 316.4 ; 36.2 ;5;32;68;0;5;3;2;4;1;2;0;3
7203; 44.4 ; 88.8 ; 39.5 ;2;52;38;1;1;2;0;0;2;1;0;1
7204; 44.4 ; 266.4 ; 9.1 ;6;40;55;1;5;2;4;4;2;0;6;0
7205; 32.3 ; 129.2 ; 9.1 ;4;12;232;0;4;1;3;1;3;1;3;0
7206; 35.9 ; 71.8 ; 16.2 ;2;86;227;0;2;0;2;2;0;1;1;0
7207; 36.3 ; 399.4 ; 11.4 ;11;23;25;0;11;6;5;4;7;4;7;0
7208; 30.8 ; 61.7 ; 8.6 ;2;5;336;0;2;0;2;1;1;1;1;0
7209; 63.5 ; 508.0 ; 20.4 ;8;34;21;0;8;0;8;4;4;0;0;8
7210; 57.4 ; 286.9 ; 9.5 ;5;41;5;0;5;0;5;5;0;0;0;5
7211; 46.6 ; 93.1 ; 40.6 ;2;96;205;0;2;1;1;1;1;1;0;1
7212; 46.8 ; 93.5 ; -   ;2;1;161;0;2;1;1;0;2;0;2;0
7213; 67.3 ; 2,288.3 ; 56.8 ;34;11;5;0;34;7;27;29;5;11;0;23
7214; 17.2 ; 86.1 ; 5.3 ;5;21;31;0;5;1;4;4;1;5;0;0
7215; 15.0 ; 59.9 ; -   ;4;47;14;0;4;2;2;2;2;4;0;0
7216; 52.6 ; 157.9 ; 15.7 ;3;11;236;0;3;1;2;2;1;0;2;1
7217; 50.7 ; 253.6 ; 26.6 ;5;45;3;0;5;2;3;3;2;2;1;2
7218; 30.9 ; 61.7 ; 23.8 ;2;43;231;0;2;0;2;2;0;1;1;0
7219; 56.9 ; 170.8 ; 31.9 ;3;14;242;0;3;1;2;1;2;1;0;2
7220; 83.4 ; 417.2 ; 62.0 ;5;16;53;0;5;0;5;3;2;2;0;3
7221; 71.3 ; 1,354.2 ; 11.7 ;19;8;26;0;19;0;19;17;2;0;0;19
7222; 46.6 ; 2,423.0 ; 16.3 ;52;5;5;0;52;14;38;30;22;0;35;17
7223; 27.9 ; 55.9 ; 4.3 ;2;15;259;0;2;2;0;1;1;1;1;0
7224; 15.0 ; 30.0 ; -   ;2;67;59;0;2;1;1;2;0;2;0;0
7225; 33.2 ; 232.5 ; 13.0 ;7;11;149;7;0;6;1;7;0;2;5;0
7226; 46.8 ; 93.5 ; -   ;2;113;136;0;2;0;2;1;1;0;2;0
7227; 25.1 ; 125.5 ; 16.6 ;5;27;58;0;5;1;4;2;3;3;2;0
7228; 57.7 ; 288.4 ; 34.3 ;5;26;12;0;5;4;1;2;3;2;0;3
7229; 41.0 ; 82.0 ; 2.8 ;2;57;84;2;0;0;2;1;1;0;2;0
7230; 51.6 ; 154.7 ; 7.2 ;3;22;125;0;3;0;3;3;0;0;2;1
7231; 28.0 ; 139.9 ; 13.7 ;5;36;278;0;5;0;5;4;1;3;2;0
7232; 48.4 ; 580.5 ; 20.8 ;12;22;3;0;12;8;4;5;7;4;4;4
7233; 68.0 ; 136.0 ; 36.6 ;2;143;86;0;2;1;1;0;2;0;0;2
7234; 25.6 ; 51.3 ; 16.0 ;2;87;195;0;2;0;2;1;1;1;1;0
7235; 82.6 ; 247.9 ; 28.0 ;3;97;99;0;3;0;3;3;0;0;0;3
7236; 20.6 ; 534.4 ; 9.0 ;26;17;8;0;26;18;8;12;14;26;0;0
7237; 82.3 ; 1,070.1 ; 42.8 ;13;28;1;0;13;3;10;9;4;0;0;13
7238; 15.0 ; 30.0 ; -   ;2;13;104;0;2;0;2;2;0;2;0;0
7239; 35.4 ; 141.5 ; 17.0 ;4;13;241;0;4;1;3;2;2;1;3;0
7240; 25.1 ; 100.3 ; -   ;4;14;5;0;4;1;3;1;3;4;0;0
7241; 30.0 ; 89.9 ; 15.9 ;3;18;286;0;3;2;1;1;2;2;1;0
7242; 48.2 ; 96.3 ; 2.1 ;2;36;216;0;2;0;2;1;1;0;2;0
7243; 42.0 ; 125.9 ; 15.0 ;3;4;256;0;3;1;2;2;1;1;1;1
7244; 30.7 ; 582.5 ; 7.4 ;19;14;5;0;19;4;15;7;12;6;13;0
7245; 91.3 ; 182.7 ; 63.9 ;2;126;173;0;2;0;2;1;1;1;0;1
7246; 18.5 ; 55.5 ; 0.9 ;3;4;147;0;3;0;3;3;0;3;0;0
7247; 29.8 ; 416.5 ; 18.9 ;14;19;11;0;14;3;11;8;6;9;5;0
7248; 40.5 ; 121.4 ; 8.2 ;3;160;68;0;3;0;3;2;1;0;3;0
7249; 18.7 ; 93.5 ; 8.8 ;5;48;10;0;5;0;5;5;0;5;0;0
7250; 102.0 ; 203.9 ; 3.0 ;2;31;52;0;2;0;2;2;0;0;0;2
7251; 63.1 ; 126.3 ; 30.4 ;2;114;97;1;1;2;0;0;2;0;0;2
7252; 43.7 ; 218.6 ; 8.0 ;5;31;45;5;0;3;2;5;0;0;5;0
7253; 28.3 ; 396.0 ; 13.9 ;14;23;1;0;14;1;13;2;12;9;5;0
7254; 43.0 ; 215.2 ; 32.6 ;5;56;26;0;5;2;3;5;0;2;1;2
7255; 52.7 ; 158.0 ; 3.8 ;3;104;241;0;3;0;3;2;1;0;2;1
7256; 39.0 ; 234.2 ; 27.9 ;6;38;36;0;6;0;6;3;3;2;2;2
7257; 53.2 ; 691.4 ; 19.0 ;13;31;16;0;13;2;11;3;10;0;9;4
7258; 25.3 ; 101.1 ; 13.4 ;4;68;90;0;4;2;2;2;2;3;1;0
7259; 22.4 ; 67.3 ; 2.4 ;3;41;0;0;3;0;3;1;2;3;0;0
7260; 60.6 ; 242.3 ; 23.8 ;4;69;167;0;4;0;4;3;1;0;0;4
7261; 52.8 ; 739.5 ; 15.3 ;14;17;23;0;14;7;7;3;11;0;9;5
7262; 51.7 ; 258.3 ; 16.0 ;5;21;258;0;5;1;4;1;4;0;3;2
7263; 66.2 ; 265.0 ; 39.2 ;4;44;83;0;4;1;3;2;2;1;0;3
7264; 27.3 ; 218.6 ; 14.2 ;8;23;96;0;8;2;6;8;0;5;3;0
7265; 27.7 ; 138.7 ; 13.2 ;5;57;68;0;5;2;3;1;4;3;2;0
7266; 47.8 ; 191.0 ; 15.8 ;4;22;14;0;4;2;2;2;2;0;3;1
7267; 20.1 ; 60.2 ; 4.9 ;3;55;14;3;0;1;2;3;0;3;0;0
7268; 27.2 ; 1,223.2 ; 10.3 ;45;4;269;0;45;2;43;6;39;30;15;0
7269; 23.9 ; 119.5 ; 5.6 ;5;30;98;1;4;4;1;2;3;5;0;0
7270; 63.2 ; 126.5 ; 16.1 ;2;32;188;0;2;0;2;2;0;0;0;2
7271; 56.8 ; 340.9 ; 41.8 ;6;5;89;0;6;1;5;4;2;2;0;4
7272; 64.1 ; 384.5 ; 42.8 ;6;14;15;0;6;1;5;2;4;2;0;4
7273; 40.1 ; 80.2 ; 15.0 ;2;298;20;0;2;1;1;0;2;1;0;1
7274; 86.1 ; 516.4 ; 36.0 ;6;45;23;0;6;2;4;3;3;0;0;6
7275; 25.4 ; 101.5 ; 4.6 ;4;82;9;0;4;3;1;3;1;4;0;0
7276; 51.0 ; 255.2 ; 23.3 ;5;55;117;0;5;2;3;3;2;2;1;2
7277; 21.5 ; 107.6 ; 12.1 ;5;41;95;0;5;0;5;1;4;3;2;0
7278; 81.3 ; 406.3 ; 21.2 ;5;38;10;0;5;0;5;2;3;0;0;5
7279; 38.1 ; 457.2 ; 15.6 ;12;24;115;0;12;0;12;10;2;4;8;0
7280; 18.0 ; 90.1 ; 6.4 ;5;44;20;0;5;0;5;4;1;5;0;0
7281; 60.9 ; 121.8 ; 3.7 ;2;41;149;0;2;1;1;2;0;0;0;2
7282; 24.1 ; 216.5 ; 3.4 ;9;22;70;0;9;4;5;4;5;9;0;0
7283; 21.5 ; 43.1 ; 9.8 ;2;12;141;0;2;0;2;2;0;1;1;0
7284; 81.6 ; 571.2 ; 12.4 ;7;36;15;0;7;0;7;7;0;0;0;7
7285; 54.6 ; 218.6 ; 2.6 ;4;25;226;0;4;0;4;3;1;0;3;1
7286; 15.0 ; 30.0 ; -   ;2;10;41;0;2;1;1;2;0;2;0;0
7287; 16.0 ; 64.2 ; 2.3 ;4;31;139;4;0;2;2;2;2;4;0;0
7288; 55.0 ; 109.9 ; 3.1 ;2;25;183;0;2;0;2;1;1;0;1;1
7289; 29.5 ; 737.2 ; 18.3 ;25;12;2;0;25;18;7;15;10;17;8;0
7290; 15.4 ; 30.8 ; -   ;2;13;173;2;0;0;2;2;0;2;0;0
7291; 49.8 ; 99.7 ; -   ;2;13;162;0;2;0;2;2;0;0;2;0
7292; 34.7 ; 104.2 ; 13.7 ;3;119;81;0;3;3;0;1;2;1;2;0
7293; 34.1 ; 68.2 ; 28.6 ;2;279;83;1;1;0;2;2;0;1;0;1
7294; 102.4 ; 204.9 ; 5.8 ;2;35;122;0;2;0;2;2;0;0;0;2
7295; 46.2 ; 185.0 ; 2.6 ;4;34;177;0;4;1;3;2;2;0;4;0
7296; 41.1 ; 246.3 ; 7.5 ;6;5;11;1;5;0;6;0;6;0;6;0
7297; 38.8 ; 543.4 ; 11.7 ;14;22;24;0;14;1;13;3;11;5;9;0
7298; 95.9 ; 191.9 ; 13.6 ;2;18;220;0;2;0;2;1;1;0;0;2
7299; 15.0 ; 89.9 ; -   ;6;35;188;0;6;4;2;0;6;6;0;0
7300; 31.2 ; 592.7 ; 14.7 ;19;23;9;0;19;13;6;11;8;6;13;0
7301; 60.8 ; 365.1 ; 16.2 ;6;33;78;0;6;1;5;4;2;0;0;6
7302; 37.9 ; 75.8 ; 10.1 ;2;3;191;0;2;2;0;1;1;1;1;0
7303; 50.9 ; 152.6 ; 5.8 ;3;50;240;0;3;1;2;2;1;0;2;1
7304; 16.2 ; 48.6 ; 2.2 ;3;13;230;0;3;1;2;3;0;3;0;0
7305; 30.7 ; 61.5 ; 23.6 ;2;12;398;0;2;0;2;0;2;1;1;0
7306; 22.4 ; 44.7 ; 4.0 ;2;9;270;0;2;1;1;0;2;2;0;0
7307; 47.7 ; 95.5 ; 1.5 ;2;94;183;0;2;0;2;1;1;0;2;0
7308; 46.5 ; 185.8 ; 3.5 ;4;113;1;0;4;2;2;1;3;0;4;0
7309; 36.5 ; 182.6 ; 7.7 ;5;40;96;0;5;1;4;3;2;2;3;0
7310; 30.2 ; 60.4 ; -   ;2;14;62;0;2;1;1;1;1;0;2;0
7311; 35.7 ; 107.1 ; 10.1 ;3;144;99;0;3;1;2;2;1;1;2;0
7312; 80.8 ; 323.0 ; 31.5 ;4;35;268;0;4;1;3;1;3;0;0;4
7313; 37.6 ; 225.6 ; 31.0 ;6;19;6;0;6;1;5;4;2;2;2;2
7314; 145.5 ; 1,455.2 ; 120.1 ;10;14;1;6;4;8;2;7;3;3;0;7
7315; 46.8 ; 93.5 ; -   ;2;57;157;0;2;0;2;2;0;0;2;0
7316; 65.6 ; 196.9 ; 33.3 ;3;53;26;0;3;0;3;3;0;0;0;3
7317; 36.2 ; 217.2 ; 16.7 ;6;20;15;0;6;1;5;1;5;2;4;0
7318; 60.8 ; 121.6 ; 3.6 ;2;176;107;1;1;1;1;1;1;0;0;2
7319; 15.9 ; 47.8 ; 1.8 ;3;2;263;0;3;0;3;1;2;3;0;0
7320; 60.6 ; 121.2 ; 3.6 ;2;19;37;0;2;0;2;1;1;0;0;2
7321; 26.0 ; 286.1 ; 7.3 ;11;11;5;11;0;2;9;4;7;7;4;0
7322; 35.4 ; 318.2 ; 11.3 ;9;27;68;0;9;2;7;2;7;3;6;0
7323; 46.5 ; 325.8 ; 10.6 ;7;50;5;0;7;0;7;6;1;0;5;2
7324; 18.0 ; 89.9 ; 6.1 ;5;15;16;0;5;1;4;3;2;5;0;0
7325; 33.0 ; 132.1 ; 13.2 ;4;50;116;0;4;2;2;3;1;1;3;0
7326; 37.1 ; 111.4 ; 9.1 ;3;7;256;0;3;2;1;3;0;1;2;0
7327; 46.8 ; 93.5 ; -   ;2;2;275;0;2;1;1;2;0;0;2;0
7328; 40.3 ; 644.6 ; 10.9 ;16;12;56;0;16;8;8;7;9;5;11;0
7329; 37.5 ; 150.0 ; 40.9 ;4;23;0;0;4;2;2;2;2;1;2;1
7330; 34.7 ; 104.1 ; 13.0 ;3;34;47;0;3;1;2;2;1;1;2;0
7331; 42.8 ; 213.8 ; 23.7 ;5;4;284;0;5;0;5;3;2;2;1;2
7332; 25.8 ; 439.4 ; 9.9 ;17;13;77;0;17;14;3;9;8;11;6;0
7333; 34.4 ; 68.9 ; -   ;2;4;95;0;2;0;2;0;2;0;2;0
7334; 19.4 ; 77.7 ; 0.2 ;4;62;147;0;4;2;2;3;1;4;0;0
7335; 26.3 ; 210.5 ; 14.3 ;8;25;104;0;8;5;3;1;7;5;3;0
7336; 15.0 ; 30.0 ; -   ;2;44;155;0;2;2;0;2;0;2;0;0
7337; 34.5 ; 241.2 ; 11.0 ;7;33;30;4;3;1;6;4;3;2;5;0
7338; 37.1 ; 148.5 ; 18.3 ;4;95;31;0;4;0;4;4;0;1;2;1
7339; 61.5 ; 799.2 ; 30.5 ;13;32;5;0;13;0;13;10;3;0;0;13
7340; 21.4 ; 64.3 ; 8.2 ;3;14;135;0;3;3;0;3;0;3;0;0
7341; 26.4 ; 52.8 ; 10.7 ;2;10;152;0;2;1;1;0;2;1;1;0
7342; 42.2 ; 1,223.1 ; 26.0 ;29;9;56;0;29;18;11;13;16;10;9;10
7343; 85.1 ; 425.3 ; 117.9 ;5;43;66;0;5;1;4;2;3;2;0;3
7344; 27.7 ; 55.5 ; 12.6 ;2;1;173;2;0;0;2;2;0;1;1;0
7345; 17.2 ; 223.4 ; 2.9 ;13;17;101;0;13;5;8;13;0;13;0;0
7346; 35.4 ; 283.2 ; 28.8 ;8;15;6;8;0;6;2;8;0;3;2;3
7347; 76.8 ; 153.6 ; 36.4 ;2;163;164;0;2;0;2;2;0;0;0;2
7348; 130.7 ; 261.3 ; 10.8 ;2;5;242;0;2;0;2;2;0;0;0;2
7349; 55.3 ; 442.1 ; 13.7 ;8;14;36;0;8;0;8;3;5;0;0;8
7350; 52.1 ; 104.2 ; 8.0 ;2;49;236;0;2;1;1;0;2;0;1;1
7351; 29.5 ; 147.7 ; 15.4 ;5;26;204;0;5;0;5;2;3;3;2;0
7352; 40.2 ; 160.7 ; 7.5 ;4;35;147;0;4;1;3;1;3;0;4;0
7353; 47.4 ; 852.5 ; 21.5 ;18;18;75;0;18;8;10;11;7;6;6;6
7354; 15.0 ; 45.0 ; -   ;3;21;249;0;3;2;1;1;2;3;0;0
7355; 58.4 ; 116.8 ; 1.4 ;2;12;174;2;0;0;2;2;0;0;0;2
7356; 17.0 ; 85.0 ; 4.8 ;5;14;286;0;5;3;2;2;3;5;0;0
7357; 23.9 ; 167.2 ; 12.6 ;7;59;38;0;7;3;4;7;0;5;2;0
7358; 38.4 ; 230.2 ; 19.4 ;6;48;20;0;6;2;4;1;5;2;2;2
7359; 48.1 ; 96.1 ; 1.9 ;2;75;80;0;2;0;2;2;0;0;2;0
7360; 15.0 ; 45.0 ; -   ;3;18;99;0;3;2;1;2;1;3;0;0
7361; 36.6 ; 73.2 ; -   ;2;126;58;0;2;0;2;1;1;0;2;0
7362; 48.5 ; 242.7 ; 8.5 ;5;35;120;0;5;1;4;0;5;0;3;2
7363; 64.3 ; 257.0 ; 26.3 ;4;12;87;2;2;2;2;2;2;0;0;4
7364; 44.5 ; 133.4 ; 26.2 ;3;18;125;0;3;1;2;2;1;1;1;1
7365; 46.9 ; 93.7 ; 2.6 ;2;8;359;0;2;2;0;2;0;0;2;0
7366; 93.8 ; 468.9 ; 60.4 ;5;27;289;0;5;1;4;4;1;0;0;5
7367; 47.3 ; 756.2 ; 18.5 ;16;14;38;0;16;8;8;8;8;5;6;5
7368; 57.4 ; 114.8 ; 15.9 ;2;34;131;0;2;1;1;1;1;0;0;2
7369; 28.8 ; 259.0 ; 20.4 ;9;29;6;0;9;5;4;6;3;6;3;0
7370; 30.0 ; 419.4 ; 11.5 ;14;21;11;0;14;6;8;3;11;9;5;0
7371; 41.8 ; 417.8 ; 31.6 ;10;31;93;0;10;5;5;2;8;3;4;3
7372; 58.6 ; 585.7 ; 13.8 ;10;32;5;0;10;2;8;8;2;0;0;10
7373; 18.4 ; 991.4 ; 5.4 ;54;5;4;0;54;43;11;54;0;54;0;0
7374; 16.3 ; 97.7 ; 1.7 ;6;17;23;0;6;6;0;6;0;6;0;0
7375; 42.6 ; 85.3 ; 9.1 ;2;3;10;0;2;1;1;1;1;0;2;0
7376; 59.3 ; 296.7 ; 12.1 ;5;47;99;0;5;2;3;5;0;0;0;5
7377; 33.7 ; 168.6 ; 36.1 ;5;32;162;0;5;1;4;5;0;2;1;2
7378; 15.4 ; 46.3 ; 0.8 ;3;67;191;0;3;3;0;2;1;3;0;0
7379; 32.7 ; 65.4 ; 2.3 ;2;185;92;0;2;1;1;2;0;0;2;0
7380; 38.8 ; 77.7 ; 12.9 ;2;51;26;1;1;0;2;2;0;1;1;0
7381; 17.0 ; 85.0 ; 1.5 ;5;77;18;0;5;5;0;3;2;5;0;0
7382; 18.3 ; 55.0 ; 6.2 ;3;9;57;0;3;1;2;1;2;3;0;0
7383; 21.5 ; 85.8 ; 6.6 ;4;59;216;0;4;2;2;4;0;4;0;0
7384; 50.8 ; 253.8 ; 6.9 ;5;45;96;0;5;1;4;4;1;0;3;2
7385; 43.7 ; 306.0 ; 33.1 ;7;13;174;0;7;5;2;6;1;2;3;2
7386; 17.3 ; 207.6 ; 6.4 ;12;26;5;0;12;4;8;6;6;12;0;0
7387; 45.5 ; 227.6 ; 11.4 ;5;34;11;0;5;1;4;4;1;0;3;2
7388; 99.6 ; 498.0 ; 46.5 ;5;69;32;0;5;0;5;5;0;0;0;5
7389; 20.4 ; 40.8 ; 8.1 ;2;64;218;0;2;2;0;0;2;2;0;0
7390; 25.1 ; 50.1 ; -   ;2;3;181;0;2;1;1;1;1;2;0;0
7391; 45.1 ; 225.5 ; 17.6 ;5;63;11;0;5;0;5;1;4;2;1;2
7392; 52.9 ; 264.3 ; 15.1 ;5;11;5;0;5;1;4;3;2;0;3;2
7393; 38.8 ; 155.2 ; 16.8 ;4;93;31;0;4;1;3;2;2;1;2;1
7394; 17.4 ; 52.1 ; 2.2 ;3;5;274;0;3;2;1;1;2;3;0;0
7395; 23.7 ; 165.8 ; 10.9 ;7;22;170;0;7;0;7;3;4;5;2;0
7396; 34.9 ; 174.3 ; 6.2 ;5;84;1;0;5;1;4;3;2;2;3;0
7397; 36.5 ; 73.0 ; 9.5 ;2;32;144;0;2;2;0;2;0;1;1;0
7398; 26.2 ; 157.1 ; 9.8 ;6;14;199;0;6;2;4;3;3;4;2;0
7399; 20.5 ; 266.1 ; 3.0 ;13;27;79;0;13;3;10;6;7;13;0;0
7400; 54.7 ; 109.4 ; 44.4 ;2;8;259;0;2;2;0;2;0;1;0;1
7401; 26.1 ; 52.2 ; 11.2 ;2;93;67;0;2;2;0;0;2;1;1;0
7402; 15.0 ; 134.9 ; -   ;9;19;22;0;9;0;9;9;0;9;0;0
7403; 35.0 ; 244.7 ; 16.6 ;7;42;22;0;7;1;6;4;3;2;5;0
7404; 50.8 ; 507.8 ; 13.2 ;10;22;116;0;10;2;8;2;8;0;7;3
7405; 54.3 ; 488.3 ; 17.7 ;9;13;17;0;9;6;3;3;6;0;6;3
7406; 41.7 ; 83.4 ; 7.6 ;2;81;258;0;2;0;2;2;0;0;2;0
7407; 18.4 ; 36.9 ; 1.9 ;2;34;240;0;2;2;0;1;1;2;0;0
7408; 42.0 ; 336.3 ; 23.6 ;8;33;63;0;8;1;7;6;2;3;2;3
7409; 46.9 ; 375.4 ; 30.7 ;8;10;191;0;8;2;6;6;2;3;2;3
7410; 22.5 ; 112.4 ; 8.7 ;5;16;203;0;5;4;1;5;0;3;2;0
7411; 62.4 ; 312.2 ; 14.2 ;5;13;20;0;5;1;4;1;4;0;0;5
7412; 44.2 ; 132.7 ; 13.2 ;3;9;204;3;0;0;3;3;0;0;2;1
7413; 38.7 ; 116.1 ; 19.4 ;3;27;222;0;3;1;2;1;2;1;1;1
7414; 70.1 ; 140.3 ; 35.0 ;2;5;303;0;2;2;0;0;2;0;0;2
7415; 28.8 ; 115.2 ; 2.6 ;4;51;95;0;4;2;2;4;0;3;1;0
7416; 33.4 ; 500.9 ; 19.8 ;15;25;2;15;0;13;2;3;12;5;10;0
7417; 48.4 ; 145.1 ; 42.9 ;3;38;53;0;3;0;3;1;2;1;1;1
7418; 25.5 ; 740.7 ; 10.1 ;29;9;2;1;28;15;14;19;10;19;10;0
7419; 77.7 ; 388.5 ; 51.0 ;5;80;27;0;5;3;2;5;0;2;0;3
7420; 41.5 ; 165.9 ; 20.1 ;4;49;204;0;4;0;4;3;1;1;2;1
7421; 25.9 ; 362.4 ; 10.1 ;14;21;4;0;14;4;10;7;7;9;5;0
7422; 15.0 ; 59.9 ; -   ;4;50;46;0;4;4;0;4;0;4;0;0
7423; 69.6 ; 139.2 ; 12.1 ;2;174;69;0;2;1;1;2;0;0;0;2
7424; 38.8 ; 77.7 ; 12.9 ;2;39;37;2;0;0;2;2;0;1;1;0
7425; 22.8 ; 68.3 ; 6.2 ;3;155;20;0;3;1;2;3;0;3;0;0
7426; 32.6 ; 326.2 ; 18.3 ;10;31;16;0;10;1;9;3;7;3;7;0
7427; 27.3 ; 81.8 ; 11.8 ;3;43;26;0;3;0;3;0;3;2;1;0
7428; 33.8 ; 101.5 ; 17.7 ;3;40;7;0;3;1;2;2;1;1;2;0
7429; 27.0 ; 135.0 ; 12.7 ;5;33;49;0;5;2;3;3;2;3;2;0
7430; 53.9 ; 215.5 ; 24.1 ;4;37;28;0;4;2;2;4;0;1;2;1
7431; 44.6 ; 312.4 ; 17.0 ;7;28;17;0;7;1;6;3;4;2;3;2
7432; 36.0 ; 107.9 ; 12.6 ;3;54;170;0;3;2;1;0;3;1;2;0
7433; 106.3 ; 212.7 ; 44.0 ;2;49;117;2;0;1;1;0;2;0;0;2
7434; 21.2 ; 127.4 ; 13.4 ;6;25;239;0;6;6;0;6;0;4;2;0
7435; 30.3 ; 302.6 ; 10.4 ;10;27;90;0;10;4;6;4;6;3;7;0
7436; 19.1 ; 76.4 ; 2.9 ;4;14;242;0;4;0;4;1;3;4;0;0
7437; 45.8 ; 91.6 ; 15.5 ;2;214;81;0;2;2;0;2;0;0;1;1
7438; 27.7 ; 110.9 ; 3.3 ;4;117;60;0;4;1;3;1;3;3;1;0
7439; 76.5 ; 688.9 ; 34.2 ;9;26;20;0;9;0;9;1;8;0;0;9
7440; 44.0 ; 132.0 ; 6.9 ;3;76;141;0;3;0;3;2;1;0;3;0
7441; 29.2 ; 116.6 ; 12.7 ;4;11;246;0;4;1;3;1;3;3;1;0
7442; 19.3 ; 38.6 ; -   ;2;8;62;0;2;1;1;2;0;2;0;0
7443; 50.6 ; 252.9 ; 5.8 ;5;54;125;0;5;3;2;2;3;0;3;2
7444; 35.0 ; 175.1 ; 4.3 ;5;19;326;0;5;0;5;3;2;0;5;0
7445; 36.1 ; 108.4 ; 11.5 ;3;54;148;0;3;1;2;1;2;1;2;0
7446; 31.2 ; 125.0 ; 11.1 ;4;22;88;0;4;1;3;4;0;1;3;0
7447; 38.4 ; 422.0 ; 19.6 ;11;15;231;0;11;3;8;4;7;4;3;4
7448; 17.3 ; 207.5 ; 8.8 ;12;23;23;0;12;7;5;3;9;12;0;0
7449; 30.5 ; 61.1 ; 0.5 ;2;22;22;0;2;1;1;0;2;0;2;0
7450; 52.6 ; 157.7 ; 2.9 ;3;20;296;0;3;2;1;3;0;0;2;1
7451; 47.3 ; 141.8 ; 9.5 ;3;4;248;0;3;3;0;2;1;0;2;1
7452; 47.1 ; 282.3 ; 0.4 ;6;39;62;0;6;0;6;6;0;0;6;0
7453; 57.1 ; 457.0 ; 15.0 ;8;27;1;0;8;0;8;6;2;0;0;8
7454; 31.9 ; 159.5 ; 11.0 ;5;11;234;0;5;4;1;2;3;2;3;0
7455; 43.2 ; 389.2 ; 15.0 ;9;30;31;0;9;4;5;2;7;3;3;3
7456; 57.1 ; 114.3 ; 15.5 ;2;33;234;0;2;1;1;1;1;0;0;2
7457; 33.0 ; 66.1 ; 20.5 ;2;50;179;0;2;0;2;0;2;1;1;0
7458; 27.9 ; 391.2 ; 11.1 ;14;19;14;0;14;8;6;3;11;9;5;0
7459; 33.3 ; 66.6 ; 5.0 ;2;22;129;0;2;1;1;2;0;1;1;0
7460; 39.9 ; 159.6 ; 23.7 ;4;13;24;0;4;3;1;1;3;1;2;1
7461; 25.8 ; 283.5 ; 10.0 ;11;11;194;0;11;0;11;4;7;7;4;0
7462; 115.0 ; 229.9 ; 89.3 ;2;118;152;0;2;1;1;2;0;1;0;1
7463; 24.8 ; 148.8 ; 12.1 ;6;50;4;0;6;4;2;1;5;4;2;0
7464; 28.7 ; 315.3 ; 18.5 ;11;28;10;0;11;5;6;6;5;7;4;0
7465; 53.1 ; 318.9 ; 31.1 ;6;25;111;0;6;3;3;1;5;2;2;2
7466; 30.0 ; 149.8 ; 6.6 ;5;59;76;0;5;2;3;3;2;3;2;0
7467; 37.9 ; 378.8 ; 27.9 ;10;23;29;0;10;5;5;5;5;3;4;3
7468; 49.2 ; 98.3 ; 3.6 ;2;68;132;0;2;0;2;0;2;0;2;0
7469; 47.8 ; 95.7 ; 0.5 ;2;75;20;0;2;0;2;0;2;0;2;0
7470; 76.7 ; 383.4 ; 90.0 ;5;69;27;0;5;1;4;5;0;2;0;3
7471; 36.2 ; 72.5 ; 31.8 ;2;15;89;0;2;1;1;0;2;1;0;1
7472; 18.0 ; 36.1 ; 4.6 ;2;161;96;0;2;1;1;0;2;2;0;0
7473; 50.7 ; 101.4 ; 4.9 ;2;12;16;0;2;0;2;1;1;0;1;1
7474; 21.6 ; 86.4 ; 9.8 ;4;41;99;0;4;2;2;2;2;3;1;0
7475; 23.1 ; 92.6 ; 8.1 ;4;6;16;0;4;1;3;1;3;3;1;0
7476; 43.4 ; 130.1 ; 5.4 ;3;63;47;0;3;0;3;1;2;0;3;0
7477; 36.6 ; 109.8 ; -   ;3;156;23;0;3;3;0;1;2;0;3;0
7478; 55.3 ; 165.9 ; 36.4 ;3;20;0;1;2;0;3;1;2;1;0;2
7479; 39.0 ; 194.9 ; 26.1 ;5;40;23;0;5;4;1;3;2;2;1;2
7480; 51.0 ; 102.0 ; 31.2 ;2;6;263;0;2;0;2;1;1;1;0;1
7481; 19.5 ; 58.6 ; 5.4 ;3;153;14;0;3;2;1;2;1;3;0;0
7482; 73.2 ; 219.6 ; 40.1 ;3;50;179;0;3;0;3;3;0;0;0;3
7483; 45.2 ; 1,355.1 ; 24.2 ;30;10;11;0;30;12;18;17;13;10;10;10
7484; 39.5 ; 197.3 ; 16.0 ;5;19;112;5;0;5;0;1;4;2;1;2
7485; 55.1 ; 165.2 ; 44.7 ;3;104;90;0;3;0;3;3;0;1;0;2
7486; 37.8 ; 113.3 ; 41.8 ;3;20;55;0;3;2;1;3;0;1;1;1
7487; 18.9 ; 132.0 ; 3.5 ;7;21;35;1;6;6;1;6;1;7;0;0
7488; 38.4 ; 230.3 ; 3.2 ;6;40;79;0;6;0;6;6;0;0;6;0
7489; 33.4 ; 100.2 ; 17.3 ;3;165;23;0;3;1;2;2;1;1;2;0
7490; 30.2 ; 60.4 ; -   ;2;23;80;0;2;0;2;2;0;0;2;0
7491; 31.9 ; 223.0 ; 12.3 ;7;29;12;0;7;3;4;3;4;2;5;0
7492; 49.7 ; 149.1 ; 46.2 ;3;5;41;0;3;2;1;1;2;1;1;1
7493; 50.8 ; 254.2 ; 12.9 ;5;41;99;0;5;0;5;4;1;0;3;2
7494; 24.2 ; 96.8 ; 4.7 ;4;65;115;0;4;1;3;1;3;4;0;0
7495; 48.5 ; 242.6 ; 21.2 ;5;27;151;0;5;3;2;4;1;2;1;2
7496; 25.1 ; 50.1 ; -   ;2;25;5;0;2;0;2;2;0;2;0;0
7497; 61.0 ; 427.0 ; 12.8 ;7;36;17;0;7;1;6;2;5;0;0;7
7498; 28.4 ; 142.0 ; 5.4 ;5;72;23;0;5;3;2;1;4;3;2;0
7499; 15.0 ; 30.0 ; -   ;2;4;150;0;2;2;0;2;0;2;0;0
7500; 27.0 ; 81.0 ; 13.8 ;3;46;187;0;3;3;0;1;2;2;1;0
7501; 70.1 ; 210.3 ; 41.8 ;3;140;23;1;2;2;1;0;3;1;0;2
7502; 46.8 ; 140.3 ; -   ;3;46;248;0;3;0;3;1;2;0;3;0
7503; 36.3 ; 217.8 ; 12.6 ;6;43;5;0;6;3;3;3;3;2;4;0
7504; 46.9 ; 93.9 ; 25.1 ;2;69;178;0;2;0;2;2;0;1;0;1
7505; 22.6 ; 519.8 ; 11.8 ;23;7;4;0;23;17;6;19;4;15;8;0
7506; 19.2 ; 173.0 ; 8.7 ;9;17;11;0;9;1;8;8;1;9;0;0
7507; 34.6 ; 172.9 ; 13.9 ;5;72;115;0;5;2;3;3;2;2;3;0
7508; 46.4 ; 1,207.1 ; 15.3 ;26;15;5;0;26;7;19;23;3;0;17;9
7509; 66.1 ; 198.2 ; 80.1 ;3;25;231;0;3;0;3;2;1;1;0;2
7510; 46.2 ; 92.4 ; 6.5 ;2;135;188;0;2;1;1;0;2;0;2;0
7511; 65.3 ; 326.3 ; 19.0 ;5;35;41;1;4;0;5;5;0;0;0;5
7512; 35.3 ; 106.0 ; 22.1 ;3;4;62;0;3;1;2;2;1;1;1;1
7513; 43.7 ; 87.4 ; 0.2 ;2;88;2;0;2;2;0;2;0;0;2;0
7514; 48.2 ; 96.3 ; 20.9 ;2;13;94;0;2;0;2;1;1;1;0;1
7515; 57.8 ; 288.8 ; 16.1 ;5;63;53;0;5;1;4;2;3;0;0;5
7516; 33.4 ; 66.7 ; 27.5 ;2;79;28;0;2;1;1;2;0;1;0;1
7517; 44.0 ; 176.0 ; 23.1 ;4;24;99;0;4;1;3;3;1;1;2;1
7518; 52.7 ; 105.3 ; 1.4 ;2;21;29;0;2;1;1;2;0;0;2;0
7519; 87.7 ; 175.4 ; 93.8 ;2;43;21;0;2;0;2;0;2;1;0;1
7520; 36.7 ; 256.7 ; 9.5 ;7;27;31;0;7;2;5;3;4;2;5;0
7521; 17.7 ; 53.0 ; 2.5 ;3;32;204;0;3;1;2;1;2;3;0;0
7522; 50.5 ; 101.1 ; 4.6 ;2;36;39;0;2;2;0;0;2;0;1;1
7523; 51.6 ; 1,859.0 ; 15.9 ;36;8;52;0;36;5;31;26;10;0;24;12
7524; 40.2 ; 442.1 ; 24.8 ;11;36;50;0;11;4;7;4;7;4;3;4
7525; 20.7 ; 41.5 ; -   ;2;7;43;0;2;1;1;0;2;2;0;0
7526; 56.9 ; 398.6 ; 9.2 ;7;20;137;0;7;4;3;2;5;0;0;7
7527; 47.5 ; 569.9 ; 25.5 ;12;26;2;0;12;7;5;5;7;4;4;4
7528; 37.2 ; 148.7 ; 14.6 ;4;40;164;0;4;4;0;1;3;1;3;0
7529; 71.7 ; 1,076.1 ; 33.0 ;15;28;22;0;15;3;12;15;0;0;0;15
7530; 70.3 ; 281.2 ; 57.0 ;4;14;284;0;4;0;4;1;3;1;0;3
7531; 30.7 ; 123.0 ; 4.3 ;4;30;41;0;4;3;1;3;1;1;3;0
7532; 26.4 ; 52.9 ; 11.8 ;2;37;245;0;2;2;0;2;0;1;1;0
7533; 50.0 ; 200.0 ; 18.4 ;4;106;32;1;3;0;4;3;1;0;3;1
7534; 48.1 ; 96.2 ; 0.9 ;2;57;38;0;2;1;1;1;1;0;2;0
7535; 32.3 ; 226.4 ; 12.0 ;7;29;26;0;7;2;5;7;0;2;5;0
7536; 64.3 ; 193.0 ; 25.9 ;3;16;261;0;3;2;1;1;2;0;0;3
7537; 30.2 ; 151.0 ; 15.9 ;5;53;47;0;5;0;5;3;2;2;3;0
7538; 78.0 ; 156.0 ; 40.4 ;2;9;152;0;2;1;1;2;0;0;0;2
7539; 47.5 ; 237.4 ; 5.2 ;5;15;16;0;5;0;5;2;3;0;5;0
7540; 30.8 ; 61.7 ; 8.6 ;2;42;317;0;2;1;1;0;2;1;1;0
7541; 43.0 ; 86.1 ; 19.6 ;2;30;233;0;2;1;1;0;2;1;0;1
7542; 44.6 ; 89.1 ; 11.9 ;2;8;263;0;2;1;1;1;1;0;1;1
7543; 78.8 ; 157.6 ; 27.6 ;2;106;112;0;2;2;0;1;1;0;0;2
7544; 32.3 ; 354.9 ; 21.6 ;11;35;80;0;11;5;6;9;2;4;7;0
7545; 32.2 ; 96.5 ; 8.8 ;3;46;68;0;3;1;2;2;1;1;2;0
7546; 24.4 ; 1,168.9 ; 5.8 ;48;6;14;0;48;22;26;11;37;32;16;0
7547; 39.0 ; 974.3 ; 19.0 ;25;12;5;0;25;1;24;3;22;8;9;8
7548; 48.6 ; 680.1 ; 5.4 ;14;22;5;0;14;1;13;13;1;0;14;0
7549; 33.4 ; 100.1 ; 13.1 ;3;103;0;2;1;1;2;1;2;1;2;0
7550; 19.4 ; 58.3 ; 0.3 ;3;89;111;0;3;2;1;3;0;3;0;0
7551; 35.5 ; 177.7 ; 19.9 ;5;67;40;0;5;1;4;3;2;2;1;2
7552; 15.0 ; 30.0 ; -   ;2;163;139;0;2;2;0;0;2;2;0;0
7553; 30.4 ; 608.1 ; 4.5 ;20;10;113;0;20;10;10;13;7;7;13;0
7554; 47.1 ; 94.2 ; 0.5 ;2;205;93;0;2;2;0;1;1;0;2;0
7555; 49.8 ; 996.7 ; 7.7 ;20;15;5;0;20;8;12;7;13;0;13;7
7556; 56.0 ; 167.9 ; 13.3 ;3;149;25;0;3;1;2;2;1;0;0;3
7557; 39.2 ; 78.4 ; 16.6 ;2;6;36;1;1;0;2;1;1;1;0;1
7558; 18.6 ; 93.2 ; 3.5 ;5;14;110;0;5;3;2;5;0;5;0;0
7559; 68.5 ; 137.1 ; 43.2 ;2;18;57;0;2;0;2;2;0;1;0;1
7560; 34.5 ; 68.9 ; 6.8 ;2;12;57;0;2;0;2;2;0;1;1;0
7561; 57.0 ; 512.6 ; 24.9 ;9;28;5;0;9;0;9;6;3;0;0;9
7562; 51.4 ; 102.9 ; 7.0 ;2;74;113;0;2;2;0;0;2;0;1;1
7563; 69.8 ; 139.5 ; 7.7 ;2;120;10;0;2;0;2;1;1;0;0;2
7564; 19.9 ; 119.6 ; 9.3 ;6;30;17;0;6;4;2;4;2;6;0;0
7565; 89.0 ; 801.0 ; 29.1 ;9;29;0;0;9;1;8;9;0;0;0;9
7566; 32.1 ; 128.5 ; 18.0 ;4;15;140;4;0;2;2;0;4;1;3;0
7567; 76.1 ; 9,284.3 ; 72.3 ;122;3;3;61;61;105;17;122;0;41;0;81
7568; 48.9 ; 244.3 ; 17.8 ;5;90;7;0;5;3;2;2;3;0;3;2
7569; 30.0 ; 210.0 ; 6.7 ;7;29;16;0;7;2;5;3;4;2;5;0
7570; 23.1 ; 46.2 ; 12.1 ;2;56;167;0;2;2;0;1;1;1;1;0
7571; 39.3 ; 196.6 ; 4.7 ;5;37;111;0;5;1;4;3;2;0;5;0
7572; 44.5 ; 222.4 ; 5.0 ;5;63;0;0;5;1;4;5;0;0;5;0
7573; 16.7 ; 233.8 ; 2.2 ;14;17;121;0;14;6;8;7;7;14;0;0
7574; 45.1 ; 180.3 ; 2.3 ;4;69;62;0;4;0;4;3;1;0;4;0
7575; 35.6 ; 106.8 ; 29.1 ;3;47;89;0;3;0;3;1;2;1;1;1
7576; 46.8 ; 140.3 ; -   ;3;41;120;0;3;0;3;3;0;0;3;0
7577; 62.9 ; 125.9 ; 24.2 ;2;132;20;2;0;0;2;2;0;0;0;2
7578; 30.1 ; 120.4 ; 12.8 ;4;56;1;1;3;2;2;1;3;1;3;0
7579; 30.3 ; 879.5 ; 14.5 ;29;8;2;0;29;12;17;23;6;10;19;0
7580; 47.5 ; 94.9 ; -   ;2;24;68;0;2;0;2;2;0;0;2;0
7581; 15.0 ; 45.0 ; -   ;3;95;92;0;3;1;2;1;2;3;0;0
7582; 15.7 ; 94.1 ; 2.0 ;6;22;163;0;6;1;5;1;5;6;0;0
7583; 26.3 ; 131.5 ; 9.0 ;5;40;32;0;5;0;5;3;2;3;2;0
7584; 22.1 ; 88.2 ; 4.9 ;4;77;115;0;4;1;3;3;1;4;0;0
7585; 16.1 ; 32.1 ; 1.6 ;2;61;71;0;2;1;1;1;1;2;0;0
7586; 46.8 ; 93.5 ; -   ;2;8;243;0;2;2;0;0;2;0;2;0
7587; 49.8 ; 249.1 ; 5.4 ;5;34;11;2;3;0;5;5;0;0;3;2
7588; 18.0 ; 90.1 ; 7.2 ;5;13;97;0;5;4;1;3;2;5;0;0
7589; 47.2 ; 141.7 ; 0.4 ;3;63;36;0;3;1;2;2;1;0;3;0
7590; 50.3 ; 201.3 ; 7.0 ;4;72;74;0;4;1;3;4;0;0;3;1
7591; 123.2 ; 1,601.1 ; 32.5 ;13;33;62;0;13;0;13;13;0;0;0;13
7592; 39.2 ; 313.3 ; 31.1 ;8;21;80;0;8;1;7;4;4;3;2;3
7593; 18.0 ; 36.1 ; 4.6 ;2;14;275;0;2;2;0;2;0;2;0;0
7594; 60.0 ; 120.0 ; 11.2 ;2;354;110;0;2;0;2;2;0;0;0;2
7595; 28.4 ; 909.3 ; 8.5 ;32;5;2;32;0;20;12;15;17;21;11;0
7596; 15.0 ; 30.0 ; -   ;2;22;103;0;2;1;1;1;1;2;0;0
7597; 55.3 ; 165.8 ; 9.5 ;3;52;15;0;3;2;1;1;2;0;0;3
7598; 47.2 ; 141.7 ; 18.5 ;3;10;241;0;3;1;2;3;0;1;1;1
7599; 62.8 ; 188.4 ; 5.3 ;3;22;71;0;3;2;1;1;2;0;0;3
7600; 27.6 ; 55.3 ; 3.8 ;2;47;260;0;2;1;1;1;1;1;1;0
7601; 17.8 ; 53.5 ; 2.0 ;3;9;225;0;3;0;3;3;0;3;0;0
7602; 22.5 ; 44.9 ; 11.2 ;2;32;237;0;2;1;1;1;1;1;1;0
7603; 74.3 ; 446.0 ; 57.8 ;6;23;5;0;6;0;6;3;3;2;0;4
7604; 44.8 ; 985.5 ; 2.2 ;22;20;10;0;22;0;22;22;0;0;22;0
7605; 59.2 ; 177.6 ; 19.3 ;3;59;146;0;3;2;1;1;2;0;0;3
7606; 39.9 ; 119.8 ; 5.1 ;3;34;275;0;3;2;1;2;1;0;3;0
7607; 36.3 ; 145.4 ; 16.4 ;4;28;255;0;4;1;3;4;0;1;3;0
7608; 34.6 ; 138.4 ; 12.1 ;4;49;33;1;3;4;0;2;2;1;3;0
7609; 28.0 ; 167.8 ; 17.1 ;6;7;15;0;6;4;2;0;6;4;2;0
7610; 108.9 ; 544.4 ; 113.0 ;5;58;87;0;5;1;4;3;2;2;0;3
7611; 18.0 ; 36.1 ; 4.6 ;2;30;236;0;2;1;1;2;0;2;0;0
7612; 54.6 ; 218.4 ; 20.0 ;4;33;32;0;4;1;3;2;2;0;3;1
7613; 104.7 ; 209.5 ; 134.4 ;2;247;173;0;2;0;2;1;1;1;0;1
7614; 50.5 ; 101.0 ; 30.4 ;2;94;116;0;2;0;2;1;1;1;0;1
7615; 38.9 ; 155.8 ; 10.7 ;4;103;131;0;4;0;4;4;0;1;3;0
7616; 76.3 ; 228.8 ; 60.6 ;3;16;84;1;2;1;2;1;2;1;0;2
7617; 22.9 ; 504.7 ; 12.6 ;22;14;15;0;22;0;22;6;16;15;7;0
7618; 47.1 ; 188.2 ; 11.6 ;4;27;158;0;4;0;4;4;0;0;3;1
7619; 39.8 ; 238.8 ; 19.8 ;6;30;115;0;6;1;5;6;0;2;2;2
7620; 26.5 ; 53.0 ; 2.2 ;2;211;92;0;2;1;1;0;2;2;0;0
7621; 40.6 ; 528.4 ; 11.0 ;13;21;89;0;13;3;10;10;3;4;9;0
7622; 46.8 ; 93.5 ; -   ;2;6;162;2;0;0;2;1;1;0;2;0
7623; 23.9 ; 71.6 ; 9.7 ;3;106;69;0;3;0;3;0;3;2;1;0
7624; 30.8 ; 61.7 ; 8.6 ;2;1;338;0;2;2;0;1;1;1;1;0
7625; 24.7 ; 49.4 ; 14.6 ;2;75;137;0;2;0;2;2;0;1;1;0
7626; 32.6 ; 163.2 ; 17.1 ;5;38;84;0;5;0;5;5;0;2;3;0
7627; 35.1 ; 175.4 ; 19.9 ;5;42;73;1;4;1;4;5;0;2;3;0
7628; 56.6 ; 396.4 ; 24.7 ;7;50;63;0;7;3;4;1;6;0;0;7
7629; 24.1 ; 337.8 ; 16.8 ;14;9;248;0;14;11;3;8;6;9;5;0
7630; 16.6 ; 265.5 ; 2.6 ;16;18;2;1;15;13;3;16;0;16;0;0
7631; 27.0 ; 242.8 ; 20.3 ;9;24;131;0;9;6;3;9;0;6;3;0
7632; 47.5 ; 94.9 ; -   ;2;32;58;0;2;0;2;1;1;0;2;0
7633; 45.6 ; 501.6 ; 10.3 ;11;23;1;0;11;0;11;8;3;0;7;4
7634; 48.6 ; 340.5 ; 3.8 ;7;43;20;7;0;0;7;7;0;0;7;0
7635; 41.0 ; 410.3 ; 22.8 ;10;45;5;0;10;0;10;5;5;3;4;3
7636; 25.8 ; 51.6 ; 16.2 ;2;74;116;2;0;0;2;1;1;1;1;0
7637; 63.2 ; 379.1 ; 33.0 ;6;19;14;1;5;1;5;4;2;0;0;6
7638; 33.2 ; 265.5 ; 7.9 ;8;37;19;0;8;6;2;2;6;3;5;0
7639; 16.4 ; 98.5 ; 4.0 ;6;25;242;0;6;2;4;3;3;6;0;0
7640; 46.7 ; 607.0 ; 22.8 ;13;14;110;0;13;7;6;8;5;4;5;4
7641; 20.8 ; 415.8 ; 5.0 ;20;14;5;0;20;0;20;17;3;20;0;0
7642; 24.9 ; 99.4 ; 5.5 ;4;14;41;0;4;1;3;3;1;3;1;0
7643; 25.1 ; 100.3 ; -   ;4;14;76;4;0;3;1;1;3;4;0;0
7644; 63.4 ; 1,140.6 ; 15.5 ;18;14;0;0;18;5;13;12;6;0;0;18
7645; 18.4 ; 36.8 ; 5.1 ;2;38;241;0;2;0;2;1;1;2;0;0
7646; 53.6 ; 268.0 ; 13.0 ;5;32;94;0;5;1;4;1;4;0;3;2
7647; 24.1 ; 217.0 ; 7.8 ;9;15;189;0;9;6;3;6;3;6;3;0
7648; 71.1 ; 142.1 ; 33.6 ;2;25;209;0;2;0;2;2;0;0;0;2
7649; 20.0 ; 40.1 ; 7.6 ;2;42;99;0;2;1;1;0;2;2;0;0
7650; 25.9 ; 51.8 ; 3.0 ;2;17;209;0;2;2;0;0;2;2;0;0
7651; 20.8 ; 811.2 ; 8.9 ;39;10;15;0;39;15;24;17;22;39;0;0
7652; 49.0 ; 147.0 ; 24.3 ;3;38;5;1;2;1;2;2;1;1;1;1
7653; 21.1 ; 105.5 ; 2.0 ;5;49;62;0;5;4;1;0;5;5;0;0
7654; 22.6 ; 90.2 ; 5.3 ;4;12;61;0;4;2;2;2;2;4;0;0
7655; 101.1 ; 404.3 ; 175.9 ;4;12;56;4;0;4;0;4;0;1;0;3
7656; 21.4 ; 128.4 ; 9.9 ;6;47;3;0;6;4;2;4;2;4;2;0
7657; 40.0 ; 120.0 ; 13.7 ;3;2;44;0;3;2;1;1;2;1;2;0
7658; 47.5 ; 95.0 ; 1.1 ;2;26;380;0;2;2;0;0;2;0;2;0
7659; 31.5 ; 850.1 ; 5.1 ;27;5;5;0;27;0;27;26;1;9;18;0
7660; 37.7 ; 414.2 ; 16.9 ;11;18;146;0;11;2;9;8;3;4;7;0
7661; 22.5 ; 89.9 ; 9.2 ;4;75;101;0;4;1;3;3;1;3;1;0
7662; 37.0 ; 1,184.3 ; 15.5 ;32;9;2;0;32;9;23;21;11;11;21;0
7663; 30.4 ; 182.6 ; 10.7 ;6;69;0;0;6;0;6;2;4;2;4;0
7664; 64.0 ; 320.0 ; 12.1 ;5;29;257;0;5;1;4;5;0;0;0;5
7665; 32.2 ; 96.7 ; 4.0 ;3;20;140;0;3;2;1;2;1;1;2;0
7666; 64.4 ; 579.9 ; 41.3 ;9;27;17;0;9;4;5;2;7;3;0;6
7667; 16.5 ; 33.0 ; 2.3 ;2;116;131;0;2;1;1;2;0;2;0;0
7668; 38.5 ; 76.9 ; 12.4 ;2;10;141;0;2;1;1;2;0;1;1;0
7669; 34.2 ; 68.4 ; 21.7 ;2;17;311;0;2;0;2;1;1;1;0;1
7670; 62.1 ; 248.4 ; 24.6 ;4;46;120;0;4;0;4;4;0;0;0;4
7671; 32.2 ; 128.8 ; 12.7 ;4;48;198;0;4;4;0;1;3;1;3;0
7672; 26.7 ; 107.0 ; 16.6 ;4;6;107;0;4;3;1;1;3;3;1;0
7673; 15.0 ; 74.9 ; -   ;5;20;71;0;5;3;2;1;4;5;0;0
7674; 19.3 ; 57.9 ; 4.0 ;3;28;104;0;3;1;2;1;2;3;0;0
7675; 30.5 ; 60.9 ; 15.6 ;2;322;57;0;2;0;2;1;1;1;1;0
7676; 58.7 ; 234.6 ; 16.8 ;4;99;47;0;4;1;3;1;3;0;0;4
7677; 18.0 ; 36.0 ; -   ;2;87;40;0;2;2;0;2;0;2;0;0
7678; 53.1 ; 106.2 ; 6.6 ;2;6;262;0;2;0;2;2;0;0;1;1
7679; 16.5 ; 33.0 ; 2.3 ;2;50;151;0;2;2;0;1;1;2;0;0
7680; 24.5 ; 98.0 ; 8.2 ;4;10;240;0;4;4;0;0;4;3;1;0
7681; 40.1 ; 200.7 ; 12.0 ;5;62;1;0;5;1;4;3;2;2;3;0
7682; 46.1 ; 506.8 ; 29.8 ;11;23;69;0;11;2;9;6;5;4;3;4
7683; 15.0 ; 75.2 ; 0.1 ;5;57;20;0;5;3;2;4;1;5;0;0
7684; 22.7 ; 158.9 ; 7.3 ;7;32;92;0;7;3;4;3;4;5;2;0
7685; 51.7 ; 103.4 ; -   ;2;45;62;0;2;1;1;1;1;0;2;0
7686; 27.6 ; 138.0 ; 11.0 ;5;32;275;0;5;3;2;2;3;3;2;0
7687; 57.4 ; 402.1 ; 25.5 ;7;22;92;0;7;2;5;4;3;0;0;7
7688; 46.3 ; 185.1 ; 23.3 ;4;41;164;0;4;1;3;1;3;1;2;1
7689; 34.6 ; 138.6 ; 11.3 ;4;121;11;3;1;1;3;4;0;1;3;0
7690; 45.3 ; 181.3 ; 11.5 ;4;23;58;0;4;0;4;4;0;0;3;1
7691; 65.7 ; 262.9 ; 17.5 ;4;76;173;0;4;0;4;4;0;0;0;4
7692; 16.2 ; 178.6 ; 4.6 ;11;11;17;0;11;1;10;8;3;11;0;0
7693; 18.6 ; 92.9 ; 9.3 ;5;53;137;0;5;2;3;3;2;5;0;0
7694; 52.9 ; 528.9 ; 23.2 ;10;34;10;0;10;0;10;5;5;3;4;3
7695; 47.0 ; 235.2 ; 0.7 ;5;80;21;0;5;0;5;5;0;0;5;0
7696; 29.0 ; 145.0 ; 14.1 ;5;32;116;0;5;1;4;5;0;3;2;0
7697; 52.5 ; 157.5 ; -   ;3;19;141;0;3;0;3;3;0;0;3;0
7698; 35.6 ; 71.1 ; 8.0 ;2;9;84;0;2;1;1;0;2;1;1;0
7699; 35.8 ; 501.8 ; 12.1 ;14;20;8;0;14;6;8;2;12;5;9;0
7700; 43.1 ; 388.0 ; 17.0 ;9;35;74;0;9;0;9;1;8;3;3;3
7701; 40.5 ; 283.8 ; 43.6 ;7;40;50;0;7;1;6;3;4;2;3;2
7702; 51.7 ; 103.4 ; 32.2 ;2;47;17;0;2;1;1;1;1;1;0;1
7703; 43.3 ; 692.6 ; 1.0 ;16;18;20;0;16;3;13;11;5;0;16;0
7704; 81.1 ; 162.2 ; 73.7 ;2;340;26;0;2;0;2;1;1;1;0;1
7705; 24.8 ; 99.2 ; 15.9 ;4;83;139;0;4;3;1;2;2;3;1;0
7706; 25.1 ; 401.1 ; -   ;16;24;0;2;14;3;13;3;13;16;0;0
7707; 22.2 ; 44.3 ; 10.7 ;2;286;32;0;2;1;1;1;1;1;1;0
7708; 63.3 ; 126.6 ; 1.6 ;2;94;47;0;2;0;2;0;2;0;0;2
7709; 18.6 ; 74.3 ; -   ;4;151;5;0;4;0;4;1;3;4;0;0
7710; 52.0 ; 260.2 ; 43.2 ;5;48;73;0;5;0;5;3;2;2;1;2
7711; 42.9 ; 85.7 ; -   ;2;19;204;2;0;0;2;1;1;0;2;0
7712; 88.1 ; 440.6 ; 76.5 ;5;52;196;0;5;3;2;4;1;2;0;3
7713; 60.0 ; 120.0 ; 18.8 ;2;16;76;0;2;1;1;0;2;0;0;2
7714; 49.5 ; 99.0 ; 9.9 ;2;32;233;0;2;2;0;0;2;0;1;1
7715; 21.4 ; 42.8 ; 9.6 ;2;39;236;0;2;1;1;1;1;1;1;0
7716; 52.8 ; 105.5 ; 1.8 ;2;303;15;0;2;0;2;0;2;0;2;0
7717; 34.1 ; 341.2 ; 7.5 ;10;5;241;0;10;2;8;6;4;3;7;0
7718; 48.4 ; 96.8 ; 1.4 ;2;68;26;0;2;0;2;2;0;0;2;0
7719; 39.0 ; 194.9 ; 30.1 ;5;14;116;0;5;3;2;2;3;2;1;2
7720; 87.0 ; 174.0 ; -   ;2;8;55;2;0;1;1;2;0;0;0;2
7721; 46.8 ; 93.5 ; -   ;2;5;157;0;2;0;2;2;0;0;2;0
7722; 48.9 ; 97.8 ; 1.8 ;2;32;0;0;2;0;2;0;2;0;2;0
7723; 36.1 ; 325.1 ; 4.7 ;9;20;0;0;9;1;8;9;0;0;9;0
7724; 26.8 ; 214.4 ; 21.2 ;8;19;170;0;8;7;1;7;1;5;3;0
7725; 29.7 ; 178.2 ; 13.0 ;6;41;7;0;6;3;3;2;4;4;2;0
7726; 21.0 ; 189.3 ; 3.2 ;9;13;20;9;0;2;7;1;8;9;0;0
7727; 55.9 ; 111.8 ; 9.8 ;2;47;52;0;2;1;1;1;1;0;0;2
7728; 29.0 ; 144.9 ; 2.9 ;5;31;242;0;5;4;1;1;4;3;2;0
7729; 54.4 ; 163.1 ; 1.7 ;3;57;178;0;3;0;3;3;0;0;2;1
7730; 34.9 ; 209.5 ; 13.0 ;6;33;31;0;6;0;6;4;2;2;4;0
7731; 27.2 ; 272.4 ; 6.4 ;10;15;8;0;10;2;8;5;5;7;3;0
7732; 47.7 ; 238.3 ; 13.2 ;5;39;143;0;5;0;5;5;0;0;3;2
7733; 52.1 ; 104.2 ; 1.6 ;2;134;3;0;2;1;1;2;0;0;2;0
7734; 47.1 ; 141.4 ; 1.0 ;3;232;7;0;3;2;1;1;2;0;3;0
7735; 47.2 ; 613.1 ; 31.0 ;13;23;10;0;13;1;12;11;2;4;5;4
7736; 32.2 ; 64.3 ; 25.7 ;2;53;90;0;2;1;1;1;1;1;0;1
7737; 61.9 ; 619.1 ; 26.5 ;10;26;65;0;10;8;2;7;3;0;0;10
7738; 47.1 ; 94.2 ; 0.5 ;2;176;78;0;2;0;2;2;0;0;2;0
7739; 29.0 ; 86.9 ; 9.5 ;3;129;83;0;3;1;2;2;1;2;1;0
7740; 39.4 ; 78.9 ; 13.9 ;2;164;47;0;2;0;2;2;0;1;1;0
7741; 25.1 ; 75.2 ; -   ;3;110;74;0;3;1;2;1;2;3;0;0
7742; 51.3 ; 154.0 ; 27.0 ;3;4;224;0;3;2;1;1;2;1;1;1
7743; 39.4 ; 78.8 ; 36.6 ;2;15;188;2;0;1;1;2;0;1;0;1
7744; 37.7 ; 1,018.5 ; 24.6 ;27;13;14;0;27;12;15;8;19;9;9;9
7745; 29.5 ; 117.9 ; 19.1 ;4;41;71;0;4;2;2;2;2;3;1;0
7746; 55.0 ; 110.1 ; 26.7 ;2;78;311;0;2;2;0;0;2;1;0;1
7747; 40.3 ; 201.7 ; 15.1 ;5;19;10;0;5;2;3;1;4;2;1;2
7748; 211.5 ; 423.0 ; 103.4 ;2;13;131;0;2;0;2;1;1;0;0;2
7749; 43.4 ; 216.8 ; 4.0 ;5;57;26;0;5;0;5;3;2;0;5;0
7750; 30.9 ; 432.0 ; 13.3 ;14;20;14;0;14;6;8;9;5;5;9;0
7751; 36.9 ; 73.8 ; 10.0 ;2;74;43;0;2;0;2;0;2;1;1;0
7752; 38.2 ; 191.0 ; 13.3 ;5;56;26;0;5;3;2;5;0;2;3;0
7753; 30.6 ; 61.1 ; 0.9 ;2;94;41;0;2;0;2;2;0;1;1;0
7754; 65.8 ; 526.4 ; 10.3 ;8;39;20;0;8;0;8;6;2;0;0;8
7755; 25.9 ; 362.0 ; 11.6 ;14;34;5;0;14;0;14;12;2;9;5;0
7756; 32.3 ; 64.5 ; 10.8 ;2;113;168;0;2;0;2;2;0;1;1;0
7757; 83.6 ; 334.3 ; 37.8 ;4;56;80;0;4;3;1;3;1;0;0;4
7758; 27.6 ; 358.8 ; 24.6 ;13;16;99;0;13;4;9;10;3;9;4;0
7759; 32.3 ; 226.0 ; 10.9 ;7;11;138;0;7;4;3;4;3;2;5;0
7760; 45.1 ; 135.2 ; 3.8 ;3;108;63;0;3;2;1;3;0;0;3;0
7761; 23.1 ; 46.2 ; 12.1 ;2;225;1;0;2;0;2;1;1;1;1;0
7762; 35.9 ; 71.8 ; 16.2 ;2;32;188;0;2;0;2;2;0;1;1;0
7763; 33.3 ; 133.1 ; 14.7 ;4;42;92;0;4;2;2;2;2;1;3;0
7764; 39.4 ; 236.3 ; 3.7 ;6;41;69;0;6;0;6;4;2;0;6;0
7765; 21.1 ; 42.2 ; -   ;2;348;99;0;2;0;2;2;0;2;0;0
7766; 33.4 ; 66.8 ; 4.8 ;2;19;53;0;2;1;1;1;1;1;1;0
7767; 49.2 ; 98.5 ; 37.6 ;2;59;45;0;2;1;1;0;2;1;0;1
7768; 35.4 ; 530.7 ; 12.4 ;15;24;5;0;15;0;15;12;3;5;10;0
7769; 34.2 ; 102.7 ; 17.7 ;3;4;0;0;3;1;2;2;1;1;2;0
7770; 40.8 ; 81.5 ; 16.2 ;2;246;73;0;2;0;2;0;2;1;0;1
7771; 35.9 ; 143.4 ; 13.5 ;4;38;216;0;4;2;2;2;2;1;3;0
7772; 51.1 ; 255.6 ; 29.7 ;5;60;26;0;5;0;5;5;0;2;1;2
7773; 19.7 ; 177.0 ; -   ;9;16;20;8;1;0;9;2;7;9;0;0
7774; 33.1 ; 66.2 ; 20.4 ;2;60;188;0;2;1;1;1;1;1;1;0
7775; 41.4 ; 82.8 ; 1.8 ;2;9;263;0;2;1;1;1;1;0;2;0
7776; 52.5 ; 105.0 ; -   ;2;158;238;0;2;2;0;2;0;0;2;0
7777; 34.9 ; 104.7 ; 15.0 ;3;33;271;0;3;3;0;1;2;1;2;0
7778; 27.3 ; 218.0 ; 13.3 ;8;23;25;0;8;4;4;8;0;5;3;0
7779; 24.6 ; 123.1 ; 13.7 ;5;33;9;0;5;3;2;1;4;3;2;0
7780; 18.0 ; 36.0 ; -   ;2;3;51;0;2;1;1;0;2;2;0;0
7781; 59.2 ; 118.4 ; 3.5 ;2;13;99;2;0;0;2;2;0;0;0;2
7782; 23.1 ; 69.4 ; 15.0 ;3;18;231;0;3;1;2;1;2;2;1;0
7783; 16.5 ; 49.6 ; 2.9 ;3;21;207;0;3;2;1;0;3;3;0;0
7784; 45.9 ; 458.6 ; 20.1 ;10;24;5;0;10;0;10;8;2;3;4;3
7785; 27.8 ; 139.0 ; 8.6 ;5;50;62;0;5;3;2;2;3;3;2;0
7786; 34.8 ; 69.5 ; 22.2 ;2;71;173;0;2;1;1;0;2;1;0;1
7787; 32.0 ; 416.3 ; 11.9 ;13;28;5;0;13;7;6;1;12;4;9;0
7788; 39.2 ; 196.2 ; 18.4 ;5;32;21;1;4;0;5;3;2;2;1;2
7789; 29.3 ; 58.6 ; 14.8 ;2;1;280;0;2;2;0;0;2;1;1;0
7790; 34.5 ; 138.0 ; 9.2 ;4;9;80;4;0;2;2;4;0;1;3;0
7791; 23.1 ; 46.3 ; 11.2 ;2;4;220;0;2;1;1;2;0;1;1;0
7792; 28.2 ; 141.2 ; 10.1 ;5;6;74;5;0;1;4;1;4;3;2;0
7793; 42.0 ; 84.1 ; 8.1 ;2;237;78;1;1;1;1;2;0;0;2;0
7794; 45.7 ; 411.1 ; 25.1 ;9;32;5;0;9;2;7;5;4;3;3;3
7795; 18.3 ; 91.7 ; 5.5 ;5;50;60;0;5;4;1;2;3;5;0;0
7796; 18.9 ; 169.8 ; 5.2 ;9;30;68;0;9;0;9;7;2;9;0;0
7797; 70.2 ; 140.5 ; 2.4 ;2;195;73;0;2;0;2;2;0;0;0;2
7798; 56.1 ; 112.2 ; 11.2 ;2;15;246;0;2;1;1;2;0;0;0;2
7799; 106.0 ; 212.0 ; 2.6 ;2;19;125;0;2;0;2;0;2;0;0;2
7800; 17.2 ; 34.4 ; 3.3 ;2;30;348;0;2;1;1;1;1;2;0;0
7801; 48.8 ; 146.4 ; 19.2 ;3;41;193;0;3;2;1;1;2;1;1;1
7802; 60.0 ; 120.0 ; 25.3 ;2;113;104;0;2;0;2;2;0;0;0;2
7803; 30.0 ; 90.1 ; 0.1 ;3;97;74;1;2;0;3;2;1;1;2;0
7804; 38.4 ; 192.0 ; 4.7 ;5;45;74;0;5;2;3;2;3;0;5;0
7805; 21.7 ; 86.7 ; 6.5 ;4;86;108;0;4;3;1;4;0;4;0;0
7806; 49.3 ; 147.8 ; 4.0 ;3;78;74;3;0;0;3;1;2;0;3;0
7807; 31.6 ; 94.7 ; 15.4 ;3;23;209;0;3;1;2;3;0;1;2;0
7808; 56.8 ; 624.5 ; 11.8 ;11;34;17;0;11;3;8;5;6;0;0;11
7809; 34.4 ; 68.9 ; -   ;2;27;158;0;2;1;1;1;1;0;2;0
7810; 63.3 ; 126.6 ; 2.9 ;2;18;183;0;2;0;2;1;1;0;0;2
7811; 36.9 ; 184.5 ; 12.6 ;5;76;56;0;5;2;3;3;2;2;3;0
7812; 56.8 ; 170.3 ; 19.2 ;3;5;61;0;3;2;1;1;2;0;0;3
7813; 21.8 ; 152.6 ; 12.0 ;7;43;46;0;7;2;5;0;7;5;2;0
7814; 47.2 ; 283.5 ; 7.9 ;6;19;47;0;6;0;6;6;0;0;4;2
7815; 50.1 ; 200.4 ; 5.8 ;4;73;57;0;4;1;3;3;1;0;3;1
7816; 17.2 ; 34.4 ; 3.3 ;2;77;200;0;2;1;1;2;0;2;0;0
7817; 27.5 ; 55.0 ; 3.7 ;2;22;362;0;2;1;1;2;0;1;1;0
7818; 69.9 ; 139.8 ; 26.0 ;2;39;235;0;2;1;1;0;2;0;0;2
7819; 46.6 ; 93.2 ; 1.7 ;2;7;245;0;2;1;1;1;1;0;2;0
7820; 46.3 ; 231.4 ; 5.8 ;5;58;6;0;5;1;4;3;2;0;5;0
7821; 15.7 ; 47.1 ; -   ;3;28;10;0;3;1;2;3;0;3;0;0
7822; 27.4 ; 137.1 ; 14.0 ;5;14;163;0;5;1;4;3;2;3;2;0
7823; 30.8 ; 61.7 ; 8.6 ;2;4;158;0;2;1;1;0;2;1;1;0
7824; 36.8 ; 257.3 ; 17.9 ;7;27;133;0;7;1;6;3;4;2;5;0
7825; 34.4 ; 103.3 ; 13.1 ;3;15;125;0;3;1;2;0;3;1;2;0
7826; 57.1 ; 114.3 ; 40.3 ;2;1;134;2;0;2;0;0;2;1;0;1
7827; 22.6 ; 90.2 ; 5.3 ;4;13;64;0;4;2;2;3;1;4;0;0
7828; 18.3 ; 55.0 ; 6.2 ;3;100;0;3;0;0;3;3;0;3;0;0
7829; 20.2 ; 282.5 ; 5.0 ;14;26;34;0;14;12;2;8;6;14;0;0
7830; 70.8 ; 212.5 ; 50.4 ;3;47;209;0;3;1;2;2;1;1;0;2
7831; 20.0 ; 80.1 ; 6.2 ;4;23;1;0;4;1;3;1;3;4;0;0
7832; 20.0 ; 80.1 ; 6.2 ;4;5;251;0;4;2;2;2;2;4;0;0
7833; 39.4 ; 118.1 ; 22.4 ;3;44;217;0;3;3;0;1;2;1;1;1
7834; 48.7 ; 389.7 ; 39.7 ;8;25;113;0;8;1;7;2;6;3;2;3
7835; 30.2 ; 60.4 ; -   ;2;104;128;0;2;1;1;0;2;0;2;0
7836; 48.3 ; 96.7 ; 18.9 ;2;50;225;0;2;0;2;2;0;1;0;1
7837; 42.3 ; 929.8 ; 26.1 ;22;16;103;0;22;16;6;16;6;7;8;7
7838; 36.8 ; 110.3 ; 33.4 ;3;213;1;0;3;1;2;2;1;1;1;1
7839; 33.2 ; 99.5 ; 2.7 ;3;22;122;0;3;1;2;1;2;0;3;0
7840; 53.3 ; 266.6 ; 8.7 ;5;27;2;5;0;2;3;4;1;0;3;2
7841; 15.0 ; 30.0 ; -   ;2;15;54;2;0;2;0;2;0;2;0;0
7842; 17.3 ; 69.3 ; 1.8 ;4;57;35;4;0;2;2;3;1;4;0;0
7843; 49.9 ; 699.2 ; 21.6 ;14;31;23;0;14;1;13;12;2;5;4;5
7844; 43.3 ; 216.5 ; 23.0 ;5;20;63;0;5;1;4;3;2;2;1;2
7845; 51.2 ; 205.0 ; 8.0 ;4;57;0;0;4;0;4;2;2;0;3;1
7846; 17.9 ; 53.6 ; 2.6 ;3;22;204;0;3;0;3;2;1;3;0;0
7847; 17.5 ; 105.2 ; 5.9 ;6;10;218;0;6;3;3;6;0;6;0;0
7848; 81.7 ; 163.5 ; 51.3 ;2;204;59;0;2;1;1;2;0;0;0;2
7849; 15.2 ; 60.8 ; 0.5 ;4;65;48;0;4;1;3;4;0;4;0;0
7850; 36.8 ; 73.6 ; 10.1 ;2;14;126;0;2;0;2;2;0;1;1;0
7851; 27.9 ; 948.8 ; 13.7 ;34;12;2;0;34;18;16;12;22;23;11;0
7852; 24.7 ; 49.4 ; 8.2 ;2;9;321;0;2;1;1;1;1;1;1;0
7853; 19.0 ; 114.0 ; 6.5 ;6;29;78;0;6;0;6;6;0;6;0;0
7854; 36.6 ; 146.4 ; -   ;4;48;6;0;4;1;3;1;3;0;4;0
7855; 28.1 ; 336.9 ; 13.1 ;12;20;68;0;12;3;9;10;2;8;4;0
7856; 19.0 ; 95.1 ; 5.9 ;5;80;88;0;5;4;1;1;4;5;0;0
7857; 30.1 ; 60.2 ; 22.7 ;2;33;22;0;2;1;1;1;1;1;1;0
7858; 46.8 ; 93.5 ; -   ;2;15;269;0;2;1;1;0;2;0;2;0
7859; 40.8 ; 449.1 ; 12.8 ;11;23;50;0;11;3;8;4;7;4;7;0
7860; 36.6 ; 73.2 ; -   ;2;13;15;0;2;0;2;2;0;0;2;0
7861; 20.1 ; 302.0 ; 5.4 ;15;26;2;0;15;10;5;15;0;15;0;0
7862; 51.0 ; 102.1 ; 0.1 ;2;157;136;0;2;0;2;2;0;0;2;0
7863; 48.9 ; 342.4 ; 29.7 ;7;19;28;0;7;3;4;6;1;2;3;2
7864; 20.0 ; 40.1 ; 7.6 ;2;41;71;0;2;1;1;2;0;2;0;0
7865; 24.7 ; 98.6 ; 14.3 ;4;16;23;0;4;2;2;0;4;3;1;0
7866; 44.4 ; 88.8 ; 27.4 ;2;14;81;0;2;2;0;0;2;1;0;1
7867; 16.4 ; 65.4 ; 2.9 ;4;32;283;0;4;0;4;1;3;4;0;0
7868; 58.2 ; 232.9 ; 36.5 ;4;32;55;4;0;1;3;2;2;1;0;3
7869; 15.0 ; 30.0 ; -   ;2;62;214;0;2;2;0;0;2;2;0;0
7870; 66.5 ; 133.0 ; 7.6 ;2;12;398;0;2;0;2;2;0;0;0;2
7871; 17.5 ; 70.0 ; 5.3 ;4;102;13;0;4;3;1;4;0;4;0;0
7872; 37.8 ; 113.4 ; 17.0 ;3;9;136;0;3;0;3;2;1;1;2;0
7873; 23.3 ; 70.0 ; 8.1 ;3;104;62;0;3;0;3;1;2;2;1;0
7874; 39.9 ; 199.6 ; 30.1 ;5;52;92;0;5;1;4;1;4;2;1;2
7875; 23.1 ; 115.3 ; 6.8 ;5;61;22;0;5;0;5;2;3;5;0;0
7876; 76.6 ; 306.3 ; 46.6 ;4;30;100;1;3;1;3;0;4;1;0;3
7877; 43.9 ; 87.7 ; -   ;2;12;11;0;2;0;2;2;0;0;2;0
7878; 32.8 ; 65.6 ; 23.8 ;2;30;14;0;2;2;0;2;0;1;0;1
7879; 42.3 ; 254.0 ; 22.3 ;6;41;41;0;6;0;6;1;5;2;2;2
7880; 30.8 ; 92.5 ; 5.3 ;3;158;16;0;3;2;1;0;3;1;2;0
7881; 45.5 ; 91.0 ; 4.8 ;2;107;95;0;2;0;2;1;1;0;2;0
7882; 24.8 ; 247.9 ; 10.9 ;10;23;74;0;10;4;6;4;6;7;3;0
7883; 19.4 ; 58.1 ; 5.5 ;3;56;90;0;3;0;3;2;1;3;0;0
7884; 36.0 ; 324.2 ; 12.5 ;9;27;69;0;9;2;7;3;6;3;6;0
7885; 25.3 ; 151.6 ; 13.3 ;6;14;73;0;6;0;6;3;3;4;2;0
7886; 41.9 ; 209.7 ; 15.7 ;5;65;11;0;5;2;3;3;2;2;1;2
7887; 36.6 ; 256.0 ; 8.9 ;7;59;7;0;7;5;2;7;0;2;5;0
7888; 52.0 ; 156.0 ; 8.9 ;3;178;78;0;3;1;2;3;0;0;2;1
7889; 117.0 ; 233.9 ; 29.3 ;2;9;160;0;2;1;1;2;0;0;0;2
7890; 33.3 ; 166.3 ; 8.0 ;5;14;303;0;5;0;5;5;0;2;3;0
7891; 65.2 ; 195.7 ; 32.1 ;3;81;87;0;3;2;1;1;2;0;0;3
7892; 30.0 ; 119.9 ; -   ;4;74;35;0;4;3;1;1;3;4;0;0
7893; 32.7 ; 65.4 ; 4.1 ;2;15;257;0;2;1;1;1;1;1;1;0
7894; 39.2 ; 157.0 ; 8.1 ;4;90;11;0;4;0;4;3;1;0;4;0
7895; 75.5 ; 603.6 ; 17.8 ;8;30;83;3;5;0;8;7;1;0;0;8
7896; 49.5 ; 148.5 ; 15.7 ;3;51;35;0;3;2;1;1;2;0;2;1
7897; 18.4 ; 201.9 ; 4.3 ;11;23;72;9;2;2;9;9;2;11;0;0
7898; 48.6 ; 388.8 ; 21.8 ;8;23;226;0;8;0;8;7;1;3;2;3
7899; 33.0 ; 65.9 ; 5.4 ;2;93;253;0;2;0;2;0;2;1;1;0
7900; 47.7 ; 95.4 ; 7.2 ;2;89;183;0;2;0;2;2;0;0;2;0
7901; 52.7 ; 263.6 ; 21.2 ;5;5;283;0;5;0;5;4;1;0;3;2
7902; 81.6 ; 407.9 ; 63.1 ;5;44;21;0;5;0;5;3;2;2;0;3
7903; 48.6 ; 194.6 ; 25.7 ;4;10;246;0;4;0;4;4;0;1;2;1
7904; 15.0 ; 30.0 ; -   ;2;198;107;1;1;1;1;0;2;2;0;0
7905; 22.6 ; 45.2 ; 11.4 ;2;250;55;0;2;2;0;2;0;1;1;0
7906; 50.4 ; 252.2 ; 13.1 ;5;41;26;5;0;0;5;1;4;0;3;2
7907; 49.6 ; 99.3 ; 4.3 ;2;2;215;0;2;1;1;1;1;0;2;0
7908; 17.9 ; 35.7 ; 4.3 ;2;23;133;2;0;1;1;0;2;2;0;0
7909; 20.0 ; 80.1 ; 6.2 ;4;23;35;0;4;2;2;2;2;4;0;0
7910; 49.6 ; 99.3 ; 4.3 ;2;6;257;0;2;0;2;2;0;0;2;0
7911; 18.9 ; 75.5 ; 5.2 ;4;86;101;0;4;2;2;2;2;4;0;0
7912; 21.1 ; 253.8 ; 10.2 ;12;9;36;0;12;4;8;2;10;8;4;0
7913; 36.1 ; 289.0 ; 6.3 ;8;40;5;0;8;0;8;8;0;3;5;0
7914; 65.2 ; 913.1 ; 22.8 ;14;14;55;1;13;5;9;11;3;0;0;14
7915; 33.4 ; 66.7 ; 23.0 ;2;160;99;0;2;1;1;0;2;1;0;1
7916; 18.5 ; 610.9 ; 7.9 ;33;5;266;0;33;16;17;27;6;33;0;0
7917; 38.4 ; 76.7 ; 12.6 ;2;15;242;0;2;1;1;1;1;1;1;0
7918; 24.9 ; 623.1 ; 19.4 ;25;17;53;0;25;12;13;22;3;17;8;0
7919; 82.3 ; 576.2 ; 41.0 ;7;38;57;0;7;1;6;5;2;0;0;7
7920; 24.1 ; 216.8 ; 11.8 ;9;32;23;0;9;3;6;1;8;6;3;0
7921; 37.5 ; 974.6 ; 3.5 ;26;13;84;0;26;9;17;3;23;0;26;0
7922; 22.4 ; 67.1 ; 7.2 ;3;203;38;1;2;0;3;1;2;3;0;0
7923; 19.7 ; 39.4 ; 0.1 ;2;68;320;0;2;0;2;1;1;2;0;0
7924; 37.7 ; 150.9 ; 12.6 ;4;40;11;0;4;1;3;1;3;1;3;0
7925; 75.2 ; 902.2 ; 28.1 ;12;24;33;0;12;0;12;4;8;0;0;12
7926; 51.3 ; 256.7 ; 2.9 ;5;44;20;1;4;1;4;5;0;0;5;0
7927; 24.7 ; 49.4 ; 14.6 ;2;8;259;0;2;2;0;2;0;1;1;0
7928; 21.2 ; 63.5 ; 11.4 ;3;88;75;0;3;2;1;1;2;2;1;0
7929; 21.0 ; 104.9 ; 14.2 ;5;26;20;5;0;3;2;5;0;3;2;0
7930; 68.5 ; 273.8 ; 24.5 ;4;21;230;0;4;1;3;4;0;0;0;4
7931; 28.2 ; 56.4 ; 8.0 ;2;13;294;0;2;0;2;0;2;1;1;0
7932; 26.0 ; 597.6 ; 10.1 ;23;10;2;19;4;17;6;21;2;15;8;0
7933; 21.2 ; 446.1 ; 5.3 ;21;5;252;0;21;8;13;20;1;21;0;0
7934; 49.1 ; 98.2 ; 0.7 ;2;92;183;0;2;1;1;2;0;0;2;0
7935; 21.9 ; 437.4 ; 11.0 ;20;4;36;0;20;5;15;6;14;13;7;0
7936; 51.5 ; 360.2 ; 17.1 ;7;42;26;0;7;1;6;1;6;0;5;2
7937; 25.1 ; 50.1 ; -   ;2;151;57;0;2;0;2;0;2;2;0;0
7938; 21.8 ; 43.7 ; 9.0 ;2;125;5;1;1;0;2;2;0;1;1;0
7939; 25.1 ; 50.1 ; -   ;2;32;16;0;2;0;2;1;1;2;0;0
7940; 17.5 ; 70.0 ; 5.3 ;4;5;263;0;4;1;3;2;2;4;0;0
7941; 54.8 ; 438.1 ; 27.4 ;8;29;35;0;8;5;3;1;7;3;2;3
7942; 44.3 ; 132.9 ; 29.6 ;3;117;25;0;3;1;2;2;1;1;1;1
7943; 58.9 ; 294.5 ; 26.5 ;5;59;41;0;5;0;5;3;2;0;0;5
7944; 39.9 ; 79.7 ; 14.5 ;2;100;100;0;2;0;2;1;1;1;1;0
7945; 34.0 ; 306.2 ; 9.6 ;9;1;246;0;9;4;5;5;4;3;6;0
7946; 17.3 ; 34.7 ; 3.5 ;2;9;273;0;2;1;1;1;1;2;0;0
7947; 16.8 ; 50.4 ; 3.3 ;3;43;223;0;3;2;1;3;0;3;0;0
7948; 54.0 ; 270.0 ; 8.1 ;5;48;15;5;0;2;3;3;2;0;3;2
7949; 66.3 ; 331.4 ; 20.1 ;5;37;110;0;5;2;3;5;0;0;0;5
7950; 34.4 ; 688.0 ; 8.6 ;20;20;2;0;20;3;17;8;12;7;13;0
7951; 16.8 ; 67.2 ; 2.2 ;4;55;70;0;4;2;2;1;3;4;0;0
7952; 34.8 ; 69.5 ; 14.5 ;2;166;114;0;2;1;1;1;1;1;1;0
7953; 43.8 ; 87.7 ; 4.4 ;2;31;305;0;2;0;2;1;1;0;2;0
7954; 112.5 ; 225.0 ; 9.1 ;2;25;34;0;2;2;0;2;0;0;0;2
7955; 28.3 ; 113.3 ; 16.9 ;4;3;194;0;4;0;4;2;2;3;1;0
7956; 21.7 ; 130.0 ; 13.1 ;6;53;0;0;6;0;6;4;2;4;2;0
7957; 23.2 ; 162.2 ; 9.3 ;7;39;5;0;7;0;7;5;2;5;2;0
7958; 37.9 ; 379.4 ; 10.6 ;10;29;26;0;10;3;7;8;2;3;7;0
7959; 47.0 ; 94.0 ; 25.2 ;2;4;44;0;2;1;1;0;2;1;0;1
7960; 50.0 ; 200.2 ; 8.5 ;4;68;89;0;4;0;4;4;0;0;3;1
7961; 38.9 ; 116.8 ; 4.3 ;3;165;29;0;3;1;2;3;0;0;3;0
7962; 52.6 ; 473.1 ; 12.6 ;9;47;29;0;9;2;7;7;2;0;6;3
7963; 48.0 ; 144.0 ; 1.1 ;3;100;121;0;3;0;3;2;1;0;3;0
7964; 47.5 ; 94.9 ; 1.1 ;2;203;18;0;2;2;0;0;2;0;2;0
7965; 35.8 ; 107.5 ; 6.5 ;3;99;140;0;3;1;2;2;1;1;2;0
7966; 55.2 ; 110.4 ; 9.7 ;2;18;84;0;2;0;2;2;0;0;0;2
7967; 30.2 ; 60.4 ; -   ;2;168;131;0;2;0;2;2;0;0;2;0
7968; 63.8 ; 255.4 ; 41.3 ;4;23;120;0;4;0;4;4;0;1;0;3
7969; 59.0 ; 589.6 ; 23.6 ;10;20;0;0;10;0;10;7;3;0;0;10
7970; 35.6 ; 2,386.2 ; 19.1 ;67;5;0;2;65;22;45;15;52;22;45;0
7971; 58.2 ; 233.0 ; 6.2 ;4;67;0;0;4;0;4;3;1;0;0;4
7972; 67.2 ; 201.7 ; 35.9 ;3;13;69;0;3;0;3;3;0;0;0;3
7973; 63.0 ; 126.0 ; 8.0 ;2;19;32;0;2;0;2;0;2;0;0;2
7974; 52.4 ; 104.8 ; 0.2 ;2;18;195;0;2;0;2;1;1;0;2;0
7975; 38.0 ; 304.1 ; 14.0 ;8;29;41;0;8;1;7;5;3;3;5;0
7976; 16.2 ; 145.9 ; 2.7 ;9;36;8;0;9;8;1;9;0;9;0;0
7977; 79.5 ; 238.4 ; 63.3 ;3;25;31;0;3;0;3;2;1;1;0;2
7978; 45.3 ; 226.3 ; 24.4 ;5;38;57;0;5;1;4;2;3;2;1;2
7979; 56.7 ; 170.1 ; 17.9 ;3;68;26;0;3;0;3;3;0;0;0;3
7980; 72.6 ; 217.9 ; 62.7 ;3;124;97;0;3;2;1;3;0;1;0;2
7981; 31.4 ; 157.0 ; 9.8 ;5;31;76;0;5;2;3;1;4;2;3;0
7982; 39.6 ; 991.1 ; 21.8 ;25;14;5;0;25;9;16;20;5;8;9;8
7983; 19.7 ; 39.3 ; -   ;2;45;381;0;2;1;1;2;0;2;0;0
7984; 40.7 ; 122.2 ; 9.0 ;3;32;42;0;3;0;3;1;2;0;3;0
7985; 47.0 ; 235.2 ; 0.4 ;5;36;60;0;5;3;2;3;2;0;5;0
7986; 34.0 ; 67.9 ; 13.3 ;2;59;142;0;2;1;1;0;2;1;1;0
7987; 17.3 ; 34.7 ; 3.5 ;2;4;248;0;2;1;1;0;2;2;0;0
7988; 35.5 ; 390.7 ; 17.9 ;11;16;6;0;11;7;4;8;3;4;7;0
7989; 21.8 ; 174.6 ; 7.2 ;8;5;325;0;8;1;7;2;6;8;0;0
7990; 34.6 ; 277.0 ; 17.4 ;8;40;7;0;8;5;3;5;3;3;5;0
7991; 99.7 ; 498.5 ; 91.5 ;5;10;15;0;5;0;5;4;1;2;0;3
7992; 21.0 ; 84.0 ; 8.6 ;4;14;13;4;0;2;2;2;2;4;0;0
7993; 40.5 ; 485.5 ; 16.3 ;12;26;2;0;12;6;6;2;10;4;4;4
7994; 22.5 ; 89.9 ; 9.2 ;4;12;7;0;4;3;1;1;3;3;1;0
7995; 51.1 ; 306.7 ; 7.4 ;6;28;20;0;6;4;2;0;6;0;4;2
7996; 37.3 ; 74.6 ; 14.1 ;2;99;221;0;2;0;2;0;2;1;1;0
7997; 53.2 ; 159.5 ; 6.2 ;3;46;89;0;3;1;2;2;1;0;2;1
7998; 39.2 ; 78.3 ; 21.1 ;2;36;22;0;2;0;2;1;1;1;0;1
7999; 84.6 ; 423.0 ; 40.8 ;5;41;141;0;5;0;5;4;1;0;0;5
8000; 36.6 ; 73.2 ; -   ;2;101;272;0;2;0;2;1;1;0;2;0
8001; 84.7 ; 169.4 ; 81.9 ;2;310;156;0;2;1;1;1;1;1;0;1
8002; 30.4 ; 91.2 ; 13.8 ;3;41;32;0;3;0;3;3;0;1;2;0
8003; 44.9 ; 224.4 ; 10.5 ;5;35;116;0;5;1;4;3;2;0;3;2
8004; 46.8 ; 93.5 ; -   ;2;32;225;0;2;0;2;1;1;0;2;0
8005; 48.8 ; 243.9 ; 4.9 ;5;46;69;0;5;0;5;5;0;0;5;0
8006; 17.8 ; 89.0 ; 6.7 ;5;4;281;0;5;4;1;5;0;5;0;0
8007; 52.8 ; 105.7 ; 8.0 ;2;75;36;2;0;0;2;2;0;0;1;1
8008; 56.3 ; 112.5 ; 14.2 ;2;28;279;0;2;1;1;1;1;0;0;2
8009; 39.6 ; 79.2 ; 14.1 ;2;150;52;0;2;0;2;1;1;1;1;0
8010; 28.5 ; 85.4 ; 3.1 ;3;135;137;0;3;1;2;1;2;2;1;0
8011; 51.2 ; 717.5 ; 20.9 ;14;29;1;0;14;2;12;6;8;0;9;5
8012; 32.0 ; 1,024.6 ; 14.4 ;32;14;15;3;29;14;18;15;17;11;21;0
8013; 26.4 ; 158.6 ; 12.1 ;6;39;83;0;6;2;4;0;6;4;2;0
8014; 31.6 ; 94.8 ; 2.6 ;3;195;37;0;3;1;2;1;2;1;2;0
8015; 38.2 ; 114.7 ; 12.2 ;3;113;117;0;3;3;0;1;2;1;2;0
8016; 33.1 ; 99.2 ; 14.3 ;3;4;93;3;0;1;2;0;3;1;2;0
8017; 22.8 ; 45.5 ; 4.5 ;2;67;167;0;2;1;1;1;1;2;0;0
8018; 35.0 ; 69.9 ; 9.8 ;2;29;170;0;2;1;1;2;0;1;1;0
8019; 39.1 ; 195.5 ; 22.7 ;5;14;189;0;5;0;5;4;1;2;1;2
8020; 24.6 ; 933.8 ; 15.9 ;38;7;113;0;38;10;28;33;5;25;13;0
8021; 21.6 ; 108.1 ; 10.0 ;5;84;2;0;5;1;4;4;1;3;2;0
8022; 33.0 ; 231.1 ; 19.1 ;7;50;10;1;6;3;4;5;2;2;5;0
8023; 32.2 ; 64.3 ; 16.0 ;2;15;238;0;2;1;1;0;2;1;1;0
8024; 25.6 ; 486.3 ; 7.0 ;19;14;69;0;19;3;16;13;6;13;6;0
8025; 40.7 ; 366.4 ; 8.9 ;9;34;22;0;9;6;3;2;7;0;9;0
8026; 39.0 ; 584.6 ; 17.3 ;15;20;5;0;15;3;12;6;9;5;5;5
8027; 48.9 ; 244.5 ; 5.3 ;5;51;241;0;5;3;2;2;3;0;5;0
8028; 30.8 ; 153.9 ; 14.3 ;5;66;11;0;5;3;2;2;3;2;3;0
8029; 27.2 ; 81.7 ; 10.5 ;3;149;131;0;3;0;3;1;2;2;1;0
8030; 36.0 ; 107.9 ; 13.8 ;3;23;7;0;3;1;2;3;0;1;2;0
8031; 31.4 ; 94.3 ; 30.2 ;3;73;59;0;3;2;1;1;2;1;1;1
8032; 56.4 ; 112.7 ; 8.0 ;2;7;137;1;1;0;2;0;2;0;0;2
8033; 20.9 ; 293.0 ; 4.7 ;14;8;233;0;14;11;3;4;10;14;0;0
8034; 68.9 ; 206.8 ; 8.5 ;3;94;107;0;3;2;1;1;2;0;0;3
8035; 50.0 ; 150.0 ; 3.1 ;3;29;30;0;3;1;2;0;3;0;3;0
8036; 47.7 ; 95.4 ; 1.4 ;2;36;122;2;0;0;2;0;2;0;2;0
8037; 20.5 ; 41.1 ; 0.9 ;2;42;191;0;2;1;1;0;2;2;0;0
8038; 38.5 ; 192.6 ; 20.9 ;5;40;17;5;0;2;3;2;3;2;1;2
8039; 44.9 ; 224.7 ; 22.4 ;5;17;36;0;5;1;4;4;1;2;1;2
8040; 136.9 ; 1,095.1 ; 21.0 ;8;24;41;0;8;0;8;7;1;0;0;8
8041; 30.2 ; 90.6 ; -   ;3;44;26;3;0;0;3;1;2;0;3;0
8042; 25.3 ; 101.3 ; 9.8 ;4;6;155;0;4;4;0;2;2;3;1;0
8043; 46.4 ; 92.7 ; 9.2 ;2;148;87;0;2;1;1;0;2;0;1;1
8044; 49.9 ; 149.8 ; 23.3 ;3;25;367;0;3;0;3;3;0;1;1;1
8045; 45.5 ; 91.1 ; 2.9 ;2;23;54;0;2;1;1;1;1;0;2;0
8046; 20.9 ; 41.7 ; 4.6 ;2;19;210;0;2;0;2;1;1;2;0;0
8047; 59.4 ; 1,129.5 ; 29.0 ;19;23;15;0;19;2;17;9;10;0;0;19
8048; 35.9 ; 143.7 ; 44.3 ;4;67;80;0;4;4;0;3;1;1;2;1
8049; 51.0 ; 102.0 ; -   ;2;188;104;0;2;0;2;2;0;0;2;0
8050; 55.7 ; 334.3 ; 25.9 ;6;47;5;0;6;0;6;2;4;2;0;4
8051; 80.6 ; 161.2 ; 28.5 ;2;41;250;0;2;1;1;2;0;0;0;2
8052; 38.3 ; 191.4 ; 24.9 ;5;50;91;0;5;4;1;1;4;2;1;2
8053; 15.0 ; 30.0 ; -   ;2;58;143;0;2;2;0;0;2;2;0;0
8054; 16.5 ; 33.0 ; 2.3 ;2;68;157;0;2;0;2;2;0;2;0;0
8055; 27.1 ; 81.2 ; 9.5 ;3;4;206;0;3;3;0;3;0;2;1;0
8056; 28.8 ; 86.5 ; 17.1 ;3;130;41;0;3;0;3;3;0;2;1;0
8057; 17.4 ; 121.6 ; 1.8 ;7;29;22;0;7;2;5;4;3;7;0;0
8058; 33.0 ; 66.0 ; 27.0 ;2;18;110;0;2;0;2;2;0;1;0;1
8059; 17.4 ; 34.7 ; 3.6 ;2;15;54;0;2;1;1;1;1;2;0;0
8060; 22.9 ; 91.7 ; 8.9 ;4;32;43;0;4;1;3;2;2;3;1;0
8061; 38.8 ; 194.0 ; 20.9 ;5;26;5;0;5;2;3;1;4;2;1;2
8062; 18.4 ; 331.6 ; 4.2 ;18;14;50;0;18;10;8;8;10;18;0;0
8063; 67.6 ; 405.7 ; 23.3 ;6;44;17;0;6;3;3;1;5;0;0;6
8064; 44.7 ; 89.5 ; 12.2 ;2;18;305;0;2;0;2;1;1;0;1;1
8065; 15.0 ; 74.9 ; -   ;5;73;106;0;5;2;3;1;4;5;0;0
8066; 72.2 ; 288.7 ; 16.7 ;4;19;14;4;0;3;1;1;3;0;0;4
8067; 81.3 ; 244.0 ; 27.2 ;3;110;10;0;3;0;3;3;0;0;0;3
8068; 80.5 ; 322.0 ; 72.2 ;4;9;220;0;4;1;3;4;0;1;0;3
8069; 40.4 ; 121.2 ; 9.6 ;3;81;73;0;3;2;1;2;1;0;3;0
8070; 20.9 ; 250.9 ; 4.9 ;12;17;15;0;12;0;12;9;3;12;0;0
8071; 46.8 ; 93.5 ; -   ;2;5;253;0;2;0;2;1;1;0;2;0
8072; 43.9 ; 263.7 ; 21.5 ;6;23;151;0;6;3;3;5;1;2;2;2
8073; 29.4 ; 88.2 ; 13.2 ;3;12;2;0;3;2;1;1;2;2;1;0
8074; 29.1 ; 203.8 ; 12.1 ;7;38;32;0;7;0;7;1;6;5;2;0
8075; 22.8 ; 113.9 ; 3.9 ;5;44;17;0;5;1;4;0;5;5;0;0
8076; 39.9 ; 159.4 ; 14.6 ;4;25;141;0;4;0;4;2;2;1;3;0
8077; 23.5 ; 117.4 ; 9.0 ;5;88;8;0;5;3;2;4;1;3;2;0
8078; 40.6 ; 81.3 ; 10.2 ;2;41;215;0;2;1;1;1;1;0;2;0
8079; 61.6 ; 246.6 ; 14.9 ;4;90;0;0;4;0;4;4;0;0;0;4
8080; 38.6 ; 578.7 ; 21.1 ;15;14;16;0;15;0;15;11;4;5;5;5
8081; 47.3 ; 757.0 ; 1.2 ;16;27;5;0;16;0;16;6;10;0;16;0
8082; 34.3 ; 171.7 ; 6.3 ;5;47;63;0;5;0;5;2;3;2;3;0
8083; 22.8 ; 45.7 ; 7.6 ;2;23;197;0;2;1;1;1;1;1;1;0
8084; 39.6 ; 158.4 ; 8.1 ;4;88;15;0;4;1;3;3;1;0;4;0
8085; 28.8 ; 259.5 ; 12.4 ;9;28;14;0;9;5;4;4;5;6;3;0
8086; 17.4 ; 87.0 ; 1.4 ;5;4;122;0;5;2;3;3;2;5;0;0
8087; 53.5 ; 374.8 ; 24.5 ;7;37;137;0;7;2;5;5;2;2;3;2
8088; 49.1 ; 147.4 ; 2.4 ;3;47;10;0;3;1;2;1;2;0;3;0
8089; 15.0 ; 74.9 ; -   ;5;36;95;0;5;0;5;3;2;5;0;0
8090; 15.0 ; 74.9 ; -   ;5;14;117;0;5;4;1;2;3;5;0;0
8091; 15.4 ; 107.6 ; 1.1 ;7;44;14;0;7;5;2;4;3;7;0;0
8092; 40.4 ; 161.5 ; 13.6 ;4;10;233;0;4;1;3;3;1;1;3;0
8093; 25.9 ; 103.7 ; 16.8 ;4;23;121;0;4;1;3;4;0;3;1;0
8094; 79.7 ; 159.5 ; 14.5 ;2;1;381;0;2;1;1;1;1;0;0;2
8095; 32.5 ; 975.6 ; 18.0 ;30;12;1;0;30;17;13;24;6;10;20;0
8096; 15.0 ; 344.7 ; -   ;23;14;15;0;23;0;23;17;6;23;0;0
8097; 94.7 ; 378.6 ; 19.8 ;4;49;209;0;4;0;4;4;0;0;0;4
8098; 37.0 ; 555.3 ; 19.0 ;15;24;74;0;15;1;14;11;4;5;5;5
8099; 26.1 ; 52.3 ; -   ;2;5;272;0;2;0;2;1;1;2;0;0
8100; 44.8 ; 269.0 ; 14.2 ;6;44;26;0;6;1;5;3;3;0;4;2
8101; 22.4 ; 44.7 ; 5.7 ;2;10;257;0;2;1;1;0;2;2;0;0
8102; 27.8 ; 55.6 ; 3.2 ;2;6;219;0;2;1;1;2;0;1;1;0
8103; 40.8 ; 81.5 ; -   ;2;25;89;0;2;0;2;2;0;0;2;0
8104; 63.6 ; 127.2 ; 31.1 ;2;57;111;0;2;0;2;0;2;0;0;2
8105; 55.0 ; 109.9 ; 10.1 ;2;120;16;0;2;0;2;2;0;0;1;1
8106; 38.6 ; 308.4 ; 16.6 ;8;29;22;0;8;6;2;6;2;3;2;3
8107; 37.6 ; 112.8 ; 17.4 ;3;27;59;0;3;0;3;2;1;1;1;1
8108; 34.7 ; 138.8 ; 12.8 ;4;44;104;0;4;1;3;4;0;1;3;0
8109; 89.9 ; 179.8 ; 51.5 ;2;12;59;0;2;1;1;2;0;0;0;2
8110; 38.4 ; 191.9 ; 24.0 ;5;6;188;0;5;1;4;3;2;2;1;2
8111; 60.0 ; 180.0 ; 35.1 ;3;135;57;0;3;0;3;2;1;1;0;2
8112; 88.9 ; 622.6 ; 45.3 ;7;59;40;0;7;3;4;3;4;0;0;7
8113; 55.8 ; 111.5 ; 13.5 ;2;5;273;0;2;0;2;1;1;0;0;2
8114; 32.5 ; 194.7 ; 15.1 ;6;31;2;0;6;1;5;5;1;2;4;0
8115; 52.7 ; 158.2 ; 8.9 ;3;13;52;0;3;0;3;1;2;0;2;1
8116; 23.4 ; 116.8 ; 14.6 ;5;49;5;0;5;1;4;2;3;3;2;0
8117; 41.0 ; 81.9 ; 9.8 ;2;43;68;0;2;0;2;2;0;0;2;0
8118; 41.5 ; 207.7 ; 30.0 ;5;58;41;0;5;0;5;3;2;2;1;2
8119; 53.8 ; 376.6 ; 24.4 ;7;21;8;0;7;5;2;7;0;2;3;2
8120; 26.3 ; 78.9 ; 1.7 ;3;2;81;0;3;1;2;1;2;3;0;0
8121; 22.3 ; 44.7 ; 11.0 ;2;65;202;0;2;2;0;0;2;1;1;0
8122; 29.8 ; 89.3 ; 6.9 ;3;95;116;0;3;2;1;1;2;2;1;0
8123; 45.8 ; 91.6 ; 4.4 ;2;12;277;0;2;2;0;1;1;0;2;0
8124; 28.9 ; 86.8 ; 17.2 ;3;22;332;0;3;0;3;1;2;2;1;0
8125; 21.3 ; 85.2 ; 1.9 ;4;15;10;0;4;2;2;2;2;4;0;0
8126; 48.2 ; 96.3 ; 2.1 ;2;98;179;0;2;1;1;2;0;0;2;0
8127; 27.6 ; 110.2 ; 6.1 ;4;4;119;0;4;3;1;1;3;3;1;0
8128; 26.1 ; 52.3 ; -   ;2;20;288;0;2;0;2;0;2;2;0;0
8129; 15.9 ; 381.9 ; 3.2 ;24;5;5;0;24;0;24;12;12;24;0;0
8130; 24.4 ; 73.2 ; 2.7 ;3;16;9;1;2;1;2;0;3;3;0;0
8131; 41.3 ; 454.6 ; 7.8 ;11;20;100;0;11;1;10;10;1;0;11;0
8132; 25.0 ; 75.0 ; 6.8 ;3;12;247;0;3;1;2;1;2;2;1;0
8133; 18.6 ; 37.2 ; 4.3 ;2;369;5;0;2;1;1;0;2;2;0;0
8134; 35.1 ; 140.3 ; 16.6 ;4;45;69;0;4;1;3;3;1;1;3;0
8135; 29.2 ; 116.7 ; 6.2 ;4;11;121;0;4;0;4;4;0;3;1;0
8136; 57.0 ; 285.1 ; 47.3 ;5;17;15;5;0;3;2;3;2;2;0;3
8137; 30.9 ; 185.2 ; 15.4 ;6;40;16;0;6;0;6;3;3;2;4;0
8138; 42.0 ; 83.9 ; 40.4 ;2;101;21;0;2;0;2;0;2;1;0;1
8139; 22.3 ; 223.2 ; 5.0 ;10;15;106;0;10;3;7;7;3;10;0;0
8140; 32.3 ; 64.6 ; 3.2 ;2;24;320;0;2;0;2;1;1;1;1;0
8141; 43.8 ; 87.6 ; 4.4 ;2;268;81;0;2;1;1;1;1;0;2;0
8142; 42.5 ; 382.6 ; 11.5 ;9;38;15;0;9;2;7;6;3;0;9;0
8143; 85.4 ; 341.6 ; 19.4 ;4;63;136;0;4;0;4;3;1;0;0;4
8144; 36.3 ; 181.7 ; 8.6 ;5;14;68;0;5;3;2;1;4;2;3;0
8145; 19.1 ; 38.3 ; 0.3 ;2;1;230;0;2;0;2;1;1;2;0;0
8146; 29.0 ; 145.0 ; 10.2 ;5;31;251;0;5;2;3;1;4;3;2;0
8147; 73.8 ; 221.4 ; 26.5 ;3;56;167;0;3;2;1;0;3;0;0;3
8148; 27.2 ; 54.4 ; 14.1 ;2;22;171;0;2;1;1;0;2;1;1;0
8149; 25.9 ; 129.5 ; 16.9 ;5;11;61;0;5;4;1;3;2;3;2;0
8150; 31.8 ; 63.5 ; 3.3 ;2;6;231;0;2;0;2;2;0;1;1;0
8151; 44.8 ; 89.6 ; 2.9 ;2;68;190;1;1;0;2;2;0;0;2;0
8152; 52.6 ; 420.7 ; 0.3 ;8;43;68;0;8;1;7;8;0;0;8;0
8153; 21.9 ; 219.5 ; 6.4 ;10;30;32;0;10;1;9;7;3;10;0;0
8154; 43.1 ; 172.3 ; 15.8 ;4;32;104;0;4;2;2;2;2;1;2;1
8155; 22.5 ; 44.9 ; 11.2 ;2;36;17;0;2;0;2;1;1;1;1;0
8156; 31.5 ; 94.4 ; 15.5 ;3;11;254;0;3;1;2;2;1;1;2;0
8157; 46.0 ; 91.9 ; 46.4 ;2;25;251;0;2;1;1;1;1;1;0;1
8158; 26.7 ; 53.4 ; 13.3 ;2;40;179;0;2;1;1;2;0;1;1;0
8159; 19.0 ; 550.4 ; 5.8 ;29;14;14;0;29;3;26;17;12;29;0;0
8160; 61.2 ; 122.5 ; 5.2 ;2;2;292;0;2;1;1;0;2;0;0;2
8161; 75.3 ; 150.6 ; 26.1 ;2;237;118;0;2;1;1;2;0;0;0;2
8162; 26.1 ; 156.6 ; 13.1 ;6;35;90;0;6;1;5;0;6;4;2;0
8163; 19.7 ; 39.3 ; -   ;2;75;205;0;2;0;2;0;2;2;0;0
8164; 27.9 ; 55.9 ; 4.3 ;2;196;27;2;0;1;1;1;1;1;1;0
8165; 19.6 ; 39.1 ; 6.8 ;2;95;53;0;2;0;2;1;1;2;0;0
8166; 25.9 ; 129.3 ; 8.7 ;5;77;45;0;5;3;2;1;4;3;2;0
8167; 36.8 ; 110.5 ; 13.9 ;3;41;150;0;3;2;1;3;0;1;2;0
8168; 56.2 ; 168.6 ; 6.8 ;3;48;188;0;3;0;3;2;1;0;0;3
8169; 23.9 ; 119.4 ; 13.9 ;5;70;144;0;5;2;3;4;1;3;2;0
8170; 38.8 ; 77.7 ; 12.9 ;2;142;95;2;0;0;2;2;0;1;1;0
8171; 44.1 ; 88.2 ; 3.9 ;2;109;199;0;2;0;2;2;0;0;2;0
8172; 24.5 ; 342.5 ; 11.1 ;14;19;5;2;12;0;14;9;5;9;5;0
8173; 96.4 ; 192.8 ; 52.9 ;2;68;57;0;2;0;2;2;0;0;0;2
8174; 98.4 ; 196.8 ; 2.9 ;2;29;173;0;2;1;1;1;1;0;0;2
8175; 50.8 ; 203.1 ; 20.8 ;4;59;101;0;4;1;3;1;3;0;3;1
8176; 66.5 ; 399.2 ; 27.7 ;6;52;6;0;6;0;6;3;3;0;0;6
8177; 47.5 ; 665.2 ; 0.5 ;14;11;5;0;14;4;10;12;2;0;14;0
8178; 37.8 ; 151.2 ; 17.8 ;4;57;230;0;4;0;4;2;2;1;2;1
8179; 54.1 ; 216.4 ; 8.9 ;4;33;38;2;2;3;1;3;1;0;3;1
8180; 73.3 ; 146.7 ; 11.8 ;2;18;36;0;2;0;2;0;2;0;0;2
8181; 27.9 ; 111.5 ; 2.9 ;4;46;159;0;4;1;3;2;2;3;1;0
8182; 46.3 ; 648.2 ; 16.7 ;14;18;94;0;14;4;10;6;8;5;4;5
8183; 44.5 ; 311.5 ; 13.4 ;7;27;6;0;7;0;7;5;2;0;5;2
8184; 74.6 ; 671.7 ; 36.8 ;9;32;29;0;9;3;6;5;4;0;0;9
8185; 22.9 ; 480.2 ; 9.6 ;21;21;5;0;21;13;8;13;8;14;7;0
8186; 26.5 ; 105.8 ; 4.8 ;4;90;4;0;4;1;3;2;2;3;1;0
8187; 37.5 ; 149.8 ; 20.2 ;4;92;32;0;4;1;3;2;2;1;2;1
8188; 27.2 ; 54.4 ; 3.2 ;2;25;80;0;2;1;1;2;0;1;1;0
8189; 65.0 ; 390.3 ; 55.4 ;6;48;10;0;6;0;6;6;0;2;0;4
8190; 46.3 ; 231.3 ; 2.1 ;5;68;26;0;5;3;2;4;1;0;5;0
8191; 65.7 ; 131.5 ; 28.4 ;2;330;102;0;2;1;1;0;2;0;0;2
8192; 46.7 ; 140.0 ; 7.0 ;3;86;35;3;0;3;0;1;2;0;3;0
8193; 57.5 ; 1,034.4 ; 36.1 ;18;11;224;0;18;10;8;4;14;6;0;12
8194; 31.1 ; 498.3 ; 4.1 ;16;18;8;0;16;8;8;9;7;5;11;0
8195; 63.1 ; 315.7 ; 7.9 ;5;75;22;0;5;0;5;3;2;0;0;5
8196; 53.6 ; 107.2 ; 0.5 ;2;93;17;0;2;0;2;2;0;0;2;0
8197; 36.1 ; 72.1 ; 27.0 ;2;230;81;0;2;1;1;2;0;1;0;1
8198; 65.2 ; 130.4 ; 12.0 ;2;1;239;0;2;2;0;0;2;0;0;2
8199; 53.1 ; 371.5 ; 27.3 ;7;39;22;0;7;2;5;3;4;2;3;2
8200; 40.7 ; 162.8 ; 5.3 ;4;40;47;1;3;0;4;1;3;0;4;0
8201; 49.6 ; 198.5 ; 18.7 ;4;39;52;2;2;1;3;3;1;0;3;1
8202; 71.2 ; 142.4 ; 35.5 ;2;9;65;0;2;1;1;1;1;0;0;2
8203; 44.8 ; 313.7 ; 23.3 ;7;42;20;0;7;0;7;4;3;2;3;2
8204; 34.8 ; 69.6 ; 23.2 ;2;2;86;0;2;1;1;1;1;1;0;1
8205; 85.3 ; 170.6 ; 18.0 ;2;168;20;2;0;2;0;0;2;0;0;2
8206; 35.8 ; 286.8 ; 10.6 ;8;36;10;0;8;1;7;6;2;3;5;0
8207; 117.2 ; 585.8 ; 23.9 ;5;57;62;0;5;0;5;2;3;0;0;5
8208; 18.9 ; 94.4 ; 9.2 ;5;68;45;1;4;5;0;5;0;5;0;0
8209; 43.6 ; 130.7 ; 17.0 ;3;16;2;0;3;3;0;1;2;1;1;1
8210; 15.0 ; 59.9 ; -   ;4;6;108;0;4;3;1;1;3;4;0;0
8211; 22.5 ; 112.6 ; 8.3 ;5;12;140;0;5;5;0;5;0;3;2;0
8212; 30.0 ; 59.9 ; -   ;2;30;1;0;2;0;2;1;1;2;0;0
8213; 66.5 ; 133.0 ; 18.8 ;2;7;5;0;2;0;2;2;0;0;0;2
8214; 16.7 ; 83.3 ; 4.4 ;5;14;181;0;5;2;3;1;4;5;0;0
8215; 33.9 ; 101.8 ; 13.4 ;3;139;20;0;3;0;3;3;0;1;2;0
8216; 48.4 ; 242.2 ; 13.5 ;5;30;161;0;5;3;2;2;3;0;3;2
8217; 52.9 ; 105.7 ; -   ;2;2;154;0;2;2;0;2;0;0;2;0
8218; 44.1 ; 88.2 ; 43.6 ;2;38;179;0;2;1;1;0;2;1;0;1
8219; 50.8 ; 254.2 ; 3.4 ;5;75;52;0;5;1;4;1;4;0;5;0
8220; 41.3 ; 165.0 ; 14.8 ;4;23;27;0;4;1;3;4;0;1;2;1
8221; 41.9 ; 209.6 ; 17.8 ;5;63;38;0;5;1;4;3;2;2;1;2
8222; 30.2 ; 60.4 ; -   ;2;80;27;2;0;0;2;0;2;0;2;0
8223; 31.0 ; 92.9 ; 20.8 ;3;34;179;0;3;1;2;1;2;1;2;0
8224; 29.2 ; 117.0 ; 14.0 ;4;18;262;0;4;2;2;2;2;3;1;0
8225; 20.4 ; 81.6 ; 11.4 ;4;4;9;0;4;4;0;1;3;3;1;0
8226; 47.1 ; 235.4 ; 13.8 ;5;26;17;0;5;0;5;0;5;0;3;2
8227; 45.6 ; 227.9 ; 10.4 ;5;63;88;0;5;1;4;4;1;0;3;2
8228; 46.2 ; 138.5 ; 14.9 ;3;37;160;0;3;2;1;2;1;0;2;1
8229; 84.4 ; 421.8 ; 39.5 ;5;15;0;0;5;1;4;5;0;0;0;5
8230; 22.1 ; 110.3 ; 7.2 ;5;47;26;0;5;1;4;2;3;5;0;0
8231; 33.6 ; 167.8 ; 15.0 ;5;22;59;0;5;0;5;2;3;2;3;0
8232; 46.8 ; 140.3 ; -   ;3;52;170;0;3;1;2;3;0;0;3;0
8233; 21.7 ; 108.7 ; 11.3 ;5;49;4;0;5;4;1;2;3;3;2;0
8234; 20.0 ; 40.1 ; 7.6 ;2;48;234;0;2;2;0;0;2;2;0;0
8235; 42.0 ; 84.1 ; 8.1 ;2;182;73;1;1;0;2;1;1;0;2;0
8236; 21.2 ; 318.6 ; 9.9 ;15;14;77;0;15;9;6;9;6;10;5;0
8237; 29.4 ; 147.0 ; 28.5 ;5;9;241;0;5;2;3;4;1;3;0;2
8238; 29.9 ; 119.5 ; 13.1 ;4;14;110;0;4;0;4;2;2;3;1;0
8239; 63.6 ; 318.0 ; 14.2 ;5;44;63;0;5;1;4;3;2;0;0;5
8240; 15.8 ; 63.2 ; 1.7 ;4;110;2;0;4;4;0;2;2;4;0;0
8241; 53.0 ; 159.0 ; 14.6 ;3;18;80;0;3;1;2;1;2;0;2;1
8242; 43.8 ; 87.7 ; 4.4 ;2;65;178;0;2;0;2;2;0;0;2;0
8243; 33.3 ; 133.1 ; 6.9 ;4;18;13;0;4;1;3;2;2;1;3;0
8244; 60.3 ; 120.5 ; 17.3 ;2;25;188;0;2;0;2;2;0;0;0;2
8245; 33.3 ; 432.5 ; 18.8 ;13;22;145;0;13;2;11;8;5;4;9;0
8246; 25.1 ; 75.2 ; -   ;3;4;191;0;3;3;0;1;2;3;0;0
8247; 30.8 ; 154.2 ; 12.0 ;5;59;61;0;5;1;4;2;3;2;3;0
8248; 22.9 ; 114.4 ; 8.4 ;5;34;68;0;5;0;5;1;4;3;2;0
8249; 23.9 ; 119.3 ; 11.6 ;5;9;142;0;5;0;5;3;2;3;2;0
8250; 44.6 ; 490.4 ; 13.4 ;11;28;8;0;11;3;8;10;1;0;7;4
8251; 28.6 ; 57.3 ; 10.6 ;2;5;178;0;2;0;2;0;2;1;1;0
8252; 41.7 ; 1,416.7 ; 19.2 ;34;9;0;0;34;6;28;30;4;11;12;11
8253; 29.1 ; 232.4 ; 7.9 ;8;33;0;0;8;4;4;5;3;5;3;0
8254; 60.9 ; 121.8 ; 12.6 ;2;9;370;0;2;1;1;1;1;0;0;2
8255; 25.1 ; 50.1 ; -   ;2;6;254;0;2;2;0;0;2;2;0;0
8256; 45.5 ; 90.9 ; 3.0 ;2;63;41;1;1;0;2;2;0;0;2;0
8257; 45.0 ; 225.0 ; 5.0 ;5;37;78;0;5;2;3;5;0;0;5;0
8258; 31.4 ; 125.4 ; 20.0 ;4;14;104;0;4;1;3;3;1;1;3;0
8259; 31.1 ; 155.7 ; 10.1 ;5;29;62;0;5;3;2;0;5;2;3;0
8260; 29.9 ; 89.7 ; 5.0 ;3;104;95;0;3;0;3;2;1;2;1;0
8261; 91.7 ; 275.1 ; 55.0 ;3;108;31;0;3;1;2;2;1;0;0;3
8262; 28.5 ; 85.4 ; 3.1 ;3;46;215;0;3;2;1;1;2;2;1;0
8263; 21.5 ; 172.0 ; 6.3 ;8;20;20;0;8;5;3;2;6;8;0;0
8264; 47.6 ; 571.5 ; 22.8 ;12;35;8;0;12;4;8;4;8;4;4;4
8265; 37.9 ; 758.9 ; 15.9 ;20;14;19;0;20;8;12;10;10;7;13;0
8266; 42.9 ; 471.4 ; 14.2 ;11;27;8;0;11;7;4;4;7;4;3;4
8267; 20.0 ; 40.1 ; 7.6 ;2;5;121;0;2;0;2;2;0;2;0;0
8268; 20.2 ; 808.9 ; 16.2 ;40;11;5;0;40;13;27;22;18;27;13;0
8269; 36.9 ; 73.8 ; 17.7 ;2;41;44;0;2;1;1;2;0;1;1;0
8270; 31.5 ; 157.3 ; 11.4 ;5;14;227;0;5;0;5;2;3;2;3;0
8271; 57.0 ; 114.0 ; 6.7 ;2;37;147;0;2;0;2;2;0;0;0;2
8272; 89.1 ; 980.3 ; 41.7 ;11;17;150;0;11;10;1;2;9;0;0;11
8273; 40.9 ; 204.5 ; 23.5 ;5;14;4;0;5;4;1;2;3;2;1;2
8274; 46.8 ; 93.5 ; -   ;2;311;107;0;2;1;1;2;0;0;2;0
8275; 18.2 ; 219.0 ; 2.9 ;12;27;3;0;12;7;5;3;9;12;0;0
8276; 19.2 ; 96.1 ; 10.0 ;5;52;82;0;5;1;4;2;3;5;0;0
8277; 37.3 ; 186.6 ; 7.9 ;5;47;119;0;5;3;2;3;2;2;3;0
8278; 18.7 ; 74.9 ; 7.9 ;4;68;12;0;4;1;3;1;3;4;0;0
8279; 55.8 ; 614.1 ; 17.0 ;11;29;99;0;11;5;6;9;2;0;0;11
8280; 30.9 ; 61.7 ; 23.8 ;2;249;80;0;2;0;2;1;1;1;1;0
8281; 35.9 ; 71.8 ; 16.2 ;2;43;142;0;2;0;2;0;2;1;1;0
8282; 32.9 ; 98.7 ; 12.1 ;3;109;85;0;3;0;3;0;3;1;2;0
8283; 25.9 ; 259.2 ; 16.0 ;10;18;50;0;10;3;7;5;5;7;3;0
8284; 43.2 ; 86.3 ; 19.4 ;2;34;241;0;2;1;1;1;1;1;0;1
8285; 52.2 ; 574.7 ; 18.2 ;11;36;10;0;11;4;7;9;2;0;7;4
8286; 33.8 ; 67.5 ; 28.1 ;2;5;296;0;2;1;1;1;1;1;0;1
8287; 48.1 ; 144.4 ; 22.2 ;3;61;58;2;1;2;1;3;0;1;1;1
8288; 44.3 ; 133.0 ; 9.1 ;3;138;42;0;3;1;2;3;0;0;3;0
8289; 18.6 ; 93.2 ; 1.6 ;5;66;31;0;5;0;5;5;0;5;0;0
8290; 56.6 ; 113.2 ; 55.2 ;2;79;43;0;2;0;2;2;0;1;0;1
8291; 19.4 ; 174.4 ; 5.3 ;9;22;2;0;9;6;3;4;5;9;0;0
8292; 38.8 ; 77.7 ; 11.9 ;2;131;0;0;2;0;2;1;1;1;1;0
8293; 19.4 ; 38.9 ; -   ;2;12;264;0;2;2;0;1;1;2;0;0
8294; 25.3 ; 50.6 ; 7.3 ;2;90;281;0;2;1;1;0;2;1;1;0
8295; 48.2 ; 192.6 ; 1.0 ;4;40;141;0;4;2;2;4;0;0;4;0
8296; 69.8 ; 348.8 ; 16.1 ;5;9;84;0;5;2;3;5;0;0;0;5
8297; 120.2 ; 240.4 ; 32.6 ;2;284;142;0;2;1;1;1;1;0;0;2
8298; 23.4 ; 46.8 ; 3.4 ;2;138;5;1;1;0;2;0;2;2;0;0
8299; 25.3 ; 861.2 ; 9.8 ;34;8;4;0;34;16;18;20;14;23;11;0
8300; 30.2 ; 90.6 ; -   ;3;19;272;0;3;1;2;1;2;0;3;0
8301; 62.3 ; 124.6 ; 29.3 ;2;26;52;0;2;0;2;1;1;0;0;2
8302; 48.3 ; 627.6 ; 3.8 ;13;31;0;6;7;0;13;13;0;0;13;0
8303; 53.0 ; 265.0 ; 0.4 ;5;12;71;0;5;2;3;0;5;0;5;0
8304; 25.6 ; 51.3 ; 6.8 ;2;14;86;0;2;2;0;0;2;1;1;0
8305; 67.2 ; 201.6 ; 28.3 ;3;23;232;0;3;0;3;1;2;0;0;3
8306; 51.7 ; 206.8 ; 26.7 ;4;92;47;0;4;1;3;4;0;1;2;1
8307; 17.5 ; 69.9 ; 4.7 ;4;23;17;0;4;2;2;3;1;4;0;0
8308; 20.0 ; 59.9 ; 9.2 ;3;29;122;0;3;2;1;1;2;3;0;0
8309; 40.8 ; 81.7 ; 38.7 ;2;7;67;0;2;1;1;1;1;1;0;1
8310; 54.5 ; 381.3 ; 10.5 ;7;50;5;0;7;0;7;5;2;0;5;2
8311; 25.4 ; 50.9 ; 3.2 ;2;16;217;0;2;1;1;0;2;2;0;0
8312; 20.0 ; 40.1 ; 7.6 ;2;19;57;0;2;0;2;1;1;2;0;0
8313; 16.8 ; 117.5 ; 2.0 ;7;13;143;7;0;6;1;7;0;7;0;0
8314; 50.0 ; 100.0 ; 11.2 ;2;6;74;0;2;0;2;2;0;0;1;1
8315; 16.5 ; 33.0 ; 2.3 ;2;37;116;0;2;0;2;1;1;2;0;0
8316; 24.2 ; 435.9 ; 12.1 ;18;13;8;0;18;10;8;6;12;12;6;0
8317; 24.4 ; 48.8 ; 8.7 ;2;242;82;0;2;1;1;0;2;1;1;0
8318; 27.8 ; 139.2 ; 15.8 ;5;31;116;0;5;2;3;2;3;3;2;0
8319; 21.1 ; 42.2 ; 5.9 ;2;8;335;0;2;1;1;1;1;2;0;0
8320; 22.5 ; 44.9 ; 11.2 ;2;212;55;0;2;2;0;1;1;1;1;0
8321; 30.8 ; 61.7 ; 15.6 ;2;214;20;0;2;0;2;2;0;1;1;0
8322; 25.1 ; 50.1 ; -   ;2;6;210;0;2;0;2;0;2;2;0;0
8323; 35.7 ; 107.1 ; 10.1 ;3;65;109;0;3;2;1;1;2;1;2;0
8324; 37.1 ; 148.3 ; 10.8 ;4;102;13;0;4;2;2;4;0;1;3;0
8325; 82.3 ; 164.6 ; 15.2 ;2;30;236;0;2;1;1;1;1;0;0;2
8326; 37.8 ; 189.0 ; 13.7 ;5;23;237;0;5;3;2;5;0;2;3;0
8327; 41.2 ; 247.2 ; 16.0 ;6;14;120;0;6;0;6;4;2;2;2;2
8328; 15.0 ; 74.9 ; -   ;5;51;131;0;5;2;3;5;0;5;0;0
8329; 27.3 ; 81.8 ; 2.8 ;3;41;53;0;3;1;2;3;0;2;1;0
8330; 58.9 ; 235.4 ; 24.9 ;4;76;25;4;0;2;2;3;1;0;0;4
8331; 52.7 ; 105.3 ; 9.1 ;2;169;24;0;2;2;0;0;2;0;1;1
8332; 36.9 ; 73.8 ; 17.7 ;2;40;110;0;2;0;2;1;1;1;1;0
8333; 38.2 ; 879.6 ; 20.0 ;23;14;15;10;13;7;16;8;15;8;7;8
8334; 21.1 ; 253.4 ; 7.5 ;12;31;1;0;12;1;11;10;2;12;0;0
8335; 53.6 ; 214.4 ; 7.2 ;4;25;16;0;4;1;3;4;0;0;3;1
8336; 51.2 ; 921.4 ; 23.2 ;18;16;5;0;18;0;18;17;1;6;6;6
8337; 29.0 ; 724.0 ; 13.9 ;25;12;0;0;25;5;20;23;2;17;8;0
8338; 52.9 ; 264.4 ; 19.9 ;5;40;29;0;5;2;3;1;4;0;3;2
8339; 49.2 ; 98.3 ; 36.1 ;2;84;22;1;1;1;1;2;0;1;0;1
8340; 55.4 ; 110.7 ; 4.3 ;2;321;89;0;2;0;2;2;0;0;0;2
8341; 67.2 ; 201.5 ; 25.9 ;3;112;26;0;3;1;2;2;1;0;0;3
8342; 53.9 ; 215.7 ; 12.6 ;4;62;20;0;4;3;1;1;3;0;3;1
8343; 41.0 ; 942.3 ; 20.1 ;23;10;10;0;23;12;11;2;21;8;7;8
8344; 37.7 ; 113.2 ; 14.1 ;3;33;104;0;3;1;2;1;2;1;2;0
8345; 35.7 ; 107.1 ; 10.1 ;3;29;68;0;3;0;3;3;0;1;2;0
8346; 30.8 ; 61.7 ; 8.6 ;2;32;267;0;2;0;2;1;1;1;1;0
8347; 32.1 ; 192.5 ; 22.7 ;6;31;8;0;6;6;0;2;4;2;4;0
8348; 17.6 ; 52.7 ; 2.5 ;3;46;83;0;3;1;2;3;0;3;0;0
8349; 56.4 ; 225.5 ; 9.3 ;4;33;22;0;4;0;4;3;1;0;0;4
8350; 30.0 ; 59.9 ; -   ;2;7;373;0;2;0;2;0;2;2;0;0
8351; 26.0 ; 52.0 ; 16.5 ;2;136;97;1;1;1;1;2;0;1;1;0
8352; 55.6 ; 278.2 ; 8.9 ;5;34;42;1;4;0;5;4;1;0;0;5
8353; 52.9 ; 105.8 ; 0.5 ;2;74;44;2;0;1;1;2;0;0;2;0
8354; 47.1 ; 94.2 ; 0.5 ;2;97;79;0;2;1;1;2;0;0;2;0
8355; 46.8 ; 93.5 ; -   ;2;24;233;0;2;2;0;2;0;0;2;0
8356; 31.9 ; 95.7 ; 18.5 ;3;11;323;0;3;1;2;3;0;1;2;0
8357; 21.1 ; 105.5 ; 14.4 ;5;13;1;0;5;3;2;4;1;3;2;0
8358; 30.4 ; 60.8 ; 14.5 ;2;8;340;0;2;1;1;1;1;1;1;0
8359; 27.6 ; 55.1 ; 3.9 ;2;35;257;0;2;1;1;0;2;1;1;0
8360; 46.8 ; 140.3 ; -   ;3;9;257;0;3;0;3;1;2;0;3;0
8361; 18.1 ; 54.2 ; 0.1 ;3;23;20;0;3;1;2;2;1;3;0;0
8362; 73.3 ; 219.8 ; 14.7 ;3;126;31;0;3;0;3;3;0;0;0;3
8363; 37.3 ; 74.6 ; 18.3 ;2;252;47;0;2;0;2;1;1;1;0;1
8364; 23.7 ; 403.0 ; 3.7 ;17;14;5;17;0;0;17;16;1;17;0;0
8365; 44.2 ; 176.9 ; 25.7 ;4;52;121;0;4;1;3;2;2;1;2;1
8366; 27.0 ; 80.9 ; 12.9 ;3;65;167;0;3;3;0;2;1;2;1;0
8367; 43.4 ; 130.1 ; 6.2 ;3;23;233;0;3;2;1;2;1;0;3;0
8368; 64.1 ; 576.7 ; 11.8 ;9;23;5;0;9;0;9;4;5;0;0;9
8369; 44.3 ; 177.1 ; 13.9 ;4;17;249;0;4;1;3;2;2;0;3;1
8370; 84.0 ; 168.0 ; 25.8 ;2;2;2;0;2;2;0;2;0;0;0;2
8371; 15.0 ; 30.0 ; -   ;2;11;119;0;2;2;0;0;2;2;0;0
8372; 15.0 ; 45.0 ; -   ;3;32;52;0;3;0;3;2;1;3;0;0
8373; 53.8 ; 161.5 ; 1.2 ;3;55;20;0;3;2;1;0;3;0;2;1
8374; 41.3 ; 412.8 ; 20.8 ;10;31;2;0;10;8;2;4;6;3;4;3
8375; 45.3 ; 90.5 ; 9.3 ;2;95;168;0;2;0;2;1;1;0;2;0
8376; 28.5 ; 142.3 ; 19.5 ;5;14;53;5;0;3;2;1;4;3;2;0
8377; 33.8 ; 101.4 ; 3.0 ;3;9;8;0;3;1;2;1;2;0;3;0
8378; 41.7 ; 83.4 ; 7.6 ;2;268;44;0;2;1;1;2;0;0;2;0
8379; 48.3 ; 966.8 ; 25.8 ;20;16;0;0;20;3;17;13;7;7;6;7
8380; 44.1 ; 220.4 ; 24.4 ;5;56;98;0;5;1;4;2;3;2;1;2
8381; 19.9 ; 99.4 ; 7.4 ;5;6;5;0;5;0;5;4;1;5;0;0
8382; 25.1 ; 50.1 ; -   ;2;2;62;0;2;0;2;0;2;2;0;0
8383; 24.2 ; 217.5 ; 10.2 ;9;28;78;0;9;2;7;4;5;6;3;0
8384; 27.2 ; 135.9 ; 27.6 ;5;76;20;0;5;0;5;3;2;3;2;0
8385; 15.0 ; 30.0 ; -   ;2;44;239;0;2;2;0;0;2;2;0;0
8386; 49.9 ; 1,098.1 ; 15.3 ;22;12;10;0;22;15;7;7;15;0;15;7
8387; 65.9 ; 197.7 ; 25.9 ;3;17;101;0;3;2;1;2;1;0;0;3
8388; 33.7 ; 404.1 ; 12.1 ;12;20;2;0;12;2;10;4;8;4;8;0
8389; 16.7 ; 50.0 ; 3.1 ;3;17;353;0;3;3;0;1;2;3;0;0
8390; 29.7 ; 207.7 ; 21.4 ;7;22;131;0;7;4;3;1;6;5;2;0
8391; 26.0 ; 363.3 ; 14.0 ;14;14;46;0;14;7;7;7;7;9;5;0
8392; 49.5 ; 99.1 ; 26.9 ;2;3;56;2;0;1;1;2;0;1;0;1
8393; 48.9 ; 244.4 ; 3.2 ;5;72;5;0;5;1;4;5;0;0;5;0
8394; 32.3 ; 129.4 ; 20.4 ;4;11;241;0;4;2;2;3;1;1;3;0
8395; 44.6 ; 267.5 ; 35.4 ;6;32;74;0;6;4;2;3;3;2;2;2
8396; 38.5 ; 76.9 ; 12.4 ;2;32;143;0;2;0;2;2;0;1;1;0
8397; 36.6 ; 73.2 ; -   ;2;24;125;1;1;0;2;1;1;0;2;0
8398; 78.7 ; 157.4 ; 37.1 ;2;31;16;2;0;0;2;1;1;0;0;2
8399; 46.2 ; 138.7 ; 5.9 ;3;15;248;0;3;3;0;1;2;0;3;0
8400; 42.0 ; 83.9 ; 18.2 ;2;4;317;0;2;1;1;0;2;1;0;1
8401; 23.5 ; 94.0 ; 6.9 ;4;59;151;0;4;4;0;4;0;3;1;0
8402; 46.8 ; 233.9 ; 7.2 ;5;76;37;0;5;0;5;3;2;0;5;0
8403; 79.7 ; 2,472.2 ; 32.2 ;31;10;5;0;31;0;31;18;13;0;0;31
8404; 49.3 ; 98.7 ; -   ;2;6;41;0;2;0;2;1;1;0;2;0
8405; 57.4 ; 172.2 ; 7.0 ;3;52;11;0;3;1;2;2;1;0;0;3
8406; 67.4 ; 202.3 ; 27.4 ;3;54;278;0;3;0;3;3;0;0;0;3
8407; 28.6 ; 142.8 ; 9.4 ;5;5;205;0;5;0;5;3;2;3;2;0
8408; 47.5 ; 189.9 ; -   ;4;19;30;0;4;2;2;3;1;0;4;0
8409; 63.4 ; 317.0 ; 22.6 ;5;63;84;0;5;0;5;2;3;0;0;5
8410; 48.9 ; 97.8 ; 3.2 ;2;5;179;0;2;0;2;2;0;0;2;0
8411; 44.1 ; 220.7 ; 12.7 ;5;49;4;2;3;4;1;0;5;0;3;2
8412; 39.6 ; 198.1 ; 11.8 ;5;70;31;0;5;2;3;3;2;2;3;0
8413; 42.3 ; 508.2 ; 11.0 ;12;24;65;0;12;9;3;3;9;0;12;0
8414; 31.4 ; 157.2 ; 15.0 ;5;28;16;0;5;2;3;3;2;2;3;0
8415; 54.8 ; 219.2 ; 11.0 ;4;120;99;0;4;0;4;0;4;0;3;1
8416; 42.9 ; 171.6 ; 10.4 ;4;93;43;0;4;2;2;1;3;0;4;0
8417; 25.1 ; 50.1 ; -   ;2;293;127;0;2;0;2;2;0;2;0;0
8418; 26.5 ; 53.0 ; 2.1 ;2;27;166;0;2;1;1;2;0;2;0;0
8419; 25.1 ; 50.1 ; -   ;2;3;314;0;2;1;1;0;2;2;0;0
8420; 32.8 ; 131.2 ; 6.0 ;4;76;47;0;4;0;4;2;2;1;3;0
8421; 56.2 ; 224.9 ; 26.7 ;4;80;5;0;4;1;3;1;3;1;0;3
8422; 37.5 ; 150.0 ; 14.6 ;4;14;23;0;4;1;3;2;2;1;3;0
8423; 52.9 ; 158.7 ; 9.5 ;3;66;163;0;3;0;3;1;2;0;2;1
8424; 38.5 ; 76.9 ; 12.4 ;2;10;332;0;2;1;1;0;2;1;1;0
8425; 86.1 ; 258.2 ; 21.0 ;3;34;167;0;3;1;2;2;1;0;0;3
8426; 56.0 ; 168.0 ; 7.9 ;3;22;18;3;0;3;0;2;1;0;0;3
8427; 20.0 ; 40.1 ; 7.6 ;2;19;256;0;2;1;1;2;0;2;0;0
8428; 33.2 ; 66.4 ; -   ;2;45;5;0;2;0;2;1;1;0;2;0
8429; 45.2 ; 90.3 ; 3.5 ;2;274;53;0;2;1;1;0;2;0;2;0
8430; 36.5 ; 291.8 ; 11.0 ;8;19;58;0;8;2;6;6;2;3;5;0
8431; 46.4 ; 417.2 ; 28.6 ;9;39;43;0;9;0;9;6;3;3;3;3
8432; 63.5 ; 253.8 ; 28.3 ;4;54;116;0;4;0;4;4;0;0;0;4
8433; 46.4 ; 556.7 ; 32.1 ;12;27;5;0;12;3;9;12;0;4;4;4
8434; 32.3 ; 161.4 ; 16.9 ;5;71;68;0;5;1;4;2;3;2;3;0
8435; 44.1 ; 88.2 ; 11.2 ;2;24;41;0;2;0;2;2;0;0;1;1
8436; 53.1 ; 744.0 ; 13.0 ;14;23;9;0;14;10;4;5;9;0;9;5
8437; 46.1 ; 276.4 ; 30.3 ;6;36;8;0;6;1;5;4;2;2;2;2
8438; 22.6 ; 90.3 ; 9.3 ;4;87;51;0;4;3;1;2;2;3;1;0
8439; 95.4 ; 190.8 ; 26.9 ;2;70;188;0;2;0;2;2;0;0;0;2
8440; 52.9 ; 105.8 ; 0.5 ;2;76;99;0;2;0;2;2;0;0;2;0
8441; 19.0 ; 285.2 ; 5.5 ;15;15;18;1;14;11;4;15;0;15;0;0
8442; 47.2 ; 377.4 ; 21.4 ;8;35;8;0;8;0;8;7;1;3;2;3
8443; 23.8 ; 95.0 ; 8.7 ;4;42;203;0;4;2;2;2;2;3;1;0
8444; 38.1 ; 152.6 ; 20.1 ;4;30;141;0;4;1;3;1;3;1;2;1
8445; 49.1 ; 98.3 ; 18.8 ;2;62;11;0;2;0;2;1;1;0;1;1
8446; 64.6 ; 323.2 ; 22.7 ;5;27;95;0;5;1;4;5;0;0;0;5
8447; 26.8 ; 80.3 ; 3.1 ;3;32;89;3;0;0;3;1;2;3;0;0
8448; 25.1 ; 75.2 ; -   ;3;44;162;0;3;0;3;2;1;3;0;0
8449; 43.2 ; 86.4 ; 0.5 ;2;117;28;0;2;1;1;2;0;0;2;0
8450; 29.6 ; 296.2 ; 17.5 ;10;11;23;0;10;7;3;1;9;7;3;0
8451; 24.3 ; 72.8 ; 3.2 ;3;5;152;0;3;0;3;3;0;3;0;0
8452; 33.4 ; 433.8 ; 8.6 ;13;27;31;0;13;8;5;10;3;4;9;0
8453; 23.9 ; 597.6 ; 11.0 ;25;19;4;0;25;9;16;14;11;17;8;0
8454; 41.4 ; 413.5 ; 11.8 ;10;26;5;0;10;1;9;7;3;3;7;0
8455; 54.9 ; 109.7 ; 28.2 ;2;172;89;1;1;1;1;2;0;1;0;1
8456; 15.0 ; 30.0 ; -   ;2;26;99;0;2;0;2;0;2;2;0;0
8457; 42.0 ; 503.8 ; 10.3 ;12;22;36;0;12;0;12;8;4;0;12;0
8458; 47.9 ; 478.6 ; 23.7 ;10;17;131;0;10;1;9;6;4;3;4;3
8459; 25.7 ; 128.4 ; 13.4 ;5;61;8;0;5;3;2;0;5;3;2;0
8460; 29.6 ; 88.7 ; 18.3 ;3;15;293;0;3;0;3;1;2;2;1;0
8461; 69.6 ; 1,183.3 ; 51.8 ;17;8;5;0;17;5;12;9;8;6;0;11
8462; 93.9 ; 469.4 ; 19.7 ;5;31;173;0;5;0;5;4;1;0;0;5
8463; 46.5 ; 139.5 ; 15.1 ;3;33;128;0;3;2;1;0;3;0;2;1
8464; 58.8 ; 294.0 ; 29.3 ;5;74;5;0;5;1;4;5;0;2;0;3
8465; 22.0 ; 439.8 ; 7.8 ;20;21;23;0;20;2;18;9;11;20;0;0
8466; 41.3 ; 82.6 ; 24.3 ;2;5;169;0;2;0;2;0;2;1;0;1
8467; 48.5 ; 97.0 ; 1.6 ;2;50;99;0;2;0;2;2;0;0;2;0
8468; 44.4 ; 1,199.1 ; 28.8 ;27;12;26;0;27;0;27;5;22;9;9;9
8469; 37.8 ; 75.7 ; 17.6 ;2;7;115;0;2;0;2;1;1;1;0;1
8470; 16.7 ; 83.3 ; 4.4 ;5;22;26;3;2;2;3;1;4;5;0;0
8471; 15.0 ; 119.9 ; -   ;8;17;81;0;8;4;4;4;4;8;0;0
8472; 24.7 ; 49.4 ; 14.6 ;2;85;207;0;2;1;1;1;1;1;1;0
8473; 15.0 ; 119.9 ; -   ;8;41;5;0;8;0;8;3;5;8;0;0
8474; 29.9 ; 89.7 ; 5.1 ;3;5;180;0;3;1;2;0;3;2;1;0
8475; 44.7 ; 223.5 ; 5.8 ;5;112;7;0;5;1;4;5;0;0;5;0
8476; 15.0 ; 45.0 ; -   ;3;7;241;0;3;1;2;1;2;3;0;0
8477; 49.4 ; 197.7 ; 1.5 ;4;10;50;0;4;2;2;2;2;0;4;0
8478; 53.6 ; 160.9 ; 30.9 ;3;22;175;0;3;1;2;1;2;1;1;1
8479; 28.3 ; 113.3 ; 16.9 ;4;26;212;0;4;3;1;1;3;3;1;0
8480; 19.1 ; 114.6 ; 3.6 ;6;32;122;0;6;5;1;5;1;6;0;0
8481; 46.8 ; 93.5 ; -   ;2;11;238;0;2;1;1;2;0;0;2;0
8482; 57.3 ; 114.6 ; 20.1 ;2;231;22;1;1;0;2;1;1;0;0;2
8483; 44.4 ; 221.9 ; 8.5 ;5;6;26;0;5;1;4;3;2;0;5;0
8484; 45.4 ; 544.7 ; 21.9 ;12;14;10;0;12;2;10;7;5;4;4;4
8485; 34.5 ; 310.3 ; 22.1 ;9;41;5;0;9;2;7;9;0;3;3;3
8486; 20.0 ; 40.1 ; 7.6 ;2;12;288;0;2;1;1;2;0;2;0;0
8487; 34.4 ; 481.4 ; 16.5 ;14;21;35;0;14;6;8;3;11;5;9;0
8488; 41.9 ; 83.7 ; 7.9 ;2;131;116;0;2;0;2;0;2;0;2;0
8489; 43.3 ; 216.7 ; 18.1 ;5;34;83;2;3;1;4;5;0;2;1;2
8490; 39.3 ; 392.8 ; 19.5 ;10;24;57;0;10;0;10;7;3;3;4;3
8491; 48.3 ; 241.5 ; 15.9 ;5;49;167;0;5;3;2;1;4;0;3;2
8492; 26.2 ; 104.8 ; 1.1 ;4;66;21;0;4;1;3;2;2;4;0;0
8493; 36.9 ; 73.8 ; 0.4 ;2;27;256;0;2;1;1;0;2;0;2;0
8494; 19.7 ; 1,259.9 ; 8.5 ;64;6;5;0;64;30;34;37;27;64;0;0
8495; 39.6 ; 118.8 ; 8.8 ;3;35;3;0;3;2;1;2;1;0;3;0
8496; 35.6 ; 213.7 ; 19.6 ;6;33;14;0;6;5;1;3;3;2;2;2
8497; 30.2 ; 90.6 ; -   ;3;124;44;0;3;2;1;1;2;0;3;0
8498; 26.1 ; 130.7 ; 5.8 ;5;40;15;0;5;2;3;3;2;3;2;0
8499; 62.5 ; 124.9 ; 16.1 ;2;50;5;1;1;0;2;0;2;0;0;2
8500; 58.4 ; 292.2 ; 23.8 ;5;41;65;0;5;2;3;3;2;0;0;5
8501; 53.5 ; 321.2 ; 29.2 ;6;50;0;0;6;1;5;2;4;2;2;2
8502; 29.8 ; 89.5 ; 8.7 ;3;32;225;0;3;1;2;2;1;2;1;0
8503; 42.4 ; 254.2 ; 16.4 ;6;36;42;0;6;5;1;0;6;2;2;2
8504; 50.0 ; 150.1 ; 2.6 ;3;35;252;0;3;0;3;1;2;0;3;0
8505; 40.0 ; 120.0 ; 12.4 ;3;151;25;0;3;1;2;2;1;1;2;0
8506; 23.4 ; 70.2 ; 8.2 ;3;4;167;0;3;1;2;1;2;2;1;0
8507; 68.0 ; 612.3 ; 24.8 ;9;34;36;0;9;0;9;3;6;0;0;9
8508; 63.4 ; 126.9 ; 6.8 ;2;6;110;0;2;0;2;1;1;0;0;2
8509; 30.0 ; 119.9 ; 13.0 ;4;65;137;0;4;1;3;2;2;3;1;0
8510; 27.3 ; 300.0 ; 8.4 ;11;23;165;0;11;5;6;6;5;7;4;0
8511; 17.0 ; 51.0 ; 1.9 ;3;4;41;0;3;1;2;1;2;3;0;0
8512; 46.5 ; 325.8 ; 16.4 ;7;17;10;0;7;1;6;4;3;0;5;2
8513; 45.5 ; 318.7 ; 29.3 ;7;16;114;0;7;2;5;7;0;2;3;2
8514; 85.4 ; 170.9 ; 14.5 ;2;211;83;0;2;1;1;1;1;0;0;2
8515; 57.0 ; 285.0 ; 23.9 ;5;32;41;0;5;2;3;3;2;0;0;5
8516; 28.1 ; 308.7 ; 6.8 ;11;34;35;0;11;5;6;11;0;7;4;0
8517; 36.4 ; 145.7 ; 9.7 ;4;41;58;0;4;2;2;3;1;1;3;0
8518; 43.9 ; 219.3 ; 14.1 ;5;83;3;0;5;2;3;2;3;2;1;2
8519; 31.0 ; 186.2 ; 16.6 ;6;9;182;0;6;4;2;2;4;2;4;0
8520; 46.6 ; 93.2 ; 0.2 ;2;11;389;0;2;0;2;0;2;0;2;0
8521; 23.5 ; 329.6 ; 12.1 ;14;23;11;0;14;0;14;12;2;9;5;0
8522; 50.4 ; 100.7 ; 9.7 ;2;43;15;0;2;0;2;2;0;0;1;1
8523; 23.3 ; 373.5 ; 13.6 ;16;18;2;4;12;7;9;8;8;11;5;0
8524; 30.2 ; 60.4 ; 6.6 ;2;51;148;0;2;1;1;0;2;1;1;0
8525; 24.4 ; 48.8 ; 8.7 ;2;55;20;0;2;2;0;2;0;1;1;0
8526; 25.7 ; 77.2 ; 11.8 ;3;34;48;0;3;0;3;2;1;2;1;0
8527; 34.1 ; 102.4 ; 19.5 ;3;37;165;0;3;2;1;2;1;1;2;0
8528; 40.4 ; 283.0 ; 21.1 ;7;29;151;0;7;3;4;4;3;2;3;2
8529; 31.8 ; 158.9 ; 25.6 ;5;31;99;0;5;2;3;2;3;2;1;2
8530; 35.5 ; 71.0 ; 24.8 ;2;25;52;0;2;0;2;1;1;1;0;1
8531; 51.7 ; 310.3 ; 35.7 ;6;52;88;0;6;2;4;2;4;2;2;2
8532; 15.0 ; 30.0 ; -   ;2;9;40;0;2;1;1;2;0;2;0;0
8533; 21.7 ; 195.6 ; 10.0 ;9;32;32;0;9;2;7;3;6;6;3;0
8534; 59.0 ; 235.9 ; 25.4 ;4;42;47;2;2;1;3;2;2;0;0;4
8535; 52.5 ; 105.0 ; -   ;2;49;247;0;2;0;2;2;0;0;2;0
8536; 26.9 ; 80.7 ; 1.7 ;3;57;68;0;3;1;2;1;2;3;0;0
8537; 41.2 ; 82.5 ; 8.3 ;2;29;305;0;2;1;1;0;2;0;2;0
8538; 15.0 ; 30.0 ; -   ;2;38;142;0;2;0;2;0;2;2;0;0
8539; 21.5 ; 86.0 ; 8.3 ;4;149;0;0;4;0;4;3;1;4;0;0
8540; 54.6 ; 273.0 ; 25.1 ;5;19;194;0;5;0;5;5;0;2;1;2
8541; 18.0 ; 36.1 ; 4.6 ;2;37;87;0;2;2;0;0;2;2;0;0
8542; 24.7 ; 148.4 ; 10.5 ;6;46;41;0;6;3;3;4;2;4;2;0
8543; 37.2 ; 74.4 ; 23.6 ;2;24;252;0;2;0;2;1;1;1;0;1
8544; 62.5 ; 500.0 ; 39.2 ;8;23;242;0;8;4;4;5;3;3;0;5
8545; 45.7 ; 456.5 ; 24.2 ;10;40;16;0;10;1;9;8;2;3;4;3
8546; 84.8 ; 593.6 ; 24.5 ;7;34;68;0;7;1;6;5;2;0;0;7
8547; 54.3 ; 922.6 ; 12.7 ;17;17;16;0;17;0;17;16;1;0;11;6
8548; 15.0 ; 30.0 ; -   ;2;5;87;0;2;2;0;0;2;2;0;0
8549; 31.2 ; 62.4 ; -   ;2;75;16;2;0;0;2;0;2;0;2;0
8550; 45.7 ; 182.7 ; 7.1 ;4;41;53;0;4;0;4;4;0;0;4;0
8551; 46.2 ; 231.2 ; 9.9 ;5;32;40;0;5;1;4;4;1;0;3;2
8552; 62.2 ; 310.8 ; 35.9 ;5;9;200;0;5;1;4;3;2;2;0;3
8553; 53.5 ; 1,338.1 ; 34.1 ;25;9;11;0;25;13;12;8;17;8;9;8
8554; 32.8 ; 98.3 ; 7.0 ;3;26;116;0;3;2;1;1;2;1;2;0
8555; 31.6 ; 126.3 ; 5.4 ;4;78;78;0;4;2;2;2;2;1;3;0
8556; 16.4 ; 49.2 ; 2.6 ;3;63;32;0;3;1;2;2;1;3;0;0
8557; 26.4 ; 738.5 ; 10.5 ;28;13;37;0;28;12;16;16;12;19;9;0
8558; 18.7 ; 93.4 ; 5.9 ;5;50;39;0;5;2;3;3;2;5;0;0
8559; 59.6 ; 178.8 ; 21.2 ;3;88;95;0;3;2;1;2;1;0;0;3
8560; 21.4 ; 42.9 ; 5.4 ;2;2;209;0;2;1;1;0;2;2;0;0
8561; 63.0 ; 189.0 ; 9.1 ;3;13;78;0;3;0;3;3;0;0;0;3
8562; 24.4 ; 195.2 ; 11.9 ;8;39;5;0;8;0;8;7;1;5;3;0
8563; 25.1 ; 100.3 ; -   ;4;74;74;0;4;2;2;1;3;4;0;0
8564; 27.5 ; 659.1 ; 17.1 ;24;13;5;0;24;8;16;8;16;16;8;0
8565; 20.7 ; 165.9 ; 3.6 ;8;17;160;0;8;6;2;3;5;8;0;0
8566; 27.2 ; 136.1 ; 6.6 ;5;66;41;0;5;3;2;3;2;3;2;0
8567; 45.9 ; 91.8 ; 3.4 ;2;26;6;0;2;1;1;0;2;0;2;0
8568; 21.5 ; 42.9 ; 7.6 ;2;62;20;2;0;0;2;2;0;2;0;0
8569; 26.0 ; 78.1 ; 1.8 ;3;106;90;0;3;0;3;1;2;3;0;0
8570; 34.0 ; 339.9 ; 12.1 ;10;22;140;0;10;2;8;2;8;3;7;0
8571; 20.0 ; 40.1 ; -   ;2;8;242;0;2;1;1;0;2;2;0;0
8572; 48.5 ; 97.0 ; 17.8 ;2;22;242;0;2;1;1;2;0;0;1;1
8573; 87.5 ; 262.6 ; 32.1 ;3;45;110;0;3;0;3;2;1;0;0;3
8574; 37.1 ; 148.4 ; 16.4 ;4;97;32;1;3;1;3;4;0;1;3;0
8575; 63.6 ; 317.9 ; 15.7 ;5;34;33;0;5;3;2;3;2;0;0;5
8576; 45.8 ; 1,052.6 ; 8.5 ;23;17;16;0;23;4;19;9;14;0;23;0
8577; 33.7 ; 67.4 ; 5.2 ;2;4;36;0;2;1;1;2;0;1;1;0
8578; 43.7 ; 392.9 ; 7.9 ;9;37;11;0;9;0;9;2;7;0;9;0
8579; 51.4 ; 102.9 ; -   ;2;3;208;1;1;1;1;0;2;0;2;0
8580; 27.4 ; 273.7 ; 12.1 ;10;14;96;0;10;7;3;5;5;7;3;0
8581; 30.9 ; 649.6 ; 12.4 ;21;17;23;0;21;11;10;16;5;7;14;0
8582; 30.9 ; 61.7 ; 23.8 ;2;19;110;0;2;0;2;0;2;1;1;0
8583; 48.3 ; 386.5 ; 26.3 ;8;40;11;0;8;4;4;2;6;3;2;3
8584; 44.7 ; 134.1 ; 14.4 ;3;27;210;0;3;0;3;1;2;0;2;1
8585; 50.6 ; 101.2 ; 2.9 ;2;12;162;0;2;0;2;2;0;0;2;0
8586; 17.9 ; 35.8 ; 0.2 ;2;119;124;0;2;2;0;0;2;2;0;0
8587; 45.5 ; 181.9 ; 19.2 ;4;60;111;0;4;2;2;1;3;1;2;1
8588; 28.6 ; 457.4 ; 6.9 ;16;19;38;0;16;6;10;8;8;11;5;0
8589; 64.0 ; 319.8 ; 22.9 ;5;74;15;0;5;0;5;5;0;0;0;5
8590; 18.3 ; 55.0 ; 6.2 ;3;33;263;0;3;2;1;2;1;3;0;0
8591; 31.1 ; 778.4 ; 13.0 ;25;9;34;0;25;15;10;11;14;8;17;0
8592; 39.1 ; 195.7 ; 11.9 ;5;59;26;1;4;1;4;4;1;2;3;0
8593; 40.3 ; 80.6 ; 15.9 ;2;20;209;0;2;0;2;2;0;1;0;1
8594; 45.8 ; 458.5 ; 13.8 ;10;32;0;0;10;2;8;5;5;0;7;3
8595; 51.3 ; 256.3 ; 10.4 ;5;33;195;0;5;4;1;1;4;0;3;2
8596; 27.2 ; 54.4 ; 14.1 ;2;166;72;0;2;1;1;1;1;1;1;0
8597; 22.8 ; 45.5 ; 7.4 ;2;127;104;0;2;0;2;1;1;1;1;0
8598; 39.3 ; 78.5 ; 14.1 ;2;246;63;0;2;0;2;0;2;1;1;0
8599; 46.7 ; 420.0 ; 6.2 ;9;41;47;0;9;0;9;7;2;0;9;0
8600; 38.5 ; 76.9 ; 12.4 ;2;170;83;1;1;0;2;2;0;1;1;0
8601; 46.8 ; 187.0 ; -   ;4;10;275;0;4;3;1;4;0;0;4;0
8602; 91.9 ; 183.8 ; 72.4 ;2;156;42;1;1;1;1;2;0;1;0;1
8603; 27.6 ; 193.3 ; 5.6 ;7;32;5;0;7;0;7;7;0;5;2;0
8604; 48.6 ; 97.2 ; -   ;2;185;109;0;2;2;0;0;2;0;2;0
8605; 49.9 ; 199.6 ; 16.8 ;4;88;42;0;4;1;3;2;2;0;3;1
8606; 50.3 ; 151.0 ; 6.6 ;3;50;127;0;3;1;2;2;1;0;2;1
8607; 73.5 ; 146.9 ; 68.2 ;2;309;11;0;2;1;1;1;1;1;0;1
8608; 18.9 ; 56.8 ; 0.7 ;3;52;176;0;3;2;1;2;1;3;0;0
8609; 19.3 ; 77.3 ; 7.7 ;4;62;26;0;4;2;2;2;2;4;0;0
8610; 22.6 ; 67.9 ; 4.4 ;3;5;178;0;3;0;3;3;0;3;0;0
8611; 41.1 ; 164.5 ; 4.9 ;4;48;209;0;4;1;3;2;2;0;4;0
8612; 38.5 ; 385.1 ; 18.8 ;10;27;89;0;10;5;5;8;2;3;4;3
8613; 53.5 ; 107.0 ; 4.9 ;2;23;262;0;2;1;1;1;1;0;1;1
8614; 36.3 ; 72.5 ; 0.8 ;2;227;120;0;2;0;2;2;0;0;2;0
8615; 24.0 ; 48.0 ; 9.3 ;2;3;189;0;2;1;1;1;1;1;1;0
8616; 33.4 ; 367.6 ; 15.4 ;11;11;45;9;2;4;7;7;4;4;7;0
8617; 24.7 ; 296.6 ; 17.3 ;12;11;79;0;12;6;6;4;8;8;4;0
8618; 28.6 ; 114.2 ; 6.7 ;4;95;30;0;4;2;2;2;2;3;1;0
8619; 17.4 ; 34.9 ; 0.9 ;2;26;173;0;2;1;1;1;1;2;0;0
8620; 40.3 ; 201.7 ; 14.7 ;5;67;26;0;5;0;5;4;1;2;1;2
8621; 44.0 ; 220.0 ; 37.5 ;5;41;67;0;5;2;3;5;0;2;1;2
8622; 31.3 ; 156.3 ; 13.3 ;5;65;113;0;5;2;3;3;2;2;3;0
8623; 61.5 ; 123.0 ; -   ;2;69;137;0;2;0;2;2;0;0;0;2
8624; 50.0 ; 100.0 ; 4.9 ;2;189;99;1;1;0;2;1;1;0;2;0
8625; 37.7 ; 452.9 ; 11.8 ;12;27;44;0;12;7;5;2;10;4;8;0
8626; 25.1 ; 200.7 ; 17.5 ;8;23;41;0;8;2;6;2;6;5;3;0
8627; 42.6 ; 85.2 ; 3.1 ;2;178;78;0;2;1;1;1;1;0;2;0
8628; 26.4 ; 105.4 ; 2.7 ;4;101;41;0;4;1;3;2;2;4;0;0
8629; 46.8 ; 140.3 ; -   ;3;16;346;0;3;0;3;3;0;0;3;0
8630; 16.2 ; 81.0 ; 1.8 ;5;77;41;0;5;0;5;5;0;5;0;0
8631; 49.1 ; 98.3 ; 18.8 ;2;92;2;0;2;1;1;2;0;0;1;1
8632; 47.5 ; 94.9 ; -   ;2;13;57;2;0;0;2;1;1;0;2;0
8633; 41.5 ; 373.3 ; 11.8 ;9;29;128;0;9;6;3;4;5;3;6;0
8634; 36.3 ; 72.5 ; 16.8 ;2;23;100;0;2;0;2;2;0;1;1;0
8635; 51.0 ; 203.9 ; 7.7 ;4;15;121;0;4;1;3;3;1;0;3;1
8636; 33.9 ; 643.4 ; 14.8 ;19;16;14;0;19;17;2;4;15;6;13;0
8637; 42.4 ; 127.1 ; 13.6 ;3;88;104;0;3;1;2;2;1;1;1;1
8638; 53.0 ; 159.0 ; 0.4 ;3;85;53;0;3;0;3;3;0;0;3;0
8639; 53.1 ; 265.5 ; 26.6 ;5;20;53;0;5;0;5;4;1;2;1;2
8640; 59.8 ; 298.9 ; 24.1 ;5;45;101;0;5;0;5;3;2;0;0;5
8641; 43.0 ; 344.4 ; 8.3 ;8;13;122;0;8;3;5;4;4;0;8;0
8642; 36.1 ; 396.6 ; 29.0 ;11;41;23;0;11;2;9;6;5;4;3;4
8643; 15.0 ; 30.0 ; -   ;2;2;115;2;0;0;2;2;0;2;0;0
8644; 20.6 ; 144.5 ; 6.6 ;7;62;21;0;7;2;5;3;4;7;0;0
8645; 22.6 ; 135.5 ; 11.5 ;6;50;94;0;6;1;5;3;3;4;2;0
8646; 50.2 ; 100.4 ; 5.1 ;2;339;83;1;1;0;2;1;1;0;1;1
8647; 33.5 ; 167.5 ; 7.8 ;5;53;62;0;5;0;5;5;0;2;3;0
8648; 63.4 ; 253.6 ; 36.8 ;4;41;165;0;4;1;3;1;3;1;0;3
8649; 29.1 ; 87.3 ; 3.7 ;3;32;116;0;3;0;3;1;2;2;1;0
8650; 46.1 ; 92.3 ; 31.6 ;2;224;69;0;2;0;2;2;0;1;0;1
8651; 24.9 ; 199.2 ; 18.3 ;8;35;65;0;8;0;8;4;4;5;3;0
8652; 60.3 ; 120.7 ; 10.6 ;2;107;89;0;2;0;2;1;1;0;0;2
8653; 54.7 ; 218.8 ; 14.2 ;4;5;126;0;4;3;1;1;3;0;3;1
8654; 41.9 ; 125.6 ; 10.8 ;3;86;195;0;3;1;2;1;2;0;3;0
8655; 25.6 ; 127.9 ; 21.4 ;5;31;166;0;5;2;3;4;1;3;2;0
8656; 38.3 ; 114.8 ; 8.8 ;3;4;199;0;3;1;2;3;0;1;2;0
8657; 48.0 ; 383.9 ; 3.9 ;8;21;23;0;8;3;5;4;4;0;8;0
8658; 31.2 ; 62.5 ; 24.3 ;2;56;31;0;2;0;2;2;0;1;0;1
8659; 52.2 ; 156.6 ; 8.0 ;3;22;10;3;0;0;3;2;1;0;2;1
8660; 23.1 ; 69.4 ; 3.6 ;3;25;60;0;3;3;0;3;0;3;0;0
8661; 20.4 ; 244.7 ; 11.4 ;12;23;2;0;12;4;8;8;4;8;4;0
8662; 36.3 ; 218.1 ; 14.3 ;6;44;4;0;6;1;5;3;3;2;4;0
8663; 32.3 ; 64.5 ; 25.9 ;2;6;257;0;2;0;2;1;1;1;0;1
8664; 40.3 ; 524.3 ; 8.4 ;13;20;31;0;13;2;11;12;1;0;13;0
8665; 41.6 ; 207.8 ; 7.2 ;5;40;56;0;5;4;1;1;4;0;5;0
8666; 21.5 ; 64.5 ; 8.3 ;3;22;362;0;3;0;3;2;1;3;0;0
8667; 49.8 ; 199.2 ; 7.2 ;4;68;84;0;4;1;3;2;2;0;3;1
8668; 50.4 ; 1,009.0 ; 23.6 ;20;23;3;0;20;11;9;14;6;7;6;7
8669; 44.9 ; 269.3 ; 19.9 ;6;32;15;0;6;0;6;5;1;2;2;2
8670; 45.8 ; 91.6 ; 4.4 ;2;7;224;0;2;1;1;2;0;0;2;0
8671; 63.3 ; 189.8 ; 42.5 ;3;38;26;0;3;0;3;2;1;1;0;2
8672; 47.1 ; 188.6 ; 2.8 ;4;23;10;0;4;1;3;1;3;0;4;0
8673; 67.3 ; 605.4 ; 34.1 ;9;24;40;0;9;5;4;2;7;0;0;9
8674; 22.6 ; 90.5 ; 12.6 ;4;30;297;0;4;1;3;3;1;3;1;0
8675; 73.2 ; 365.8 ; 23.6 ;5;41;20;0;5;2;3;3;2;0;0;5
8676; 309.7 ; 619.4 ; 99.4 ;2;187;55;2;0;1;1;2;0;0;0;2
8677; 29.5 ; 147.5 ; 12.4 ;5;33;137;0;5;3;2;5;0;3;2;0
8678; 19.1 ; 38.3 ; 0.8 ;2;12;9;2;0;2;0;2;0;2;0;0
8679; 74.1 ; 222.2 ; 19.5 ;3;82;58;3;0;1;2;2;1;0;0;3
8680; 53.9 ; 107.8 ; 2.1 ;2;71;202;0;2;1;1;1;1;0;1;1
8681; 44.2 ; 265.4 ; 7.4 ;6;31;41;4;2;4;2;2;4;0;6;0
8682; 57.3 ; 114.6 ; 21.6 ;2;18;130;2;0;2;0;0;2;0;0;2
8683; 53.2 ; 159.6 ; 31.2 ;3;89;84;0;3;1;2;2;1;1;1;1
8684; 16.8 ; 168.2 ; 4.3 ;10;23;15;0;10;3;7;2;8;10;0;0
8685; 47.1 ; 282.5 ; 15.0 ;6;19;2;0;6;4;2;6;0;0;4;2
8686; 25.0 ; 174.8 ; 9.5 ;7;39;45;0;7;5;2;0;7;5;2;0
8687; 55.7 ; 334.5 ; 20.3 ;6;41;29;0;6;2;4;5;1;0;0;6
8688; 33.4 ; 100.2 ; 6.3 ;3;1;122;0;3;3;0;1;2;1;2;0
8689; 38.5 ; 76.9 ; 12.4 ;2;19;139;2;0;2;0;2;0;1;1;0
8690; 49.9 ; 149.8 ; 2.4 ;3;41;122;3;0;1;2;1;2;0;3;0
8691; 18.0 ; 36.0 ; -   ;2;16;61;2;0;2;0;0;2;2;0;0
8692; 71.7 ; 143.4 ; 2.4 ;2;27;243;0;2;2;0;2;0;0;0;2
8693; 19.5 ; 117.1 ; 8.9 ;6;34;2;0;6;3;3;1;5;6;0;0
8694; 19.4 ; 58.3 ; 1.1 ;3;34;0;1;2;1;2;1;2;3;0;0
8695; 35.5 ; 2,558.2 ; 12.8 ;72;6;4;0;72;30;42;24;48;24;48;0
8696; 91.9 ; 459.3 ; 91.3 ;5;33;99;0;5;1;4;2;3;2;0;3
8697; 25.1 ; 50.1 ; -   ;2;96;38;0;2;2;0;0;2;2;0;0
8698; 20.0 ; 40.1 ; 7.6 ;2;246;76;0;2;2;0;1;1;2;0;0
8699; 20.3 ; 183.0 ; 9.9 ;9;8;178;0;9;6;3;5;4;6;3;0
8700; 38.8 ; 77.7 ; 12.9 ;2;29;41;0;2;2;0;0;2;1;1;0
8701; 25.8 ; 206.5 ; 19.2 ;8;11;2;0;8;1;7;6;2;5;3;0
8702; 35.8 ; 465.5 ; 18.1 ;13;20;65;0;13;5;8;9;4;4;9;0
8703; 75.0 ; 150.0 ; 11.2 ;2;50;225;0;2;0;2;2;0;0;0;2
8704; 46.3 ; 92.6 ; 13.6 ;2;88;15;0;2;0;2;1;1;0;1;1
8705; 35.3 ; 176.6 ; 19.7 ;5;13;30;5;0;4;1;1;4;2;1;2
8706; 43.7 ; 218.5 ; 11.1 ;5;19;11;0;5;1;4;3;2;0;5;0
8707; 28.9 ; 86.6 ; 8.5 ;3;68;14;0;3;3;0;2;1;2;1;0
8708; 36.3 ; 72.5 ; 26.9 ;2;7;137;0;2;1;1;1;1;1;0;1
8709; 18.5 ; 870.9 ; 5.4 ;47;5;5;0;47;24;23;25;22;47;0;0
8710; 57.0 ; 114.0 ; 6.7 ;2;56;242;0;2;0;2;1;1;0;0;2
8711; 22.9 ; 2,629.5 ; 5.2 ;115;4;5;0;115;43;72;13;102;115;0;0
8712; 40.3 ; 322.8 ; 23.2 ;8;34;32;0;8;0;8;2;6;3;2;3
8713; 57.3 ; 286.5 ; 46.9 ;5;58;20;0;5;3;2;4;1;2;0;3
8714; 48.6 ; 728.5 ; 43.0 ;15;11;1;0;15;3;12;13;2;5;5;5
8715; 55.6 ; 111.1 ; 8.2 ;2;89;24;0;2;1;1;0;2;0;0;2
8716; 15.0 ; 30.0 ; -   ;2;6;101;0;2;0;2;2;0;2;0;0
8717; 46.9 ; 609.2 ; 5.3 ;13;23;5;0;13;0;13;10;3;0;13;0
8718; 36.3 ; 72.5 ; 16.8 ;2;31;78;0;2;0;2;2;0;1;1;0
8719; 32.5 ; 195.0 ; 16.0 ;6;57;42;0;6;1;5;3;3;2;4;0
8720; 89.3 ; 446.6 ; 36.7 ;5;63;8;3;2;3;2;2;3;0;0;5
8721; 57.7 ; 115.5 ; 6.7 ;2;62;41;0;2;0;2;2;0;0;0;2
8722; 56.5 ; 791.2 ; 21.0 ;14;13;11;0;14;4;10;7;7;0;0;14
8723; 36.4 ; 109.2 ; 19.6 ;3;115;85;0;3;1;2;2;1;1;1;1
8724; 23.9 ; 47.8 ; -   ;2;4;171;0;2;1;1;2;0;2;0;0
8725; 37.8 ; 416.2 ; 15.0 ;11;10;11;0;11;2;9;8;3;4;7;0
8726; 116.3 ; 232.5 ; 8.3 ;2;8;62;0;2;0;2;1;1;0;0;2
8727; 28.9 ; 115.5 ; 13.0 ;4;46;175;0;4;3;1;3;1;3;1;0
8728; 32.3 ; 64.5 ; 25.9 ;2;107;104;2;0;0;2;1;1;1;0;1
8729; 44.5 ; 178.2 ; 12.2 ;4;104;130;0;4;1;3;2;2;0;3;1
8730; 59.8 ; 119.6 ; 8.8 ;2;6;146;0;2;0;2;1;1;0;0;2
8731; 26.9 ; 188.0 ; 16.6 ;7;30;89;0;7;2;5;1;6;5;2;0
8732; 26.7 ; 427.4 ; 9.4 ;16;12;17;1;15;10;6;5;11;11;5;0
8733; 15.0 ; 30.0 ; -   ;2;9;10;2;0;1;1;1;1;2;0;0
8734; 30.5 ; 61.1 ; 0.5 ;2;147;24;0;2;1;1;1;1;0;2;0
8735; 43.8 ; 219.2 ; 20.0 ;5;31;132;0;5;0;5;5;0;2;1;2
8736; 50.4 ; 151.3 ; 26.3 ;3;133;19;0;3;2;1;3;0;1;1;1
8737; 43.1 ; 603.9 ; 9.7 ;14;24;11;0;14;3;11;5;9;0;14;0
8738; 76.7 ; 153.4 ; 11.2 ;2;18;247;0;2;0;2;0;2;0;0;2
8739; 25.6 ; 408.8 ; 13.6 ;16;23;1;0;16;8;8;13;3;11;5;0
8740; 47.7 ; 95.4 ; 1.4 ;2;43;274;0;2;0;2;2;0;0;2;0
8741; 65.2 ; 260.6 ; 12.5 ;4;95;5;0;4;3;1;2;2;0;0;4
8742; 15.4 ; 30.8 ; -   ;2;100;216;0;2;0;2;1;1;2;0;0
8743; 55.0 ; 385.2 ; 28.0 ;7;35;93;0;7;2;5;6;1;2;0;5
8744; 44.6 ; 89.1 ; 11.9 ;2;34;266;0;2;2;0;2;0;0;1;1
8745; 15.0 ; 30.0 ; -   ;2;17;12;0;2;1;1;1;1;2;0;0
8746; 48.8 ; 97.5 ; 10.9 ;2;194;31;0;2;0;2;2;0;0;1;1
8747; 30.2 ; 60.4 ; -   ;2;68;126;0;2;0;2;2;0;0;2;0
8748; 27.8 ; 83.3 ; 12.9 ;3;70;36;0;3;0;3;0;3;2;1;0
8749; 24.9 ; 99.7 ; 5.8 ;4;12;252;0;4;1;3;3;1;3;1;0
8750; 43.9 ; 219.6 ; 17.3 ;5;32;155;0;5;2;3;4;1;2;1;2
8751; 52.0 ; 156.0 ; 8.9 ;3;71;71;3;0;2;1;1;2;0;2;1
8752; 93.6 ; 280.7 ; 58.7 ;3;44;246;0;3;1;2;2;1;0;0;3
8753; 42.2 ; 421.9 ; 18.7 ;10;30;5;0;10;0;10;10;0;3;4;3
8754; 47.4 ; 142.2 ; 1.2 ;3;67;110;0;3;0;3;3;0;0;3;0
8755; 15.0 ; 30.0 ; -   ;2;56;304;0;2;0;2;2;0;2;0;0
8756; 95.7 ; 2,200.2 ; 33.5 ;23;12;5;0;23;0;23;23;0;0;0;23
8757; 21.7 ; 65.1 ; 6.2 ;3;183;73;0;3;0;3;3;0;3;0;0
8758; 43.7 ; 87.4 ; 4.6 ;2;29;160;2;0;1;1;1;1;0;2;0
8759; 77.8 ; 155.7 ; 37.9 ;2;101;212;0;2;2;0;0;2;0;0;2
8760; 67.9 ; 475.2 ; 22.6 ;7;34;93;0;7;1;6;6;1;0;0;7
8761; 27.2 ; 54.3 ; 18.2 ;2;7;78;0;2;0;2;1;1;1;1;0
8762; 16.9 ; 84.7 ; 1.2 ;5;49;13;4;1;3;2;2;3;5;0;0
8763; 50.2 ; 251.1 ; 16.4 ;5;68;41;0;5;2;3;3;2;0;3;2
8764; 28.1 ; 56.3 ; 12.7 ;2;3;267;0;2;1;1;1;1;1;1;0
8765; 24.3 ; 48.6 ; 13.9 ;2;204;14;0;2;1;1;0;2;1;1;0
8766; 39.4 ; 78.8 ; 13.8 ;2;149;83;0;2;1;1;1;1;1;1;0
8767; 38.3 ; 76.6 ; 12.1 ;2;112;5;1;1;0;2;1;1;1;1;0
8768; 56.6 ; 396.4 ; 20.0 ;7;29;36;5;2;5;2;4;3;0;0;7
8769; 47.9 ; 574.3 ; 24.4 ;12;21;134;0;12;3;9;10;2;4;4;4
8770; 41.9 ; 125.7 ; 9.7 ;3;100;158;0;3;0;3;2;1;0;3;0
8771; 46.8 ; 187.0 ; -   ;4;54;173;0;4;0;4;2;2;0;4;0
8772; 36.5 ; 182.3 ; 11.4 ;5;54;52;0;5;0;5;4;1;2;3;0
8773; 25.5 ; 51.1 ; 6.6 ;2;85;49;0;2;2;0;0;2;1;1;0
8774; 19.5 ; 488.5 ; 7.5 ;25;10;3;0;25;8;17;18;7;25;0;0
8775; 27.4 ; 54.9 ; 1.0 ;2;1;77;0;2;1;1;0;2;2;0;0
8776; 15.0 ; 30.0 ; -   ;2;25;299;0;2;0;2;2;0;2;0;0
8777; 55.2 ; 386.1 ; 16.1 ;7;23;47;0;7;2;5;4;3;0;0;7
8778; 31.9 ; 159.4 ; 2.5 ;5;41;45;0;5;2;3;1;4;2;3;0
8779; 56.6 ; 283.1 ; 13.1 ;5;20;16;0;5;0;5;3;2;0;0;5
8780; 39.5 ; 118.6 ; 19.4 ;3;18;75;1;2;1;2;2;1;1;1;1
8781; 47.7 ; 429.0 ; 22.3 ;9;20;219;0;9;3;6;9;0;3;3;3
8782; 68.5 ; 205.5 ; 40.6 ;3;121;179;0;3;1;2;1;2;1;0;2
8783; 48.8 ; 292.5 ; 2.1 ;6;38;1;0;6;2;4;1;5;0;6;0
8784; 65.4 ; 1,112.2 ; 19.6 ;17;21;26;0;17;0;17;10;7;0;0;17
8785; 47.1 ; 94.2 ; 0.5 ;2;118;95;0;2;0;2;2;0;0;2;0
8786; 44.9 ; 224.3 ; 22.0 ;5;29;179;0;5;3;2;1;4;2;1;2
8787; 25.1 ; 50.1 ; -   ;2;5;255;0;2;2;0;0;2;2;0;0
8788; 40.2 ; 80.5 ; 16.6 ;2;26;242;0;2;1;1;2;0;1;0;1
8789; 55.1 ; 496.3 ; 17.1 ;9;27;5;0;9;0;9;6;3;0;0;9
8790; 93.9 ; 1,783.8 ; 33.8 ;19;12;50;0;19;4;15;15;4;0;0;19
8791; 67.2 ; 537.3 ; 26.7 ;8;23;47;0;8;0;8;6;2;0;0;8
8792; 18.4 ; 110.4 ; 5.9 ;6;44;67;0;6;3;3;4;2;6;0;0
8793; 50.3 ; 100.6 ; 5.3 ;2;6;194;0;2;0;2;2;0;0;1;1
8794; 18.8 ; 93.9 ; 4.4 ;5;36;80;0;5;1;4;4;1;5;0;0
8795; 36.6 ; 73.2 ; -   ;2;36;253;0;2;0;2;2;0;0;2;0
8796; 21.7 ; 455.5 ; 7.0 ;21;12;59;0;21;16;5;19;2;21;0;0
8797; 45.1 ; 270.9 ; 2.1 ;6;29;0;0;6;1;5;2;4;0;6;0
8798; 32.8 ; 1,574.9 ; 65.2 ;48;5;1;48;0;31;17;48;0;16;16;16
8799; 52.6 ; 210.4 ; 28.1 ;4;59;37;0;4;0;4;2;2;1;2;1
8800; 58.6 ; 175.8 ; 20.0 ;3;64;241;0;3;0;3;1;2;0;0;3
8801; 26.3 ; 131.5 ; 2.9 ;5;32;28;0;5;5;0;2;3;5;0;0
8802; 62.1 ; 124.2 ; 0.5 ;2;45;99;0;2;0;2;0;2;0;0;2
8803; 25.9 ; 285.1 ; 6.8 ;11;22;70;0;11;7;4;4;7;7;4;0
8804; 38.8 ; 77.6 ; 20.5 ;2;117;173;0;2;1;1;2;0;1;0;1
8805; 16.7 ; 383.8 ; 4.7 ;23;16;10;0;23;6;17;17;6;23;0;0
8806; 117.2 ; 234.4 ; 27.0 ;2;238;69;0;2;0;2;1;1;0;0;2
8807; 49.6 ; 99.3 ; 4.3 ;2;12;299;0;2;0;2;1;1;0;2;0
8808; 55.3 ; 165.8 ; 41.3 ;3;85;131;0;3;1;2;3;0;1;0;2
8809; 92.2 ; 184.3 ; 10.3 ;2;37;37;0;2;0;2;0;2;0;0;2
8810; 21.7 ; 65.1 ; 6.2 ;3;36;41;1;2;1;2;3;0;3;0;0
8811; 46.5 ; 232.3 ; 5.3 ;5;33;3;0;5;0;5;5;0;0;5;0
8812; 31.1 ; 62.2 ; 1.6 ;2;170;121;0;2;0;2;1;1;1;1;0
8813; 25.1 ; 75.2 ; -   ;3;13;129;0;3;3;0;0;3;3;0;0
8814; 42.0 ; 797.6 ; 8.0 ;19;10;4;19;0;13;6;5;14;0;19;0
8815; 52.0 ; 416.2 ; 3.0 ;8;18;40;0;8;1;7;8;0;0;8;0
8816; 27.8 ; 388.8 ; 6.8 ;14;19;2;0;14;9;5;2;12;9;5;0
8817; 19.9 ; 79.6 ; 7.5 ;4;13;314;0;4;0;4;4;0;4;0;0
8818; 17.7 ; 35.4 ; 4.0 ;2;165;130;0;2;1;1;1;1;2;0;0
8819; 35.8 ; 71.6 ; 14.5 ;2;25;245;0;2;2;0;2;0;1;1;0
8820; 52.5 ; 105.0 ; -   ;2;8;380;0;2;2;0;0;2;0;2;0
8821; 40.5 ; 364.1 ; 14.0 ;9;49;20;0;9;3;6;5;4;3;6;0
8822; 39.2 ; 430.8 ; 29.1 ;11;19;10;0;11;5;6;2;9;4;3;4
8823; 58.8 ; 353.0 ; 14.3 ;6;41;69;0;6;1;5;3;3;0;0;6
8824; 45.4 ; 136.3 ; 25.3 ;3;151;43;0;3;2;1;1;2;1;1;1
8825; 18.0 ; 90.1 ; 6.4 ;5;25;5;0;5;0;5;4;1;5;0;0
8826; 44.3 ; 310.2 ; 11.2 ;7;26;5;0;7;0;7;6;1;0;5;2
8827; 17.5 ; 157.2 ; 3.7 ;9;13;11;0;9;0;9;5;4;9;0;0
8828; 62.4 ; 1,061.4 ; 28.9 ;17;16;31;0;17;7;10;6;11;0;0;17
8829; 41.7 ; 83.4 ; 17.3 ;2;5;23;0;2;2;0;2;0;1;0;1
8830; 27.4 ; 136.8 ; 12.8 ;5;83;41;0;5;0;5;2;3;3;2;0
8831; 72.7 ; 218.2 ; 34.7 ;3;233;9;0;3;2;1;3;0;0;0;3
8832; 50.1 ; 100.3 ; 2.2 ;2;23;273;0;2;0;2;1;1;0;2;0
8833; 69.9 ; 209.7 ; 33.8 ;3;68;63;0;3;0;3;3;0;0;0;3
8834; 68.7 ; 137.4 ; 21.1 ;2;302;99;0;2;0;2;2;0;0;0;2
8835; 36.6 ; 109.8 ; -   ;3;137;76;0;3;2;1;3;0;0;3;0
8836; 37.3 ; 186.3 ; 13.9 ;5;10;302;0;5;2;3;2;3;2;3;0
8837; 22.5 ; 44.9 ; 11.2 ;2;15;170;0;2;1;1;1;1;1;1;0
8838; 73.9 ; 961.1 ; 19.7 ;13;8;0;13;0;0;13;13;0;0;0;13
8839; 45.3 ; 543.7 ; 8.9 ;12;37;7;0;12;6;6;2;10;0;12;0
8840; 36.7 ; 146.9 ; 10.2 ;4;36;178;0;4;1;3;2;2;1;3;0
8841; 54.1 ; 270.4 ; 1.7 ;5;82;5;0;5;0;5;5;0;0;3;2
8842; 33.3 ; 666.7 ; 5.0 ;20;16;0;0;20;0;20;11;9;7;13;0
8843; 60.7 ; 182.0 ; 23.9 ;3;43;169;0;3;0;3;2;1;0;0;3
8844; 17.3 ; 103.6 ; 0.4 ;6;41;106;3;3;3;3;5;1;6;0;0
8845; 62.3 ; 809.6 ; 27.8 ;13;25;26;0;13;0;13;12;1;0;0;13
8846; 22.5 ; 90.0 ; 14.4 ;4;16;257;0;4;1;3;1;3;3;1;0
8847; 29.2 ; 58.4 ; 4.6 ;2;166;59;0;2;2;0;0;2;1;1;0
8848; 47.8 ; 143.5 ; 3.4 ;3;12;242;0;3;0;3;2;1;0;3;0
8849; 43.5 ; 87.0 ; 27.6 ;2;16;91;0;2;1;1;2;0;1;0;1
8850; 50.7 ; 101.4 ; 3.7 ;2;7;17;0;2;2;0;2;0;0;2;0
8851; 59.0 ; 294.9 ; 35.1 ;5;22;199;0;5;1;4;3;2;2;0;3
8852; 25.6 ; 281.6 ; 8.7 ;11;18;3;0;11;8;3;6;5;7;4;0
8853; 31.6 ; 378.7 ; 12.1 ;12;26;32;0;12;5;7;6;6;4;8;0
8854; 70.2 ; 912.3 ; 26.7 ;13;25;40;0;13;5;8;7;6;0;0;13
8855; 65.3 ; 391.8 ; 49.8 ;6;44;46;0;6;2;4;2;4;2;0;4
8856; 42.3 ; 211.6 ; 7.5 ;5;38;211;0;5;4;1;2;3;0;5;0
8857; 22.4 ; 44.7 ; 4.0 ;2;36;232;0;2;0;2;2;0;2;0;0
8858; 65.0 ; 130.0 ; 23.5 ;2;24;36;2;0;0;2;2;0;0;0;2
8859; 65.6 ; 393.9 ; 34.0 ;6;36;189;0;6;0;6;5;1;0;0;6
8860; 20.4 ; 61.2 ; 2.4 ;3;34;25;0;3;3;0;3;0;3;0;0
8861; 42.5 ; 467.1 ; 29.0 ;11;10;13;0;11;9;2;7;4;4;3;4
8862; 68.1 ; 272.4 ; 72.4 ;4;52;12;0;4;1;3;1;3;1;0;3
8863; 30.5 ; 578.8 ; 9.2 ;19;11;16;0;19;10;9;8;11;6;13;0
8864; 40.3 ; 281.9 ; 18.3 ;7;54;3;7;0;3;4;3;4;2;3;2
8865; 69.6 ; 139.2 ; 23.6 ;2;86;152;0;2;1;1;2;0;0;0;2
8866; 79.7 ; 159.4 ; 27.0 ;2;37;110;0;2;0;2;1;1;0;0;2
8867; 19.7 ; 157.7 ; 5.0 ;8;6;97;0;8;4;4;2;6;8;0;0
8868; 39.0 ; 194.8 ; 19.7 ;5;20;278;0;5;2;3;1;4;2;1;2
8869; 53.8 ; 430.2 ; 35.2 ;8;39;20;0;8;2;6;6;2;3;2;3
8870; 41.4 ; 124.2 ; 8.8 ;3;41;162;0;3;0;3;1;2;0;3;0
8871; 47.5 ; 94.9 ; -   ;2;13;36;0;2;0;2;2;0;0;2;0
8872; 70.8 ; 141.7 ; 36.1 ;2;111;69;0;2;0;2;1;1;0;0;2
8873; 24.5 ; 489.6 ; 2.7 ;20;14;0;0;20;5;15;17;3;20;0;0
8874; 64.0 ; 192.0 ; 29.7 ;3;16;10;0;3;0;3;2;1;0;0;3
8875; 47.4 ; 331.8 ; 1.1 ;7;37;78;0;7;2;5;3;4;0;7;0
8876; 36.9 ; 73.8 ; 17.7 ;2;26;178;0;2;0;2;1;1;1;1;0
8877; 42.0 ; 168.0 ; 21.3 ;4;6;264;0;4;1;3;2;2;1;2;1
8878; 29.0 ; 57.9 ; 13.9 ;2;14;283;0;2;0;2;1;1;1;1;0
8879; 15.5 ; 62.1 ; 1.1 ;4;112;102;0;4;4;0;0;4;4;0;0
8880; 40.6 ; 81.2 ; 15.6 ;2;24;356;0;2;0;2;1;1;1;0;1
8881; 36.7 ; 404.2 ; 13.6 ;11;28;8;0;11;4;7;1;10;4;7;0
8882; 25.1 ; 50.1 ; -   ;2;32;263;0;2;1;1;1;1;2;0;0
8883; 55.2 ; 110.4 ; 9.8 ;2;16;130;0;2;2;0;0;2;0;0;2
8884; 16.7 ; 83.3 ; 4.4 ;5;42;125;0;5;4;1;4;1;5;0;0
8885; 57.8 ; 635.3 ; 18.6 ;11;28;82;0;11;6;5;9;2;0;0;11
8886; 36.0 ; 180.2 ; 17.7 ;5;59;0;0;5;2;3;1;4;2;3;0
8887; 36.8 ; 73.7 ; 17.6 ;2;73;67;2;0;2;0;1;1;1;1;0
8888; 44.6 ; 89.1 ; 11.9 ;2;141;97;0;2;1;1;1;1;0;1;1
8889; 37.5 ; 187.3 ; 15.6 ;5;71;25;3;2;1;4;4;1;2;3;0
8890; 17.2 ; 51.6 ; 2.7 ;3;10;248;0;3;1;2;3;0;3;0;0
8891; 27.3 ; 109.1 ; 15.0 ;4;16;26;0;4;0;4;4;0;3;1;0
8892; 19.7 ; 39.3 ; -   ;2;22;254;0;2;1;1;0;2;2;0;0
8893; 26.5 ; 185.3 ; 7.5 ;7;55;4;0;7;5;2;2;5;5;2;0
8894; 53.6 ; 107.3 ; 12.2 ;2;2;398;0;2;0;2;2;0;0;1;1
8895; 32.0 ; 64.0 ; 18.5 ;2;26;178;2;0;0;2;2;0;1;1;0
8896; 25.8 ; 51.6 ; 16.2 ;2;189;31;0;2;0;2;1;1;1;1;0
8897; 53.7 ; 107.5 ; 8.3 ;2;24;0;0;2;0;2;0;2;0;1;1
8898; 40.3 ; 201.6 ; 7.2 ;5;31;75;0;5;2;3;4;1;0;5;0
8899; 48.2 ; 289.5 ; 9.9 ;6;64;4;0;6;1;5;4;2;0;4;2
8900; 63.7 ; 446.1 ; 8.4 ;7;16;26;0;7;0;7;6;1;0;0;7
8901; 15.0 ; 59.9 ; -   ;4;23;131;0;4;0;4;4;0;4;0;0
8902; 138.6 ; 277.2 ; 53.3 ;2;76;141;0;2;0;2;0;2;0;0;2
8903; 26.6 ; 292.4 ; 7.5 ;11;18;114;0;11;9;2;10;1;7;4;0
8904; 46.8 ; 374.5 ; 29.0 ;8;24;17;0;8;6;2;7;1;3;2;3
8905; 41.7 ; 125.1 ; 10.6 ;3;106;32;2;1;0;3;1;2;0;3;0
8906; 52.6 ; 157.8 ; 8.8 ;3;41;17;0;3;0;3;0;3;0;2;1
8907; 43.0 ; 1,420.5 ; 19.0 ;33;10;5;0;33;12;21;30;3;11;11;11
8908; 90.2 ; 180.4 ; 11.2 ;2;14;161;0;2;1;1;1;1;0;0;2
8909; 20.4 ; 142.7 ; 2.0 ;7;16;179;0;7;3;4;6;1;7;0;0
8910; 23.1 ; 415.4 ; 5.1 ;18;17;4;0;18;3;15;5;13;18;0;0
8911; 19.2 ; 249.1 ; 8.5 ;13;22;51;5;8;11;2;4;9;13;0;0
8912; 48.7 ; 194.9 ; 29.6 ;4;86;11;0;4;0;4;4;0;1;2;1
8913; 78.9 ; 157.9 ; 33.2 ;2;55;116;0;2;0;2;2;0;0;0;2
8914; 43.8 ; 131.5 ; 18.0 ;3;10;15;3;0;0;3;1;2;1;1;1
8915; 23.0 ; 183.9 ; 10.8 ;8;40;1;0;8;2;6;7;1;5;3;0
8916; 18.6 ; 37.2 ; -   ;2;29;2;0;2;1;1;0;2;2;0;0
8917; 102.0 ; 306.1 ; 16.0 ;3;44;51;0;3;2;1;3;0;0;0;3
8918; 18.0 ; 143.8 ; 2.5 ;8;36;53;0;8;1;7;6;2;8;0;0
8919; 36.6 ; 183.0 ; -   ;5;42;127;0;5;1;4;2;3;0;5;0
8920; 58.2 ; 116.4 ; 0.5 ;2;239;57;0;2;0;2;2;0;0;0;2
8921; 71.2 ; 284.9 ; 25.6 ;4;52;68;0;4;0;4;3;1;0;0;4
8922; 47.7 ; 95.4 ; 1.4 ;2;31;154;2;0;1;1;0;2;0;2;0
8923; 23.1 ; 115.6 ; 9.9 ;5;23;86;0;5;4;1;4;1;3;2;0
8924; 86.7 ; 433.7 ; 26.0 ;5;53;5;0;5;0;5;4;1;0;0;5
8925; 58.7 ; 293.4 ; 20.6 ;5;32;112;0;5;3;2;2;3;0;0;5
8926; 30.7 ; 122.8 ; 6.3 ;4;6;142;0;4;1;3;0;4;1;3;0
8927; 16.4 ; 131.0 ; 2.2 ;8;17;251;0;8;3;5;5;3;8;0;0
8928; 46.2 ; 554.5 ; 16.7 ;12;18;73;0;12;2;10;4;8;4;4;4
8929; 15.0 ; 45.0 ; -   ;3;29;7;0;3;3;0;3;0;3;0;0
8930; 18.6 ; 37.2 ; -   ;2;2;259;0;2;2;0;2;0;2;0;0
8931; 49.0 ; 196.1 ; 15.6 ;4;90;12;0;4;1;3;3;1;0;3;1
8932; 90.8 ; 272.3 ; 61.4 ;3;110;83;0;3;0;3;2;1;1;0;2
8933; 64.7 ; 129.5 ; 26.9 ;2;25;110;2;0;0;2;2;0;0;0;2
8934; 22.1 ; 309.6 ; 5.7 ;14;22;16;0;14;8;6;8;6;14;0;0
8935; 20.0 ; 100.2 ; 7.6 ;5;24;270;0;5;2;3;1;4;5;0;0
8936; 27.3 ; 81.9 ; 10.6 ;3;9;22;1;2;1;2;2;1;2;1;0
8937; 34.9 ; 69.9 ; 7.1 ;2;93;93;0;2;2;0;0;2;1;1;0
8938; 58.3 ; 175.0 ; 30.0 ;3;136;38;0;3;3;0;0;3;1;0;2
8939; 20.0 ; 40.1 ; 7.6 ;2;144;87;2;0;2;0;2;0;2;0;0
8940; 30.0 ; 59.9 ; -   ;2;120;12;2;0;2;0;2;0;2;0;0
8941; 66.0 ; 132.0 ; 5.3 ;2;92;86;0;2;1;1;0;2;0;0;2
8942; 42.7 ; 213.7 ; 17.8 ;5;21;73;0;5;0;5;2;3;2;1;2
8943; 33.0 ; 197.9 ; 19.6 ;6;26;32;0;6;2;4;3;3;2;4;0
8944; 19.1 ; 57.2 ; 5.6 ;3;161;41;0;3;0;3;2;1;3;0;0
8945; 40.3 ; 523.8 ; 20.2 ;13;23;41;0;13;10;3;13;0;4;5;4
8946; 49.7 ; 248.5 ; 7.3 ;5;40;29;0;5;0;5;4;1;0;3;2
8947; 43.7 ; 262.0 ; 10.3 ;6;41;15;0;6;1;5;4;2;0;6;0
8948; 22.6 ; 45.2 ; 11.4 ;2;5;104;2;0;2;0;1;1;1;1;0
8949; 50.8 ; 203.1 ; 6.7 ;4;84;167;0;4;0;4;4;0;0;3;1
8950; 40.1 ; 80.2 ; 5.2 ;2;38;57;0;2;0;2;2;0;0;2;0
8951; 27.7 ; 276.5 ; 2.4 ;10;18;5;0;10;6;4;4;6;7;3;0
8952; 61.1 ; 1,223.0 ; 13.1 ;20;11;0;0;20;0;20;20;0;0;0;20
8953; 55.0 ; 109.9 ; 11.2 ;2;23;74;0;2;0;2;1;1;0;1;1
8954; 53.1 ; 265.5 ; 1.2 ;5;34;99;0;5;0;5;5;0;0;5;0
8955; 45.8 ; 91.6 ; 1.5 ;2;18;254;0;2;1;1;0;2;0;2;0
8956; 38.4 ; 383.9 ; 9.3 ;10;30;5;0;10;1;9;8;2;3;7;0
8957; 24.5 ; 73.5 ; -   ;3;2;296;0;3;1;2;0;3;3;0;0
8958; 53.9 ; 107.8 ; 2.1 ;2;68;211;0;2;0;2;2;0;0;1;1
8959; 27.4 ; 164.3 ; 5.2 ;6;39;2;6;0;3;3;5;1;4;2;0
8960; 44.6 ; 446.2 ; 12.4 ;10;23;108;0;10;3;7;8;2;0;7;3
8961; 42.8 ; 256.7 ; 13.9 ;6;46;16;0;6;1;5;3;3;2;2;2
8962; 54.5 ; 381.3 ; 22.4 ;7;31;99;0;7;0;7;7;0;0;5;2
8963; 48.9 ; 97.8 ; 3.2 ;2;17;254;0;2;1;1;1;1;0;2;0
8964; 27.1 ; 135.7 ; 18.2 ;5;7;238;0;5;0;5;3;2;3;2;0
8965; 59.0 ; 1,120.3 ; 25.1 ;19;14;0;0;19;6;13;6;13;0;0;19
8966; 95.3 ; 381.1 ; 29.8 ;4;63;11;0;4;2;2;2;2;0;0;4
8967; 29.8 ; 59.5 ; 0.3 ;2;239;6;0;2;0;2;1;1;1;1;0
8968; 15.0 ; 45.0 ; -   ;3;49;17;0;3;0;3;1;2;3;0;0
8969; 48.3 ; 434.3 ; 10.1 ;9;45;2;0;9;3;6;3;6;0;6;3
8970; 23.7 ; 47.3 ; 10.8 ;2;5;1;2;0;0;2;2;0;1;1;0
8971; 58.1 ; 232.3 ; 16.1 ;4;73;124;0;4;3;1;2;2;0;0;4
8972; 54.6 ; 163.9 ; 8.5 ;3;38;149;0;3;3;0;1;2;0;2;1
8973; 53.4 ; 694.2 ; 46.2 ;13;14;46;13;0;8;5;2;11;4;5;4
8974; 25.1 ; 50.1 ; -   ;2;5;220;0;2;0;2;0;2;2;0;0
8975; 27.8 ; 83.4 ; 8.2 ;3;25;57;0;3;0;3;2;1;2;1;0
8976; 71.1 ; 142.1 ; 27.8 ;2;63;120;0;2;0;2;2;0;0;0;2
8977; 65.1 ; 130.1 ; 42.6 ;2;131;100;0;2;0;2;2;0;1;0;1
8978; 23.6 ; 47.1 ; 6.4 ;2;1;200;2;0;1;1;1;1;2;0;0
8979; 32.4 ; 97.2 ; 4.4 ;3;31;170;0;3;3;0;1;2;1;2;0
8980; 49.1 ; 196.4 ; 19.8 ;4;107;107;0;4;3;1;2;2;1;2;1
8981; 57.4 ; 172.2 ; 12.1 ;3;25;215;0;3;1;2;2;1;0;0;3
8982; 57.6 ; 172.9 ; 33.0 ;3;26;170;1;2;1;2;1;2;1;0;2
8983; 124.6 ; 249.2 ; 3.4 ;2;67;205;0;2;1;1;1;1;0;0;2
8984; 62.5 ; 249.9 ; 33.7 ;4;57;100;0;4;0;4;3;1;1;0;3
8985; 63.2 ; 695.5 ; 15.1 ;11;25;68;0;11;0;11;11;0;0;0;11
8986; 50.3 ; 703.9 ; 6.6 ;14;13;10;2;12;1;13;13;1;0;9;5
8987; 38.5 ; 76.9 ; 12.4 ;2;20;351;0;2;0;2;1;1;1;1;0
8988; 57.6 ; 230.4 ; 28.9 ;4;60;69;0;4;1;3;3;1;1;0;3
8989; 62.7 ; 125.4 ; 23.9 ;2;86;83;2;0;2;0;2;0;0;0;2
8990; 25.1 ; 75.4 ; 9.3 ;3;110;155;0;3;3;0;3;0;2;1;0
8991; 15.0 ; 134.9 ; -   ;9;11;241;0;9;2;7;2;7;9;0;0
8992; 36.0 ; 72.0 ; 31.5 ;2;12;1;0;2;0;2;2;0;1;0;1
8993; 50.9 ; 101.8 ; 16.2 ;2;138;268;0;2;0;2;0;2;0;1;1
8994; 46.8 ; 93.5 ; -   ;2;12;263;0;2;0;2;0;2;0;2;0
8995; 22.6 ; 45.2 ; 3.2 ;2;6;262;0;2;0;2;2;0;2;0;0
8996; 44.8 ; 402.8 ; 14.6 ;9;44;5;0;9;1;8;7;2;0;6;3
8997; 47.5 ; 142.4 ; -   ;3;31;39;3;0;2;1;1;2;0;3;0
8998; 25.1 ; 125.3 ; -   ;5;9;299;0;5;3;2;3;2;5;0;0
8999; 58.1 ; 232.5 ; 11.1 ;4;1;242;0;4;3;1;3;1;0;0;4
9000; 37.6 ; 263.3 ; 11.7 ;7;14;5;1;6;0;7;3;4;2;5;0
9001; 36.9 ; 73.8 ; 17.7 ;2;27;8;0;2;1;1;0;2;1;1;0
9002; 63.5 ; 571.8 ; 28.6 ;9;36;6;0;9;2;7;3;6;0;0;9
9003; 50.7 ; 152.1 ; 3.1 ;3;64;29;2;1;1;2;1;2;0;3;0
9004; 54.1 ; 162.2 ; 38.0 ;3;43;155;0;3;3;0;1;2;1;1;1
9005; 41.3 ; 82.6 ; 8.2 ;2;12;272;0;2;2;0;1;1;0;2;0
9006; 23.2 ; 324.4 ; 12.2 ;14;16;5;0;14;4;10;12;2;9;5;0
9007; 41.4 ; 165.6 ; 7.5 ;4;64;95;0;4;1;3;4;0;0;4;0
9008; 44.5 ; 711.7 ; 17.2 ;16;11;55;0;16;9;7;4;12;5;6;5
9009; 21.6 ; 64.7 ; 4.1 ;3;33;113;0;3;2;1;2;1;3;0;0
9010; 49.6 ; 99.3 ; 4.3 ;2;129;160;0;2;1;1;2;0;0;2;0
9011; 28.4 ; 256.0 ; 14.6 ;9;41;84;0;9;4;5;3;6;6;3;0
9012; 39.8 ; 79.5 ; 17.9 ;2;5;32;0;2;0;2;1;1;1;0;1
9013; 25.7 ; 51.4 ; 1.0 ;2;23;74;0;2;0;2;2;0;2;0;0
9014; 58.5 ; 117.0 ; 11.2 ;2;111;57;0;2;1;1;2;0;0;0;2
9015; 51.0 ; 102.0 ; -   ;2;13;105;0;2;0;2;0;2;0;2;0
9016; 70.4 ; 211.3 ; 36.5 ;3;51;5;0;3;0;3;3;0;0;0;3
9017; 33.3 ; 833.4 ; 7.8 ;25;14;1;0;25;13;12;3;22;8;17;0
9018; 24.7 ; 74.0 ; 17.7 ;3;88;5;0;3;0;3;2;1;2;1;0
9019; 35.1 ; 246.0 ; 12.1 ;7;32;20;0;7;3;4;4;3;2;5;0
9020; 38.2 ; 650.1 ; 17.5 ;17;9;5;0;17;0;17;17;0;6;5;6
9021; 15.0 ; 59.9 ; -   ;4;16;63;0;4;2;2;1;3;4;0;0
9022; 25.5 ; 51.1 ; 15.8 ;2;14;183;0;2;0;2;1;1;1;1;0
9023; 19.8 ; 634.3 ; 11.1 ;32;13;0;0;32;11;21;18;14;21;11;0
9024; 55.3 ; 553.3 ; 37.5 ;10;35;16;0;10;1;9;7;3;3;0;7
9025; 50.1 ; 150.3 ; 12.2 ;3;34;83;0;3;1;2;1;2;0;2;1
9026; 71.7 ; 358.4 ; 17.3 ;5;58;38;0;5;3;2;5;0;0;0;5
9027; 19.2 ; 365.3 ; 5.5 ;19;11;2;0;19;12;7;14;5;19;0;0
9028; 24.9 ; 49.8 ; 0.3 ;2;24;96;0;2;1;1;1;1;2;0;0
9029; 24.1 ; 458.0 ; 13.0 ;19;20;12;0;19;6;13;9;10;13;6;0
9030; 34.6 ; 345.9 ; 14.0 ;10;29;22;0;10;2;8;8;2;3;7;0
9031; 34.3 ; 68.5 ; 4.6 ;2;207;99;0;2;0;2;0;2;1;1;0
9032; 49.1 ; 98.2 ; 0.7 ;2;27;256;0;2;1;1;2;0;0;2;0
9033; 60.3 ; 120.5 ; 20.2 ;2;131;259;0;2;1;1;1;1;0;0;2
9034; 21.1 ; 84.4 ; -   ;4;29;11;0;4;0;4;4;0;4;0;0
9035; 99.3 ; 198.5 ; 70.0 ;2;50;149;2;0;2;0;0;2;1;0;1
9036; 20.0 ; 40.1 ; 7.6 ;2;46;134;0;2;2;0;0;2;2;0;0
9037; 33.9 ; 474.0 ; 9.4 ;14;17;29;0;14;2;12;5;9;5;9;0
9038; 32.4 ; 647.0 ; 16.8 ;20;7;1;0;20;4;16;5;15;7;13;0
9039; 47.4 ; 94.8 ; 15.1 ;2;89;113;0;2;2;0;0;2;0;1;1
9040; 37.1 ; 222.5 ; 12.7 ;6;47;36;0;6;1;5;2;4;2;4;0
9041; 52.5 ; 262.6 ; 5.0 ;5;57;57;0;5;0;5;4;1;0;3;2
9042; 52.6 ; 105.2 ; 1.8 ;2;42;126;0;2;0;2;0;2;0;2;0
9043; 31.7 ; 158.4 ; 10.1 ;5;49;2;0;5;1;4;2;3;2;3;0
9044; 63.4 ; 1,521.8 ; 43.5 ;24;18;2;0;24;3;21;12;12;8;0;16
9045; 36.6 ; 146.3 ; 11.0 ;4;102;9;0;4;3;1;2;2;1;3;0
9046; 36.1 ; 108.4 ; 11.5 ;3;52;127;0;3;0;3;2;1;1;2;0
9047; 16.5 ; 33.0 ; 2.3 ;2;69;94;0;2;0;2;2;0;2;0;0
9048; 77.4 ; 154.7 ; 20.1 ;2;13;68;0;2;0;2;2;0;0;0;2
9049; 27.8 ; 111.1 ; 16.0 ;4;66;17;0;4;2;2;2;2;3;1;0
9050; 47.9 ; 95.9 ; 0.4 ;2;320;7;1;1;1;1;1;1;0;2;0
9051; 33.4 ; 1,069.0 ; 12.6 ;32;8;4;0;32;20;12;6;26;11;21;0
9052; 29.6 ; 148.2 ; 8.2 ;5;19;250;0;5;3;2;3;2;3;2;0
9053; 58.3 ; 524.9 ; 48.8 ;9;32;95;0;9;0;9;6;3;3;0;6
9054; 84.3 ; 168.6 ; 56.3 ;2;24;183;0;2;0;2;0;2;1;0;1
9055; 33.9 ; 67.9 ; 19.2 ;2;20;105;0;2;1;1;2;0;1;1;0
9056; 25.1 ; 50.1 ; -   ;2;5;230;0;2;2;0;0;2;2;0;0
9057; 52.2 ; 156.5 ; 9.8 ;3;25;32;0;3;0;3;2;1;0;2;1
9058; 45.7 ; 365.5 ; 20.9 ;8;29;3;0;8;4;4;6;2;3;2;3
9059; 27.0 ; 81.0 ; 2.9 ;3;109;183;0;3;1;2;1;2;3;0;0
9060; 40.1 ; 160.2 ; 7.0 ;4;50;26;0;4;0;4;4;0;0;4;0
9061; 50.3 ; 201.3 ; 25.2 ;4;33;218;0;4;4;0;2;2;1;2;1
9062; 78.0 ; 156.0 ; 3.4 ;2;67;160;0;2;1;1;2;0;0;0;2
9063; 53.9 ; 161.7 ; 25.1 ;3;190;23;0;3;3;0;1;2;1;1;1
9064; 36.1 ; 108.3 ; 11.1 ;3;124;21;0;3;1;2;2;1;1;2;0
9065; 54.5 ; 163.6 ; -   ;3;45;26;0;3;1;2;1;2;0;3;0
9066; 54.4 ; 108.9 ; 11.5 ;2;2;138;2;0;2;0;0;2;0;1;1
9067; 15.0 ; 30.0 ; -   ;2;85;3;0;2;1;1;2;0;2;0;0
9068; 15.0 ; 30.0 ; -   ;2;42;63;0;2;1;1;0;2;2;0;0
9069; 46.5 ; 232.6 ; 7.5 ;5;77;2;0;5;3;2;1;4;0;5;0
9070; 57.1 ; 799.0 ; 17.9 ;14;33;10;0;14;0;14;10;4;0;0;14
9071; 18.1 ; 36.2 ; 0.2 ;2;12;25;0;2;2;0;0;2;2;0;0
9072; 49.6 ; 99.3 ; 4.3 ;2;86;295;0;2;0;2;2;0;0;2;0
9073; 53.5 ; 213.9 ; 30.4 ;4;12;262;0;4;1;3;2;2;1;2;1
9074; 23.6 ; 471.9 ; 8.0 ;20;17;3;0;20;9;11;5;15;13;7;0
9075; 47.9 ; 575.3 ; 9.9 ;12;16;78;0;12;3;9;8;4;0;8;4
9076; 62.7 ; 125.3 ; 2.5 ;2;70;90;0;2;1;1;1;1;0;0;2
9077; 80.1 ; 1,121.0 ; 23.7 ;14;29;20;0;14;0;14;12;2;0;0;14
9078; 19.4 ; 38.9 ; -   ;2;11;215;0;2;1;1;0;2;2;0;0
9079; 26.1 ; 209.0 ; 11.0 ;8;29;99;0;8;0;8;5;3;5;3;0
9080; 53.2 ; 212.8 ; 13.1 ;4;85;84;0;4;2;2;2;2;0;3;1
9081; 68.2 ; 204.6 ; 39.6 ;3;26;125;2;1;1;2;1;2;1;0;2
9082; 46.6 ; 606.4 ; 5.3 ;13;12;38;0;13;7;6;11;2;0;13;0
9083; 37.3 ; 74.6 ; 4.6 ;2;69;102;0;2;2;0;0;2;0;2;0
9084; 29.5 ; 501.4 ; 10.1 ;17;19;1;0;17;6;11;9;8;11;6;0
9085; 41.0 ; 81.9 ; 16.1 ;2;76;76;2;0;2;0;0;2;1;0;1
9086; 48.8 ; 146.5 ; 48.8 ;3;113;2;0;3;2;1;1;2;1;1;1
9087; 50.6 ; 151.7 ; 33.3 ;3;5;250;0;3;2;1;0;3;1;1;1
9088; 22.1 ; 397.6 ; 11.3 ;18;18;6;0;18;6;12;10;8;12;6;0
9089; 51.9 ; 259.7 ; 22.2 ;5;32;84;0;5;0;5;3;2;2;1;2
9090; 33.2 ; 265.6 ; 5.3 ;8;19;29;0;8;5;3;4;4;3;5;0
9091; 17.1 ; 102.8 ; 6.0 ;6;41;44;0;6;4;2;4;2;6;0;0
9092; 16.0 ; 351.4 ; 3.1 ;22;14;15;0;22;7;15;11;11;22;0;0
9093; 53.1 ; 955.8 ; 36.0 ;18;14;38;0;18;8;10;7;11;6;6;6
9094; 56.8 ; 170.3 ; 12.9 ;3;16;152;0;3;0;3;2;1;0;0;3
9095; 51.9 ; 103.9 ; 1.4 ;2;12;251;0;2;0;2;2;0;0;2;0
9096; 31.1 ; 62.2 ; 19.6 ;2;13;147;2;0;0;2;1;1;1;1;0
9097; 46.8 ; 140.3 ; -   ;3;29;225;0;3;0;3;1;2;0;3;0
9098; 32.5 ; 194.7 ; 16.4 ;6;33;115;0;6;0;6;2;4;2;4;0
9099; 28.0 ; 83.9 ; 5.8 ;3;50;316;0;3;0;3;2;1;2;1;0
9100; 26.2 ; 341.0 ; 23.3 ;13;18;50;0;13;7;6;13;0;9;4;0
9101; 18.0 ; 89.9 ; 7.1 ;5;35;55;0;5;4;1;1;4;5;0;0
9102; 25.6 ; 817.6 ; 14.7 ;32;6;0;0;32;12;20;16;16;21;11;0
9103; 62.7 ; 313.3 ; 11.9 ;5;62;17;0;5;0;5;3;2;0;0;5
9104; 43.8 ; 525.9 ; 5.3 ;12;23;22;0;12;0;12;10;2;0;12;0
9105; 36.6 ; 73.2 ; -   ;2;36;245;0;2;2;0;0;2;0;2;0
9106; 35.5 ; 248.8 ; 15.2 ;7;10;1;0;7;0;7;1;6;2;5;0
9107; 29.2 ; 291.8 ; 17.2 ;10;23;0;2;8;6;4;6;4;7;3;0
9108; 22.2 ; 66.6 ; 13.2 ;3;97;35;0;3;3;0;1;2;2;1;0
9109; 48.9 ; 146.7 ; 2.7 ;3;144;14;0;3;3;0;3;0;0;3;0
9110; 21.3 ; 106.6 ; 10.2 ;5;20;57;0;5;2;3;4;1;3;2;0
9111; 47.4 ; 142.1 ; 1.1 ;3;50;189;0;3;1;2;1;2;0;3;0
9112; 26.7 ; 106.9 ; 16.0 ;4;13;239;0;4;4;0;1;3;3;1;0
9113; 36.8 ; 441.2 ; 6.2 ;12;24;10;0;12;6;6;4;8;0;12;0
9114; 37.2 ; 111.5 ; 7.9 ;3;153;13;0;3;2;1;1;2;1;2;0
9115; 29.6 ; 414.2 ; 10.4 ;14;12;233;0;14;8;6;5;9;9;5;0
9116; 33.3 ; 232.8 ; 9.9 ;7;32;10;0;7;3;4;1;6;2;5;0
9117; 43.2 ; 172.7 ; 12.8 ;4;41;0;0;4;1;3;2;2;0;3;1
9118; 15.0 ; 74.9 ; -   ;5;12;22;0;5;1;4;5;0;5;0;0
9119; 70.2 ; 140.3 ; 3.4 ;2;32;73;0;2;0;2;2;0;0;0;2
9120; 26.4 ; 79.2 ; 6.8 ;3;34;118;0;3;2;1;3;0;2;1;0
9121; 19.8 ; 692.0 ; 10.1 ;35;5;49;0;35;22;13;9;26;35;0;0
9122; 54.9 ; 768.0 ; 13.9 ;14;23;16;0;14;5;9;8;6;0;9;5
9123; 47.5 ; 94.9 ; 1.1 ;2;231;17;0;2;0;2;0;2;0;2;0
9124; 17.5 ; 70.0 ; 5.3 ;4;30;168;0;4;1;3;2;2;4;0;0
9125; 41.3 ; 165.2 ; 6.1 ;4;12;8;4;0;3;1;4;0;0;4;0
9126; 48.2 ; 241.2 ; 15.8 ;5;33;215;0;5;3;2;2;3;0;3;2
9127; 49.6 ; 248.2 ; 18.2 ;5;52;159;2;3;2;3;3;2;0;3;2
9128; 22.6 ; 90.3 ; 9.3 ;4;35;10;0;4;1;3;0;4;3;1;0
9129; 54.3 ; 108.6 ; 2.7 ;2;76;225;0;2;0;2;1;1;0;1;1
9130; 15.0 ; 59.9 ; -   ;4;45;26;0;4;3;1;1;3;4;0;0
9131; 15.0 ; 30.0 ; -   ;2;7;260;0;2;2;0;2;0;2;0;0
9132; 51.5 ; 103.0 ; 39.6 ;2;60;191;0;2;1;1;1;1;1;0;1
9133; 44.7 ; 1,697.7 ; 31.7 ;38;10;6;0;38;12;26;22;16;13;12;13
9134; 46.6 ; 279.6 ; 18.6 ;6;37;95;0;6;0;6;4;2;2;2;2
9135; 56.1 ; 112.2 ; -   ;2;145;236;0;2;0;2;2;0;0;0;2
9136; 31.5 ; 220.5 ; 20.6 ;7;43;26;0;7;0;7;2;5;2;5;0
9137; 18.0 ; 71.9 ; 5.1 ;4;17;269;0;4;2;2;4;0;4;0;0
9138; 55.3 ; 774.5 ; 23.4 ;14;23;23;0;14;2;12;4;10;0;0;14
9139; 24.1 ; 48.2 ; 9.1 ;2;72;86;0;2;1;1;1;1;1;1;0
9140; 23.9 ; 119.6 ; 15.9 ;5;32;97;2;3;2;3;3;2;3;2;0
9141; 43.0 ; 86.1 ; 20.5 ;2;103;121;0;2;1;1;2;0;1;0;1
9142; 36.6 ; 146.4 ; -   ;4;9;110;0;4;2;2;4;0;0;4;0
9143; 19.7 ; 59.0 ; -   ;3;45;218;0;3;1;2;1;2;3;0;0
9144; 19.2 ; 268.9 ; 5.4 ;14;9;10;0;14;2;12;7;7;14;0;0
9145; 19.7 ; 39.5 ; -   ;2;5;265;0;2;2;0;2;0;2;0;0
9146; 29.6 ; 118.4 ; 18.3 ;4;41;176;0;4;2;2;1;3;3;1;0
9147; 28.9 ; 86.7 ; 21.8 ;3;68;155;0;3;2;1;1;2;2;1;0
9148; 24.8 ; 148.9 ; 13.2 ;6;30;137;0;6;3;3;1;5;4;2;0
9149; 20.4 ; 81.6 ; 7.3 ;4;11;47;0;4;0;4;3;1;4;0;0
9150; 40.1 ; 160.6 ; 19.8 ;4;22;162;0;4;1;3;2;2;1;2;1
9151; 46.2 ; 692.5 ; 14.1 ;15;18;11;0;15;7;8;8;7;0;10;5
9152; 32.0 ; 159.9 ; 4.6 ;5;26;147;0;5;0;5;5;0;2;3;0
9153; 61.4 ; 306.9 ; 27.4 ;5;10;206;0;5;1;4;1;4;0;0;5
9154; 25.3 ; 177.1 ; 12.1 ;7;21;133;0;7;0;7;2;5;5;2;0
9155; 69.9 ; 139.9 ; 13.4 ;2;1;115;0;2;0;2;2;0;0;0;2
9156; 91.1 ; 273.3 ; 22.0 ;3;41;104;0;3;0;3;3;0;0;0;3
9157; 55.3 ; 110.7 ; 3.2 ;2;194;1;0;2;0;2;0;2;0;0;2
9158; 48.9 ; 146.7 ; 3.3 ;3;19;94;0;3;0;3;3;0;0;3;0
9159; 71.0 ; 142.0 ; 32.1 ;2;26;167;0;2;0;2;2;0;0;0;2
9160; 25.1 ; 75.2 ; 2.2 ;3;45;107;0;3;2;1;1;2;3;0;0
9161; 36.7 ; 256.9 ; 13.3 ;7;31;131;0;7;3;4;6;1;2;5;0
9162; 15.0 ; 45.0 ; -   ;3;55;58;0;3;1;2;0;3;3;0;0
9163; 51.4 ; 102.9 ; 7.0 ;2;62;215;0;2;0;2;2;0;0;1;1
9164; 29.7 ; 178.1 ; 3.2 ;6;36;122;0;6;2;4;1;5;4;2;0
9165; 16.5 ; 49.6 ; 2.9 ;3;123;73;0;3;0;3;0;3;3;0;0
9166; 27.6 ; 55.3 ; 3.8 ;2;10;143;0;2;0;2;1;1;1;1;0
9167; 44.7 ; 134.0 ; 7.4 ;3;57;88;0;3;2;1;1;2;0;3;0
9168; 25.3 ; 252.9 ; 8.5 ;10;29;5;0;10;5;5;2;8;7;3;0
9169; 30.3 ; 576.4 ; 20.6 ;19;5;35;0;19;5;14;8;11;6;13;0
9170; 30.6 ; 275.2 ; 17.5 ;9;3;147;0;9;5;4;3;6;3;6;0
9171; 22.7 ; 45.5 ; 5.1 ;2;6;185;0;2;2;0;0;2;2;0;0
9172; 45.2 ; 135.6 ; 15.3 ;3;235;5;0;3;2;1;2;1;1;1;1
9173; 45.4 ; 90.8 ; 19.5 ;2;178;17;2;0;1;1;0;2;1;0;1
9174; 15.0 ; 59.9 ; -   ;4;5;97;0;4;4;0;2;2;4;0;0
9175; 26.7 ; 160.0 ; 15.5 ;6;30;119;0;6;3;3;2;4;4;2;0
9176; 30.2 ; 60.4 ; -   ;2;19;263;0;2;0;2;1;1;0;2;0
9177; 50.2 ; 1,103.7 ; 14.6 ;22;20;5;5;17;5;17;16;6;0;15;7
9178; 23.8 ; 143.0 ; 5.6 ;6;23;196;0;6;3;3;1;5;6;0;0
9179; 55.5 ; 222.0 ; 8.9 ;4;7;14;4;0;4;0;1;3;0;0;4
9180; 27.6 ; 55.3 ; 3.8 ;2;95;104;2;0;0;2;2;0;1;1;0
9181; 23.5 ; 46.9 ; 12.7 ;2;5;74;0;2;0;2;2;0;1;1;0
9182; 64.9 ; 324.7 ; 38.2 ;5;23;226;0;5;1;4;2;3;2;0;3
9183; 45.3 ; 678.9 ; 14.3 ;15;16;0;9;6;4;11;4;11;0;10;5
9184; 47.7 ; 190.6 ; 0.4 ;4;33;5;0;4;0;4;4;0;0;4;0
9185; 43.3 ; 86.5 ; 13.9 ;2;25;204;0;2;0;2;2;0;1;0;1
9186; 27.6 ; 331.5 ; 5.5 ;12;11;21;0;12;0;12;9;3;8;4;0
9187; 28.2 ; 84.7 ; 2.9 ;3;2;317;0;3;2;1;2;1;2;1;0
9188; 18.3 ; 201.3 ; 5.7 ;11;15;72;0;11;7;4;1;10;11;0;0
9189; 69.9 ; 279.5 ; 30.7 ;4;27;53;0;4;0;4;2;2;0;0;4
9190; 47.7 ; 811.5 ; 32.0 ;17;8;19;0;17;7;10;2;15;6;5;6
9191; 80.5 ; 161.1 ; 91.7 ;2;46;182;0;2;1;1;1;1;1;0;1
9192; 47.2 ; 330.5 ; 18.4 ;7;30;52;0;7;1;6;2;5;2;3;2
9193; 20.6 ; 102.9 ; 6.0 ;5;35;180;0;5;3;2;4;1;5;0;0
9194; 99.9 ; 199.8 ; 60.4 ;2;180;40;0;2;1;1;0;2;0;0;2
9195; 57.0 ; 114.0 ; 7.9 ;2;59;45;2;0;1;1;0;2;0;0;2
9196; 53.2 ; 106.5 ; -   ;2;13;89;2;0;0;2;2;0;0;2;0
9197; 27.6 ; 55.2 ; -   ;2;5;215;0;2;1;1;2;0;2;0;0
9198; 80.1 ; 160.1 ; 25.9 ;2;59;228;0;2;1;1;1;1;0;0;2
9199; 15.0 ; 30.0 ; -   ;2;5;139;2;0;1;1;1;1;2;0;0
9200; 93.1 ; 186.3 ; 56.7 ;2;67;22;0;2;0;2;2;0;0;0;2
9201; 41.4 ; 372.9 ; 27.0 ;9;18;44;0;9;6;3;5;4;3;3;3
9202; 108.1 ; 648.4 ; 68.2 ;6;20;33;0;6;3;3;5;1;0;0;6
9203; 18.8 ; 94.2 ; 2.8 ;5;56;29;0;5;3;2;1;4;5;0;0
9204; 44.0 ; 219.9 ; 13.7 ;5;34;30;1;4;2;3;2;3;0;3;2
9205; 48.2 ; 96.4 ; -   ;2;14;10;0;2;0;2;2;0;0;2;0
9206; 49.1 ; 98.3 ; 36.0 ;2;4;278;0;2;1;1;0;2;1;0;1
9207; 36.6 ; 109.8 ; -   ;3;68;23;0;3;1;2;3;0;0;3;0
9208; 57.8 ; 288.9 ; 21.3 ;5;19;142;0;5;0;5;5;0;0;0;5
9209; 25.4 ; 481.8 ; 1.4 ;19;15;10;0;19;3;16;11;8;19;0;0
9210; 33.9 ; 135.4 ; 10.8 ;4;103;5;0;4;1;3;2;2;1;3;0
9211; 40.4 ; 242.4 ; 9.7 ;6;30;148;0;6;0;6;2;4;0;6;0
9212; 23.5 ; 612.2 ; 15.9 ;26;9;7;0;26;21;5;24;2;17;9;0
9213; 33.0 ; 66.0 ; 4.5 ;2;142;53;0;2;0;2;1;1;1;1;0
9214; 20.8 ; 582.1 ; 8.9 ;28;6;19;0;28;13;15;24;4;28;0;0
9215; 47.9 ; 239.5 ; 0.4 ;5;9;1;0;5;0;5;3;2;0;5;0
9216; 23.0 ; 527.9 ; 9.7 ;23;12;18;0;23;13;10;7;16;15;8;0
9217; 26.4 ; 105.5 ; 8.0 ;4;40;37;4;0;0;4;3;1;3;1;0
9218; 52.5 ; 105.0 ; -   ;2;5;231;0;2;0;2;1;1;0;2;0
9219; 28.3 ; 311.4 ; 13.7 ;11;38;18;0;11;9;2;7;4;7;4;0
9220; 33.4 ; 66.8 ; 8.8 ;2;12;59;0;2;1;1;0;2;1;1;0
9221; 33.3 ; 533.1 ; 18.8 ;16;20;3;0;16;5;11;3;13;5;11;0
9222; 55.6 ; 166.8 ; 11.3 ;3;25;251;0;3;0;3;3;0;0;0;3
9223; 28.3 ; 85.0 ; 3.0 ;3;9;5;0;3;0;3;2;1;2;1;0
9224; 20.0 ; 40.1 ; 7.6 ;2;7;73;2;0;0;2;1;1;2;0;0
9225; 63.0 ; 126.0 ; 33.6 ;2;5;53;0;2;0;2;2;0;1;0;1
9226; 35.4 ; 177.1 ; 15.1 ;5;14;17;0;5;4;1;2;3;2;3;0
9227; 18.8 ; 619.1 ; 7.3 ;33;9;2;0;33;7;26;13;20;33;0;0
9228; 19.4 ; 271.7 ; 10.2 ;14;21;5;0;14;0;14;3;11;14;0;0
9229; 52.6 ; 315.8 ; 19.3 ;6;68;5;0;6;0;6;4;2;0;4;2
9230; 35.4 ; 141.7 ; 8.3 ;4;26;272;0;4;2;2;2;2;1;3;0
9231; 34.1 ; 204.3 ; 18.2 ;6;57;5;0;6;4;2;6;0;2;4;0
9232; 38.4 ; 76.7 ; 12.6 ;2;142;5;0;2;1;1;1;1;1;1;0
9233; 75.7 ; 530.0 ; 50.0 ;7;36;52;0;7;3;4;3;4;2;0;5
9234; 60.1 ; 120.3 ; 26.1 ;2;24;268;0;2;0;2;2;0;0;0;2
9235; 34.0 ; 67.9 ; 13.3 ;2;44;125;0;2;0;2;0;2;1;1;0
9236; 35.9 ; 71.8 ; 16.2 ;2;51;220;0;2;0;2;1;1;1;1;0
9237; 30.3 ; 939.9 ; 14.4 ;31;14;34;0;31;16;15;19;12;10;21;0
9238; 24.9 ; 74.8 ; 6.7 ;3;111;85;0;3;2;1;1;2;2;1;0
9239; 40.6 ; 202.8 ; 10.0 ;5;44;15;0;5;1;4;2;3;0;5;0
9240; 30.2 ; 60.4 ; -   ;2;29;356;0;2;2;0;0;2;0;2;0
9241; 32.1 ; 224.6 ; 22.1 ;7;9;258;0;7;2;5;3;4;2;5;0
9242; 24.3 ; 218.6 ; 11.8 ;9;55;1;0;9;1;8;7;2;6;3;0
9243; 33.5 ; 167.5 ; 1.3 ;5;57;68;0;5;0;5;5;0;0;5;0
9244; 17.2 ; 34.4 ; 3.3 ;2;19;274;0;2;1;1;1;1;2;0;0
9245; 26.0 ; 77.9 ; 15.7 ;3;59;263;0;3;0;3;3;0;2;1;0
9246; 22.6 ; 90.3 ; 9.3 ;4;77;83;0;4;0;4;0;4;3;1;0
9247; 25.1 ; 50.1 ; -   ;2;32;179;0;2;1;1;0;2;2;0;0
9248; 45.4 ; 181.5 ; 27.9 ;4;19;135;0;4;3;1;2;2;1;2;1
9249; 34.8 ; 174.0 ; 6.6 ;5;5;137;0;5;3;2;2;3;2;3;0
9250; 26.7 ; 133.3 ; 7.4 ;5;37;116;0;5;0;5;0;5;3;2;0
9251; 61.9 ; 123.8 ; 40.7 ;2;1;315;0;2;1;1;2;0;1;0;1
9252; 32.4 ; 259.4 ; 11.6 ;8;22;16;0;8;0;8;6;2;3;5;0
9253; 18.2 ; 73.0 ; 2.4 ;4;14;1;4;0;2;2;4;0;4;0;0
9254; 19.7 ; 39.5 ; -   ;2;1;29;0;2;2;0;0;2;2;0;0
9255; 25.2 ; 125.8 ; 7.1 ;5;63;56;0;5;3;2;4;1;3;2;0
9256; 19.1 ; 898.1 ; 8.2 ;47;9;2;0;47;20;27;31;16;47;0;0
9257; 35.9 ; 71.8 ; 16.2 ;2;22;250;0;2;1;1;0;2;1;1;0
9258; 15.0 ; 45.0 ; -   ;3;2;45;0;3;3;0;0;3;3;0;0
9259; 49.2 ; 492.2 ; 25.5 ;10;37;0;0;10;1;9;6;4;3;4;3
9260; 71.5 ; 429.2 ; 32.1 ;6;19;20;0;6;0;6;5;1;0;0;6
9261; 48.4 ; 145.3 ; 2.7 ;3;79;137;0;3;2;1;1;2;0;3;0
9262; 17.9 ; 268.8 ; 3.0 ;15;20;5;0;15;0;15;12;3;15;0;0
9263; 25.4 ; 101.7 ; 9.4 ;4;33;62;0;4;0;4;2;2;3;1;0
9264; 42.5 ; 212.4 ; 5.8 ;5;38;246;0;5;0;5;2;3;0;5;0
9265; 50.1 ; 150.2 ; 29.5 ;3;35;35;0;3;1;2;0;3;1;1;1
9266; 32.4 ; 453.6 ; 9.7 ;14;28;7;0;14;5;9;6;8;5;9;0
9267; 51.5 ; 154.5 ; 25.5 ;3;40;156;3;0;3;0;1;2;1;1;1
9268; 24.1 ; 120.4 ; 5.9 ;5;27;68;0;5;2;3;3;2;5;0;0
9269; 39.4 ; 78.8 ; 13.8 ;2;12;262;0;2;0;2;2;0;1;1;0
9270; 23.9 ; 167.6 ; 9.4 ;7;24;57;0;7;4;3;6;1;5;2;0
9271; 21.2 ; 63.5 ; 7.8 ;3;36;228;0;3;2;1;2;1;3;0;0
9272; 33.1 ; 231.9 ; 11.9 ;7;21;0;0;7;3;4;2;5;2;5;0
9273; 39.9 ; 79.7 ; 14.5 ;2;75;47;0;2;0;2;2;0;1;1;0
9274; 59.6 ; 119.2 ; 23.3 ;2;114;8;0;2;2;0;0;2;0;0;2
9275; 60.7 ; 182.0 ; 65.6 ;3;14;237;0;3;1;2;1;2;1;0;2
9276; 30.2 ; 362.0 ; 0.1 ;12;17;158;0;12;4;8;4;8;0;12;0
9277; 24.8 ; 198.6 ; 8.6 ;8;25;173;0;8;4;4;4;4;5;3;0
9278; 45.8 ; 91.6 ; 4.4 ;2;4;269;0;2;1;1;0;2;0;2;0
9279; 51.4 ; 102.7 ; 0.5 ;2;15;94;0;2;1;1;2;0;0;2;0
9280; 52.8 ; 316.9 ; 16.7 ;6;51;54;0;6;3;3;5;1;0;4;2
9281; 27.8 ; 388.9 ; 10.2 ;14;12;2;0;14;5;9;6;8;9;5;0
9282; 158.5 ; 316.9 ; 57.7 ;2;6;314;0;2;0;2;2;0;0;0;2
9283; 45.9 ; 275.2 ; 6.5 ;6;56;110;0;6;0;6;2;4;0;6;0
9284; 44.7 ; 268.4 ; 23.8 ;6;22;125;0;6;4;2;4;2;2;2;2
9285; 59.6 ; 119.3 ; 34.5 ;2;6;167;0;2;0;2;1;1;1;0;1
9286; 52.1 ; 260.3 ; 22.2 ;5;43;15;0;5;0;5;3;2;2;1;2
9287; 15.9 ; 334.0 ; 2.8 ;21;10;194;0;21;11;10;11;10;21;0;0
9288; 29.1 ; 87.3 ; 7.4 ;3;38;40;2;1;1;2;2;1;2;1;0
9289; 56.3 ; 506.5 ; 17.2 ;9;18;41;0;9;5;4;3;6;0;0;9
9290; 38.2 ; 152.9 ; 0.9 ;4;34;34;0;4;4;0;0;4;0;4;0
9291; 35.8 ; 179.1 ; 14.6 ;5;72;29;0;5;2;3;2;3;2;3;0
9292; 35.6 ; 71.2 ; 24.2 ;2;20;47;0;2;0;2;1;1;1;0;1
9293; 78.8 ; 157.5 ; 10.4 ;2;124;169;1;1;0;2;1;1;0;0;2
9294; 57.6 ; 806.3 ; 23.6 ;14;23;8;0;14;1;13;9;5;0;0;14
9295; 47.9 ; 239.5 ; 2.7 ;5;22;155;0;5;1;4;1;4;0;5;0
9296; 35.6 ; 71.1 ; 8.0 ;2;23;248;0;2;1;1;0;2;1;1;0
9297; 50.0 ; 450.0 ; 17.5 ;9;28;5;1;8;1;8;6;3;0;6;3
9298; 41.7 ; 83.4 ; 7.6 ;2;152;267;0;2;0;2;2;0;0;2;0
9299; 45.2 ; 677.9 ; 7.3 ;15;23;40;0;15;2;13;12;3;0;15;0
9300; 53.9 ; 377.0 ; 6.1 ;7;33;110;0;7;0;7;4;3;0;5;2
9301; 60.5 ; 121.1 ; 4.6 ;2;131;27;0;2;0;2;1;1;0;0;2
9302; 32.0 ; 256.4 ; 26.7 ;8;41;34;0;8;3;5;4;4;3;2;3
9303; 23.1 ; 115.4 ; 5.5 ;5;77;52;0;5;1;4;2;3;5;0;0
9304; 17.3 ; 86.4 ; 1.6 ;5;18;194;0;5;4;1;5;0;5;0;0
9305; 16.7 ; 250.8 ; 5.5 ;15;20;3;0;15;12;3;14;1;15;0;0
9306; 17.1 ; 102.8 ; 6.0 ;6;40;11;0;6;2;4;3;3;6;0;0
9307; 47.9 ; 143.6 ; 0.7 ;3;56;37;3;0;2;1;1;2;0;3;0
9308; 25.1 ; 75.2 ; -   ;3;41;2;0;3;1;2;1;2;3;0;0
9309; 47.7 ; 95.5 ; 1.5 ;2;18;152;0;2;0;2;2;0;0;2;0
9310; 52.5 ; 105.1 ; 14.5 ;2;64;99;1;1;0;2;1;1;0;1;1
9311; 44.0 ; 263.9 ; 11.5 ;6;29;0;0;6;2;4;3;3;0;4;2
9312; 25.1 ; 50.1 ; -   ;2;17;283;0;2;1;1;0;2;2;0;0
9313; 41.0 ; 327.9 ; 11.1 ;8;46;11;0;8;1;7;8;0;3;5;0
9314; 67.3 ; 201.8 ; 11.0 ;3;3;226;0;3;1;2;1;2;0;0;3
9315; 46.5 ; 1,532.9 ; 18.5 ;33;12;5;0;33;6;27;18;15;11;11;11
9316; 49.1 ; 147.2 ; 22.3 ;3;36;248;0;3;2;1;0;3;1;1;1
9317; 50.6 ; 101.3 ; 2.9 ;2;44;210;0;2;0;2;2;0;0;2;0
9318; 15.8 ; 236.6 ; 1.9 ;15;14;132;0;15;6;9;9;6;15;0;0
9319; 19.4 ; 116.1 ; 3.2 ;6;35;34;6;0;2;4;1;5;6;0;0
9320; 27.1 ; 162.8 ; 26.2 ;6;40;66;0;6;5;1;5;1;4;2;0
9321; 22.9 ; 91.7 ; 16.8 ;4;6;206;4;0;4;0;4;0;3;1;0
9322; 40.6 ; 121.9 ; 19.2 ;3;36;78;0;3;1;2;1;2;1;1;1
9323; 57.1 ; 114.3 ; 0.5 ;2;32;99;0;2;0;2;1;1;0;0;2
9324; 36.9 ; 110.6 ; 17.0 ;3;9;247;0;3;1;2;0;3;1;2;0
9325; 34.3 ; 68.6 ; 19.7 ;2;55;41;0;2;1;1;1;1;1;1;0
9326; 32.8 ; 131.1 ; 7.0 ;4;117;10;0;4;1;3;3;1;1;3;0
9327; 30.7 ; 184.1 ; 10.2 ;6;16;56;0;6;2;4;1;5;2;4;0
9328; 18.3 ; 55.0 ; 6.2 ;3;195;55;1;2;2;1;2;1;3;0;0
9329; 60.0 ; 120.0 ; 17.7 ;2;138;11;2;0;0;2;2;0;0;0;2
9330; 44.7 ; 625.1 ; 7.4 ;14;14;22;0;14;10;4;4;10;0;14;0
9331; 25.6 ; 76.7 ; 19.4 ;3;42;152;0;3;2;1;2;1;2;1;0
9332; 47.6 ; 190.5 ; 17.5 ;4;12;11;0;4;2;2;2;2;0;3;1
9333; 26.7 ; 240.5 ; 10.0 ;9;30;35;0;9;1;8;5;4;6;3;0
9334; 48.6 ; 242.8 ; 6.7 ;5;52;88;0;5;3;2;3;2;0;3;2
9335; 20.4 ; 102.1 ; 6.1 ;5;48;121;0;5;3;2;5;0;5;0;0
9336; 38.8 ; 155.1 ; 13.9 ;4;80;16;0;4;2;2;2;2;1;3;0
9337; 94.2 ; 188.4 ; 7.6 ;2;221;188;0;2;0;2;2;0;0;0;2
9338; 42.1 ; 505.5 ; 33.8 ;12;15;120;0;12;4;8;9;3;4;4;4
9339; 69.9 ; 279.5 ; 6.6 ;4;33;121;0;4;0;4;3;1;0;0;4
9340; 48.0 ; 384.3 ; 14.9 ;8;32;20;0;8;0;8;8;0;0;5;3
9341; 52.0 ; 104.1 ; 23.1 ;2;5;271;0;2;2;0;2;0;1;0;1
9342; 63.8 ; 255.2 ; 19.3 ;4;66;40;2;2;2;2;3;1;0;0;4
9343; 30.9 ; 154.7 ; 19.7 ;5;32;146;0;5;2;3;5;0;2;3;0
9344; 17.0 ; 51.0 ; 1.9 ;3;22;53;3;0;0;3;1;2;3;0;0
9345; 20.3 ; 122.0 ; 8.7 ;6;22;258;0;6;2;4;5;1;6;0;0
9346; 50.3 ; 150.9 ; 23.8 ;3;50;220;0;3;1;2;2;1;1;1;1
9347; 24.3 ; 145.6 ; 9.3 ;6;11;192;0;6;3;3;3;3;4;2;0
9348; 42.8 ; 85.5 ; 8.8 ;2;238;217;0;2;1;1;0;2;0;2;0
9349; 27.7 ; 83.0 ; 11.2 ;3;178;29;0;3;2;1;1;2;2;1;0
9350; 81.6 ; 326.3 ; 35.5 ;4;28;197;0;4;1;3;3;1;0;0;4
9351; 17.7 ; 372.0 ; 5.4 ;21;5;8;21;0;13;8;15;6;21;0;0
9352; 33.4 ; 66.8 ; 4.8 ;2;141;99;0;2;1;1;0;2;1;1;0
9353; 42.7 ; 85.4 ; 18.8 ;2;68;205;0;2;0;2;1;1;1;0;1
9354; 77.2 ; 617.6 ; 27.8 ;8;37;10;0;8;1;7;7;1;0;0;8
9355; 25.9 ; 181.2 ; 11.1 ;7;10;71;0;7;3;4;1;6;5;2;0
9356; 71.8 ; 502.7 ; 31.7 ;7;24;21;0;7;3;4;1;6;0;0;7
9357; 26.7 ; 53.3 ; 14.2 ;2;32;230;0;2;0;2;1;1;1;1;0
9358; 49.1 ; 98.3 ; 0.6 ;2;6;237;0;2;1;1;1;1;0;2;0
9359; 85.4 ; 170.9 ; 55.0 ;2;35;7;0;2;1;1;1;1;0;0;2
9360; 67.4 ; 134.8 ; 12.9 ;2;182;125;0;2;0;2;2;0;0;0;2
9361; 36.8 ; 257.3 ; 11.5 ;7;67;2;0;7;3;4;5;2;2;5;0
9362; 48.4 ; 290.2 ; 35.2 ;6;23;79;0;6;0;6;0;6;2;2;2
9363; 28.3 ; 255.1 ; 3.8 ;9;24;15;0;9;3;6;3;6;6;3;0
9364; 37.5 ; 74.9 ; -   ;2;12;41;0;2;0;2;0;2;0;2;0
9365; 15.0 ; 45.0 ; -   ;3;22;95;1;2;0;3;2;1;3;0;0
9366; 25.8 ; 77.3 ; 9.9 ;3;77;59;0;3;2;1;3;0;2;1;0
9367; 61.8 ; 123.7 ; 47.4 ;2;48;144;2;0;1;1;2;0;1;0;1
9368; 33.7 ; 235.9 ; 12.6 ;7;24;51;0;7;3;4;3;4;2;5;0
9369; 63.9 ; 319.7 ; 7.3 ;5;57;121;0;5;1;4;3;2;0;0;5
9370; 55.3 ; 110.5 ; 32.5 ;2;79;161;0;2;1;1;1;1;1;0;1
9371; 64.7 ; 129.5 ; 18.3 ;2;36;227;0;2;0;2;2;0;0;0;2
9372; 55.5 ; 222.0 ; 12.6 ;4;88;173;0;4;0;4;2;2;0;0;4
9373; 18.3 ; 55.0 ; 1.3 ;3;6;202;3;0;3;0;3;0;3;0;0
9374; 45.1 ; 90.2 ; 19.2 ;2;29;236;0;2;1;1;0;2;1;0;1
9375; 28.1 ; 478.4 ; 5.3 ;17;12;24;0;17;10;7;4;13;11;6;0
9376; 24.7 ; 49.4 ; 11.8 ;2;181;200;0;2;0;2;0;2;1;1;0
9377; 48.2 ; 96.3 ; 2.1 ;2;19;152;0;2;0;2;0;2;0;2;0
9378; 39.8 ; 278.3 ; 23.3 ;7;44;66;0;7;4;3;1;6;2;3;2
9379; 65.2 ; 717.3 ; 29.6 ;11;14;11;0;11;9;2;1;10;0;0;11
9380; 31.8 ; 95.3 ; 17.9 ;3;94;42;0;3;1;2;2;1;1;2;0
9381; 49.7 ; 397.9 ; 17.4 ;8;30;147;0;8;0;8;1;7;0;5;3
9382; 51.1 ; 102.1 ; 4.3 ;2;16;5;0;2;1;1;0;2;0;1;1
9383; 46.1 ; 138.3 ; 6.0 ;3;2;260;0;3;2;1;1;2;0;3;0
9384; 49.9 ; 299.4 ; 41.1 ;6;72;39;0;6;2;4;3;3;2;2;2
9385; 17.7 ; 35.4 ; 4.1 ;2;9;213;0;2;1;1;2;0;2;0;0
9386; 15.0 ; 59.9 ; -   ;4;53;8;3;1;1;3;1;3;4;0;0
9387; 22.4 ; 44.7 ; 6.2 ;2;5;5;0;2;0;2;1;1;2;0;0
9388; 30.1 ; 420.8 ; 7.9 ;14;18;7;2;12;8;6;8;6;5;9;0
9389; 31.6 ; 94.9 ; 1.8 ;3;155;32;0;3;2;1;1;2;1;2;0
9390; 20.0 ; 80.1 ; 6.2 ;4;51;31;0;4;1;3;4;0;4;0;0
9391; 26.7 ; 53.4 ; 17.5 ;2;23;15;0;2;1;1;0;2;1;1;0
9392; 15.0 ; 30.0 ; -   ;2;62;230;0;2;2;0;1;1;2;0;0
9393; 39.5 ; 118.6 ; 13.3 ;3;3;251;0;3;0;3;3;0;1;2;0
9394; 33.9 ; 135.4 ; 16.2 ;4;11;268;0;4;0;4;2;2;1;3;0
9395; 64.3 ; 192.9 ; 16.2 ;3;21;59;0;3;0;3;1;2;0;0;3
9396; 91.5 ; 182.9 ; 34.4 ;2;16;232;0;2;0;2;0;2;0;0;2
9397; 38.7 ; 77.4 ; 3.2 ;2;21;160;0;2;1;1;2;0;0;2;0
9398; 43.4 ; 86.7 ; 27.4 ;2;24;73;2;0;0;2;2;0;1;0;1
9399; 44.5 ; 133.4 ; 7.3 ;3;27;36;3;0;1;2;1;2;0;3;0
9400; 73.7 ; 515.7 ; 26.9 ;7;45;31;0;7;1;6;4;3;0;0;7
9401; 29.3 ; 87.8 ; 26.2 ;3;38;103;0;3;2;1;2;1;2;0;1
9402; 33.4 ; 801.3 ; 8.5 ;24;11;8;0;24;3;21;18;6;8;16;0
9403; 32.9 ; 98.7 ; 3.1 ;3;23;131;0;3;0;3;2;1;1;2;0
9404; 38.5 ; 76.9 ; 12.4 ;2;2;274;0;2;1;1;2;0;1;1;0
9405; 32.7 ; 130.8 ; 19.1 ;4;4;241;0;4;2;2;0;4;1;3;0
9406; 45.6 ; 136.9 ; 16.5 ;3;25;89;0;3;1;2;2;1;1;1;1
9407; 18.8 ; 75.1 ; 8.0 ;4;104;10;0;4;2;2;3;1;4;0;0
9408; 41.4 ; 82.7 ; 16.7 ;2;1;356;0;2;0;2;1;1;1;0;1
9409; 49.5 ; 148.6 ; 3.1 ;3;160;101;0;3;1;2;1;2;0;3;0
9410; 23.2 ; 116.2 ; 8.1 ;5;14;137;0;5;1;4;1;4;3;2;0
9411; 49.1 ; 98.3 ; 7.2 ;2;38;0;2;0;0;2;2;0;0;1;1
9412; 34.2 ; 171.2 ; 13.1 ;5;24;13;0;5;5;0;0;5;2;3;0
9413; 34.3 ; 68.6 ; 6.1 ;2;113;21;0;2;0;2;1;1;1;1;0
9414; 53.6 ; 321.9 ; 6.4 ;6;47;16;0;6;1;5;1;5;0;4;2
9415; 128.7 ; 257.4 ; 31.6 ;2;4;343;0;2;1;1;2;0;0;0;2
9416; 43.5 ; 87.0 ; 6.0 ;2;203;99;0;2;0;2;2;0;0;2;0
9417; 34.9 ; 69.8 ; 20.7 ;2;18;183;0;2;0;2;1;1;1;0;1
9418; 48.4 ; 435.3 ; 21.5 ;9;32;10;0;9;0;9;4;5;3;3;3
9419; 19.4 ; 38.9 ; -   ;2;26;212;0;2;2;0;0;2;2;0;0
9420; 41.7 ; 83.4 ; 7.6 ;2;11;269;0;2;0;2;1;1;0;2;0
9421; 30.5 ; 61.1 ; 0.5 ;2;181;1;0;2;0;2;0;2;0;2;0
9422; 38.9 ; 427.6 ; 16.9 ;11;29;7;0;11;1;10;8;3;4;3;4
9423; 44.4 ; 222.0 ; 2.0 ;5;49;36;0;5;0;5;5;0;0;5;0
9424; 50.6 ; 151.9 ; 3.5 ;3;31;70;0;3;1;2;1;2;0;3;0
9425; 42.8 ; 171.3 ; 11.0 ;4;38;205;0;4;0;4;1;3;0;4;0
9426; 39.2 ; 822.3 ; 11.3 ;21;14;79;0;21;1;20;10;11;7;14;0
9427; 31.1 ; 714.9 ; 12.8 ;23;19;2;0;23;9;14;15;8;8;15;0
9428; 51.4 ; 205.7 ; 5.7 ;4;45;201;0;4;1;3;2;2;0;3;1
9429; 26.3 ; 447.7 ; 5.3 ;17;26;7;0;17;13;4;2;15;11;6;0
9430; 31.5 ; 63.0 ; 9.6 ;2;6;47;0;2;0;2;0;2;1;1;0
9431; 29.9 ; 418.9 ; 11.3 ;14;10;0;0;14;2;12;4;10;9;5;0
9432; 25.1 ; 75.2 ; -   ;3;14;50;0;3;3;0;0;3;3;0;0
9433; 26.3 ; 131.5 ; 11.4 ;5;37;40;0;5;4;1;3;2;3;2;0
9434; 25.8 ; 51.6 ; 16.2 ;2;94;211;0;2;0;2;2;0;1;1;0
9435; 36.9 ; 73.8 ; 17.7 ;2;22;100;0;2;1;1;2;0;1;1;0
9436; 34.4 ; 68.9 ; -   ;2;29;326;0;2;1;1;0;2;0;2;0
9437; 39.1 ; 430.4 ; 9.5 ;11;31;37;0;11;5;6;2;9;4;7;0
9438; 93.7 ; 1,218.5 ; 22.2 ;13;23;37;0;13;0;13;9;4;0;0;13
9439; 16.0 ; 208.0 ; 1.8 ;13;19;54;0;13;7;6;4;9;13;0;0
9440; 37.0 ; 259.1 ; 17.9 ;7;58;96;0;7;7;0;7;0;2;5;0
9441; 69.4 ; 277.4 ; 54.8 ;4;43;203;0;4;1;3;1;3;1;0;3
9442; 19.0 ; 38.0 ; 1.5 ;2;178;155;0;2;1;1;1;1;2;0;0
9443; 33.6 ; 336.1 ; 17.0 ;10;21;2;0;10;3;7;7;3;3;7;0
9444; 50.1 ; 400.7 ; 4.4 ;8;49;53;0;8;3;5;4;4;0;8;0
9445; 70.7 ; 141.3 ; 5.9 ;2;157;73;0;2;0;2;2;0;0;0;2
9446; 17.6 ; 87.8 ; 4.6 ;5;53;180;0;5;2;3;3;2;5;0;0
9447; 23.7 ; 638.9 ; 10.7 ;27;14;13;0;27;19;8;7;20;18;9;0
9448; 52.9 ; 105.8 ; 0.5 ;2;66;84;0;2;1;1;0;2;0;2;0
9449; 57.3 ; 286.6 ; 18.2 ;5;20;17;0;5;0;5;1;4;0;0;5
9450; 41.7 ; 125.2 ; 14.6 ;3;65;59;0;3;1;2;1;2;1;1;1
9451; 85.6 ; 171.2 ; 7.2 ;2;38;120;0;2;0;2;2;0;0;0;2
9452; 68.4 ; 273.7 ; 33.1 ;4;121;91;0;4;2;2;2;2;0;0;4
9453; 15.0 ; 209.8 ; -   ;14;21;4;0;14;12;2;14;0;14;0;0
9454; 20.0 ; 40.1 ; 7.6 ;2;4;2;0;2;1;1;0;2;2;0;0
9455; 47.7 ; 95.5 ; 1.5 ;2;34;272;0;2;1;1;1;1;0;2;0
9456; 25.4 ; 305.4 ; 16.0 ;12;20;15;0;12;0;12;9;3;8;4;0
9457; 18.0 ; 89.9 ; 7.1 ;5;13;268;0;5;2;3;5;0;5;0;0
9458; 50.7 ; 101.4 ; 4.9 ;2;41;20;0;2;1;1;2;0;0;1;1
9459; 45.9 ; 458.7 ; 22.3 ;10;24;13;10;0;4;6;7;3;3;4;3
9460; 52.8 ; 105.7 ; 7.0 ;2;11;22;0;2;0;2;0;2;0;1;1
9461; 46.9 ; 234.3 ; 0.3 ;5;49;68;0;5;3;2;2;3;0;5;0
9462; 42.0 ; 84.1 ; 8.1 ;2;6;41;0;2;0;2;2;0;0;2;0
9463; 37.3 ; 149.1 ; 11.7 ;4;68;130;0;4;2;2;2;2;1;3;0
9464; 47.6 ; 142.9 ; 14.3 ;3;173;26;0;3;1;2;3;0;0;2;1
9465; 53.9 ; 107.8 ; 2.1 ;2;4;211;0;2;0;2;1;1;0;1;1
9466; 86.3 ; 517.5 ; 21.8 ;6;52;5;0;6;1;5;6;0;0;0;6
9467; 37.7 ; 113.2 ; 14.1 ;3;102;95;0;3;1;2;0;3;1;2;0
9468; 39.4 ; 590.6 ; 15.1 ;15;19;18;0;15;5;10;14;1;5;10;0
9469; 43.4 ; 86.8 ; 5.0 ;2;9;221;0;2;1;1;2;0;0;2;0
9470; 30.7 ; 337.3 ; 9.8 ;11;20;26;0;11;0;11;5;6;4;7;0
9471; 35.9 ; 71.8 ; 7.5 ;2;66;21;1;1;1;1;1;1;1;1;0
9472; 46.1 ; 92.2 ; 25.1 ;2;218;148;0;2;1;1;0;2;1;0;1
9473; 100.5 ; 201.0 ; 70.0 ;2;37;48;0;2;0;2;0;2;0;0;2
9474; 41.5 ; 249.0 ; 18.8 ;6;57;38;0;6;2;4;2;4;2;2;2
9475; 40.7 ; 122.0 ; 19.5 ;3;77;64;0;3;0;3;3;0;1;1;1
9476; 54.3 ; 217.1 ; 27.8 ;4;110;19;0;4;3;1;2;2;1;2;1
9477; 18.9 ; 207.7 ; 10.4 ;11;14;2;4;7;7;4;7;4;11;0;0
9478; 36.7 ; 587.1 ; 12.5 ;16;16;10;0;16;10;6;1;15;5;11;0
9479; 20.4 ; 101.8 ; 5.8 ;5;5;65;0;5;4;1;2;3;5;0;0
9480; 28.1 ; 56.3 ; 4.6 ;2;149;17;0;2;1;1;0;2;1;1;0
9481; 41.9 ; 418.7 ; 14.8 ;10;25;65;0;10;2;8;4;6;3;4;3
9482; 39.7 ; 119.1 ; 16.5 ;3;50;305;0;3;0;3;1;2;1;1;1
9483; 35.0 ; 105.1 ; 8.9 ;3;5;141;0;3;1;2;1;2;1;2;0
9484; 15.5 ; 46.4 ; 0.9 ;3;122;69;0;3;1;2;2;1;3;0;0
9485; 28.1 ; 252.5 ; 13.6 ;9;14;177;0;9;4;5;2;7;6;3;0
9486; 16.7 ; 116.8 ; 3.0 ;7;25;72;0;7;6;1;7;0;7;0;0
9487; 38.4 ; 191.9 ; 15.4 ;5;92;21;0;5;0;5;5;0;2;3;0
9488; 36.9 ; 73.8 ; 17.7 ;2;55;174;1;1;0;2;1;1;1;1;0
9489; 33.0 ; 99.0 ; 17.5 ;3;59;69;2;1;0;3;1;2;1;2;0
9490; 46.8 ; 93.5 ; -   ;2;30;189;2;0;0;2;2;0;0;2;0
9491; 44.8 ; 672.4 ; 17.4 ;15;9;142;0;15;6;9;3;12;5;5;5
9492; 29.6 ; 88.7 ; 10.2 ;3;3;137;0;3;0;3;1;2;2;1;0
9493; 50.1 ; 200.5 ; 2.4 ;4;48;44;0;4;1;3;1;3;0;4;0
9494; 17.6 ; 123.0 ; 3.3 ;7;51;53;0;7;2;5;1;6;7;0;0
9495; 21.6 ; 108.0 ; 5.8 ;5;11;7;0;5;2;3;2;3;5;0;0
9496; 47.1 ; 94.2 ; 0.5 ;2;32;99;0;2;0;2;0;2;0;2;0
9497; 68.6 ; 342.8 ; 61.6 ;5;38;26;0;5;0;5;4;1;2;0;3
9498; 64.8 ; 324.2 ; 15.8 ;5;46;10;0;5;0;5;2;3;0;0;5
9499; 22.9 ; 481.1 ; 18.7 ;21;20;16;0;21;0;21;21;0;14;7;0
9500; 57.3 ; 114.7 ; 15.9 ;2;164;188;0;2;0;2;1;1;0;0;2
9501; 36.9 ; 221.5 ; 11.7 ;6;49;15;0;6;0;6;6;0;2;4;0
9502; 49.9 ; 748.9 ; 8.0 ;15;29;10;0;15;4;11;4;11;0;10;5
9503; 66.9 ; 334.6 ; 83.6 ;5;21;116;0;5;1;4;2;3;2;0;3
9504; 15.0 ; 30.0 ; -   ;2;64;221;0;2;1;1;0;2;2;0;0
9505; 28.9 ; 86.7 ; 7.0 ;3;23;106;0;3;2;1;3;0;2;1;0
9506; 44.5 ; 178.2 ; 10.4 ;4;14;110;0;4;0;4;2;2;0;4;0
9507; 49.1 ; 98.1 ; 9.4 ;2;68;199;0;2;1;1;1;1;0;1;1
9508; 35.4 ; 318.9 ; 5.0 ;9;16;155;0;9;5;4;2;7;0;9;0
9509; 18.5 ; 203.9 ; 5.8 ;11;8;66;0;11;1;10;7;4;11;0;0
9510; 28.7 ; 201.1 ; 5.7 ;7;26;2;0;7;5;2;1;6;5;2;0
9511; 79.2 ; 237.5 ; 29.8 ;3;4;230;0;3;1;2;1;2;0;0;3
9512; 34.8 ; 69.6 ; 24.3 ;2;21;188;0;2;0;2;2;0;1;0;1
9513; 17.7 ; 88.6 ; 4.7 ;5;41;131;0;5;0;5;2;3;5;0;0
9514; 31.7 ; 63.3 ; 15.8 ;2;29;69;0;2;1;1;1;1;1;1;0
9515; 35.4 ; 672.0 ; 14.8 ;19;21;47;0;19;1;18;17;2;6;13;0
9516; 34.8 ; 69.6 ; 16.0 ;2;2;158;0;2;1;1;1;1;1;1;0
9517; 23.1 ; 69.3 ; 8.1 ;3;65;46;0;3;2;1;1;2;2;1;0
9518; 23.0 ; 114.9 ; 4.5 ;5;59;41;0;5;5;0;2;3;5;0;0
9519; 29.4 ; 264.5 ; 5.4 ;9;28;10;0;9;3;6;2;7;6;3;0
9520; 16.7 ; 50.0 ; 3.1 ;3;5;69;0;3;0;3;1;2;3;0;0
9521; 38.1 ; 228.3 ; 19.2 ;6;27;64;0;6;2;4;2;4;2;2;2
9522; 47.2 ; 235.9 ; 0.7 ;5;80;7;0;5;1;4;2;3;0;5;0
9523; 55.8 ; 892.3 ; 23.8 ;16;21;11;0;16;0;16;14;2;0;0;16
9524; 36.6 ; 73.2 ; -   ;2;56;11;0;2;0;2;1;1;0;2;0
9525; 100.3 ; 200.5 ; 103.9 ;2;6;16;2;0;0;2;0;2;1;0;1
9526; 65.7 ; 262.7 ; 36.6 ;4;112;98;0;4;3;1;2;2;1;0;3
9527; 38.6 ; 115.8 ; 11.3 ;3;72;117;0;3;1;2;1;2;1;2;0
9528; 20.1 ; 60.2 ; 3.7 ;3;41;72;0;3;2;1;2;1;3;0;0
9529; 35.6 ; 71.2 ; 11.7 ;2;23;124;0;2;2;0;0;2;1;1;0
9530; 23.4 ; 116.9 ; 4.4 ;5;60;1;0;5;4;1;3;2;5;0;0
9531; 48.4 ; 96.9 ; 0.4 ;2;20;0;0;2;0;2;2;0;0;2;0
9532; 54.4 ; 271.9 ; 4.5 ;5;84;73;0;5;1;4;4;1;0;3;2
9533; 46.8 ; 93.5 ; -   ;2;58;214;0;2;1;1;0;2;0;2;0
9534; 39.6 ; 198.1 ; 21.8 ;5;41;17;0;5;4;1;0;5;2;1;2
9535; 29.5 ; 59.0 ; 14.7 ;2;151;41;0;2;0;2;0;2;1;1;0
9536; 24.3 ; 509.4 ; 16.6 ;21;9;54;0;21;15;6;19;2;14;7;0
9537; 34.0 ; 135.9 ; 8.1 ;4;50;41;0;4;2;2;2;2;1;3;0
9538; 43.5 ; 217.5 ; 17.0 ;5;48;57;0;5;3;2;5;0;2;1;2
9539; 15.0 ; 30.0 ; -   ;2;6;234;0;2;2;0;2;0;2;0;0
9540; 27.6 ; 55.3 ; 3.8 ;2;50;94;0;2;0;2;1;1;1;1;0
9541; 29.0 ; 87.0 ; 23.0 ;3;18;11;0;3;0;3;2;1;2;1;0
9542; 19.7 ; 39.3 ; 0.4 ;2;25;268;0;2;0;2;1;1;2;0;0
9543; 39.6 ; 118.9 ; 15.2 ;3;41;43;0;3;2;1;0;3;1;2;0
9544; 48.9 ; 293.5 ; 15.3 ;6;18;5;0;6;4;2;1;5;0;4;2
9545; 15.0 ; 45.0 ; -   ;3;81;87;0;3;3;0;1;2;3;0;0
9546; 81.2 ; 243.6 ; 34.6 ;3;77;57;0;3;2;1;3;0;0;0;3
9547; 35.6 ; 248.9 ; 26.7 ;7;33;22;0;7;0;7;1;6;2;3;2
9548; 44.6 ; 89.1 ; 11.9 ;2;5;200;0;2;0;2;0;2;0;1;1
9549; 18.3 ; 201.8 ; 6.6 ;11;18;10;0;11;5;6;4;7;11;0;0
9550; 67.2 ; 403.3 ; 29.0 ;6;42;54;0;6;2;4;4;2;0;0;6
9551; 27.0 ; 135.0 ; 6.0 ;5;26;74;0;5;1;4;4;1;3;2;0
9552; 49.3 ; 394.1 ; 26.5 ;8;29;65;0;8;4;4;1;7;3;2;3
9553; 35.0 ; 175.1 ; 19.7 ;5;80;8;1;4;3;2;2;3;2;3;0
9554; 19.4 ; 213.2 ; 5.7 ;11;12;32;0;11;5;6;3;8;11;0;0
9555; 20.7 ; 41.5 ; -   ;2;5;0;0;2;0;2;2;0;2;0;0
9556; 52.6 ; 210.6 ; 31.6 ;4;68;10;0;4;1;3;3;1;1;2;1
9557; 46.8 ; 93.5 ; -   ;2;5;362;0;2;0;2;2;0;0;2;0
9558; 47.7 ; 143.1 ; 1.7 ;3;22;225;0;3;0;3;2;1;0;3;0
9559; 52.3 ; 104.7 ; 23.2 ;2;9;3;0;2;1;1;1;1;1;0;1
9560; 61.0 ; 122.0 ; 16.2 ;2;16;296;0;2;1;1;0;2;0;0;2
9561; 27.5 ; 55.0 ; 8.5 ;2;3;5;0;2;1;1;1;1;1;1;0
9562; 20.9 ; 397.5 ; 8.7 ;19;16;80;0;19;9;10;19;0;19;0;0
9563; 17.3 ; 103.5 ; 3.9 ;6;23;120;0;6;0;6;5;1;6;0;0
9564; 37.0 ; 110.9 ; 15.1 ;3;1;78;0;3;2;1;1;2;1;2;0
9565; 53.7 ; 268.4 ; 21.3 ;5;25;100;0;5;0;5;3;2;0;3;2
9566; 22.7 ; 159.2 ; 6.2 ;7;38;59;4;3;1;6;5;2;7;0;0
9567; 35.9 ; 71.8 ; 16.2 ;2;62;115;0;2;1;1;1;1;1;1;0
9568; 43.2 ; 86.4 ; -   ;2;5;251;0;2;2;0;1;1;0;2;0
9569; 44.1 ; 220.5 ; 4.7 ;5;57;89;0;5;1;4;3;2;0;5;0
9570; 56.9 ; 170.8 ; 15.4 ;3;14;262;0;3;0;3;1;2;0;0;3
9571; 38.3 ; 306.1 ; 15.8 ;8;39;5;0;8;0;8;6;2;3;5;0
9572; 99.1 ; 297.4 ; 24.2 ;3;83;140;1;2;2;1;1;2;0;0;3
9573; 70.7 ; 212.1 ; 24.8 ;3;32;121;0;3;2;1;1;2;0;0;3
9574; 26.7 ; 106.8 ; 16.2 ;4;89;22;0;4;2;2;2;2;3;1;0
9575; 50.4 ; 100.8 ; 17.0 ;2;68;173;0;2;0;2;0;2;0;1;1
9576; 48.4 ; 145.1 ; 5.7 ;3;9;110;0;3;0;3;2;1;0;3;0
9577; 16.7 ; 83.3 ; 2.5 ;5;12;177;0;5;3;2;2;3;5;0;0
9578; 43.1 ; 129.4 ; 17.2 ;3;77;111;0;3;0;3;3;0;1;1;1
9579; 30.2 ; 90.6 ; -   ;3;31;57;3;0;1;2;1;2;0;3;0
9580; 28.5 ; 57.1 ; 12.1 ;2;120;152;0;2;0;2;1;1;1;1;0
9581; 25.1 ; 301.5 ; 5.3 ;12;15;30;0;12;12;0;5;7;8;4;0
9582; 44.1 ; 969.6 ; 26.9 ;22;18;3;1;21;14;8;19;3;7;8;7
9583; 51.7 ; 465.0 ; 10.9 ;9;27;62;1;8;0;9;9;0;0;6;3
9584; 24.1 ; 48.2 ; 9.1 ;2;264;43;0;2;0;2;2;0;1;1;0
9585; 22.8 ; 455.1 ; 11.4 ;20;19;2;0;20;7;13;7;13;13;7;0
9586; 38.3 ; 191.5 ; 13.6 ;5;78;131;0;5;1;4;4;1;2;3;0
9587; 26.1 ; 287.0 ; 14.7 ;11;30;7;0;11;8;3;10;1;7;4;0
9588; 58.8 ; 411.4 ; 20.7 ;7;35;23;0;7;0;7;0;7;0;0;7
9589; 17.5 ; 70.0 ; 5.3 ;4;27;69;4;0;0;4;4;0;4;0;0
9590; 24.1 ; 96.5 ; 10.9 ;4;9;274;0;4;2;2;4;0;3;1;0
9591; 47.8 ; 287.0 ; 2.3 ;6;23;259;0;6;2;4;0;6;0;6;0
9592; 41.1 ; 82.2 ; 8.5 ;2;50;131;2;0;0;2;2;0;0;2;0
9593; 36.7 ; 659.7 ; 20.8 ;18;17;14;0;18;10;8;6;12;6;6;6
9594; 30.7 ; 153.6 ; 12.7 ;5;38;99;0;5;1;4;1;4;2;3;0
9595; 52.3 ; 209.0 ; 28.3 ;4;104;34;3;1;3;1;4;0;1;2;1
9596; 17.7 ; 106.1 ; 7.6 ;6;53;20;0;6;3;3;3;3;6;0;0
9597; 65.0 ; 260.1 ; 20.1 ;4;86;41;0;4;1;3;2;2;0;0;4
9598; 35.4 ; 141.8 ; 13.7 ;4;21;146;0;4;2;2;4;0;1;3;0
9599; 52.2 ; 261.2 ; 26.7 ;5;38;194;0;5;0;5;0;5;2;1;2
9600; 23.2 ; 69.5 ; 4.8 ;3;70;1;0;3;2;1;3;0;3;0;0
9601; 88.7 ; 532.0 ; 30.9 ;6;63;69;0;6;0;6;6;0;0;0;6
9602; 79.4 ; 158.8 ; 6.8 ;2;202;10;0;2;0;2;2;0;0;0;2
9603; 29.6 ; 88.9 ; 26.9 ;3;25;194;0;3;1;2;3;0;2;0;1
9604; 23.7 ; 712.0 ; 7.7 ;30;14;1;0;30;16;14;14;16;20;10;0
9605; 29.3 ; 234.5 ; 10.8 ;8;37;31;0;8;1;7;4;4;5;3;0
9606; 37.9 ; 379.3 ; 18.6 ;10;20;263;0;10;0;10;5;5;3;4;3
9607; 16.5 ; 33.0 ; 2.3 ;2;131;92;0;2;2;0;0;2;2;0;0
9608; 47.5 ; 94.9 ; -   ;2;9;32;2;0;1;1;0;2;0;2;0
9609; 38.3 ; 153.2 ; 16.7 ;4;27;89;3;1;0;4;3;1;1;3;0
9610; 30.8 ; 153.9 ; 1.8 ;5;40;110;0;5;1;4;5;0;2;3;0
9611; 61.9 ; 309.4 ; 24.7 ;5;61;52;0;5;1;4;3;2;0;0;5
9612; 49.9 ; 249.4 ; 30.2 ;5;16;0;0;5;1;4;5;0;2;1;2
9613; 92.9 ; 278.8 ; 34.5 ;3;49;57;0;3;2;1;1;2;0;0;3
9614; 36.6 ; 183.0 ; -   ;5;32;25;0;5;2;3;4;1;0;5;0
9615; 30.8 ; 61.7 ; 8.6 ;2;13;380;0;2;2;0;1;1;1;1;0
9616; 37.3 ; 484.5 ; 7.9 ;13;30;31;0;13;0;13;12;1;4;9;0
9617; 35.9 ; 71.8 ; 16.2 ;2;69;110;0;2;0;2;0;2;1;1;0
9618; 35.9 ; 71.8 ; 16.2 ;2;24;247;0;2;0;2;2;0;1;1;0
9619; 43.3 ; 216.6 ; 7.8 ;5;29;8;0;5;3;2;3;2;0;5;0
9620; 46.5 ; 232.3 ; 11.8 ;5;33;80;0;5;2;3;4;1;0;3;2
9621; 73.6 ; 220.9 ; 36.4 ;3;38;217;0;3;3;0;3;0;0;0;3
9622; 68.5 ; 273.8 ; 25.4 ;4;33;73;0;4;0;4;2;2;0;0;4
9623; 48.0 ; 144.1 ; 1.2 ;3;142;74;0;3;0;3;2;1;0;3;0
9624; 61.1 ; 305.7 ; 15.3 ;5;48;32;0;5;1;4;1;4;0;0;5
9625; 16.2 ; 48.6 ; 2.2 ;3;87;15;0;3;2;1;1;2;3;0;0
9626; 33.6 ; 134.5 ; 13.9 ;4;35;49;0;4;1;3;2;2;1;3;0
9627; 88.0 ; 440.1 ; 40.7 ;5;41;41;0;5;2;3;1;4;0;0;5
9628; 54.9 ; 548.7 ; 13.9 ;10;27;26;0;10;1;9;6;4;0;7;3
9629; 22.3 ; 66.9 ; 4.1 ;3;28;84;0;3;0;3;2;1;3;0;0
9630; 49.3 ; 246.3 ; 23.7 ;5;41;32;0;5;1;4;5;0;2;1;2
9631; 49.8 ; 149.5 ; 27.4 ;3;13;149;0;3;2;1;2;1;1;1;1
9632; 35.9 ; 430.2 ; 13.0 ;12;9;68;0;12;0;12;12;0;4;8;0
9633; 15.0 ; 30.0 ; -   ;2;36;353;0;2;0;2;1;1;2;0;0
9634; 23.5 ; 541.3 ; 4.1 ;23;9;72;0;23;20;3;23;0;23;0;0
9635; 36.3 ; 72.5 ; 16.8 ;2;87;0;0;2;0;2;0;2;1;1;0
9636; 34.8 ; 139.3 ; 9.8 ;4;44;70;0;4;2;2;1;3;1;3;0
9637; 42.9 ; 429.2 ; 16.2 ;10;28;99;0;10;4;6;7;3;3;4;3
9638; 46.8 ; 93.5 ; -   ;2;1;109;1;1;1;1;2;0;0;2;0
9639; 27.5 ; 137.7 ; 12.7 ;5;69;59;0;5;2;3;2;3;3;2;0
9640; 21.5 ; 43.1 ; 5.3 ;2;18;84;0;2;0;2;1;1;2;0;0
9641; 40.0 ; 240.2 ; 16.4 ;6;26;135;0;6;2;4;0;6;2;2;2
9642; 79.0 ; 158.0 ; 37.4 ;2;26;107;0;2;2;0;0;2;0;0;2
9643; 29.3 ; 732.7 ; 8.8 ;25;9;8;0;25;15;10;10;15;17;8;0
9644; 51.9 ; 155.6 ; 41.8 ;3;75;22;0;3;0;3;1;2;1;1;1
9645; 65.9 ; 329.4 ; 44.0 ;5;84;0;0;5;2;3;1;4;2;0;3
9646; 49.3 ; 1,231.4 ; 20.9 ;25;10;15;0;25;3;22;14;11;8;9;8
9647; 51.4 ; 154.2 ; 4.5 ;3;54;289;0;3;1;2;1;2;0;2;1
9648; 52.5 ; 105.0 ; -   ;2;76;204;0;2;0;2;0;2;0;2;0
9649; 48.4 ; 96.8 ; 1.4 ;2;25;73;0;2;0;2;1;1;0;2;0
9650; 46.8 ; 93.5 ; -   ;2;5;255;0;2;2;0;0;2;0;2;0
9651; 25.1 ; 175.5 ; -   ;7;24;16;7;0;2;5;3;4;7;0;0
9652; 52.5 ; 105.1 ; 14.5 ;2;292;71;0;2;1;1;2;0;0;1;1
9653; 49.6 ; 148.8 ; 5.2 ;3;7;249;0;3;1;2;2;1;0;3;0
9654; 28.1 ; 56.3 ; 4.6 ;2;104;296;0;2;1;1;0;2;1;1;0
9655; 26.1 ; 52.3 ; -   ;2;59;218;0;2;1;1;0;2;2;0;0
9656; 45.9 ; 91.8 ; 9.6 ;2;23;236;0;2;1;1;1;1;0;1;1
9657; 31.4 ; 157.0 ; 7.6 ;5;7;304;0;5;3;2;1;4;2;3;0
9658; 28.9 ; 375.8 ; 18.0 ;13;20;63;0;13;1;12;10;3;9;4;0
9659; 36.6 ; 146.4 ; -   ;4;68;95;0;4;0;4;3;1;0;4;0
9660; 80.1 ; 240.4 ; 17.4 ;3;78;101;0;3;0;3;3;0;0;0;3
9661; 30.5 ; 122.1 ; 7.5 ;4;50;52;3;1;0;4;2;2;1;3;0
9662; 41.0 ; 82.0 ; 23.8 ;2;20;110;0;2;0;2;0;2;1;0;1
9663; 18.8 ; 75.1 ; 8.0 ;4;25;30;0;4;2;2;3;1;4;0;0
9664; 22.8 ; 114.2 ; 15.4 ;5;26;121;0;5;1;4;4;1;3;2;0
9665; 31.9 ; 956.5 ; 6.1 ;30;11;1;0;30;12;18;6;24;10;20;0
9666; 47.5 ; 94.9 ; -   ;2;51;47;0;2;0;2;0;2;0;2;0
9667; 16.3 ; 48.8 ; 1.6 ;3;52;162;0;3;1;2;3;0;3;0;0
9668; 15.7 ; 31.4 ; 1.1 ;2;29;23;0;2;1;1;0;2;2;0;0
9669; 50.6 ; 151.8 ; 3.5 ;3;97;115;0;3;0;3;1;2;0;3;0
9670; 49.0 ; 293.8 ; 17.2 ;6;41;0;6;0;1;5;2;4;0;4;2
9671; 46.8 ; 93.5 ; -   ;2;29;155;0;2;1;1;0;2;0;2;0
9672; 38.8 ; 194.0 ; 23.0 ;5;1;250;0;5;2;3;3;2;2;1;2
9673; 19.4 ; 97.1 ; 7.0 ;5;34;255;0;5;3;2;3;2;5;0;0
9674; 28.3 ; 113.1 ; 0.1 ;4;10;14;4;0;3;1;1;3;4;0;0
9675; 41.9 ; 125.8 ; 10.8 ;3;45;21;0;3;1;2;1;2;0;3;0
9676; 31.6 ; 63.1 ; 7.1 ;2;23;5;0;2;0;2;0;2;1;1;0
9677; 48.9 ; 97.8 ; 3.2 ;2;18;273;0;2;0;2;0;2;0;2;0
9678; 52.5 ; 157.6 ; 6.5 ;3;90;78;0;3;1;2;2;1;0;2;1
9679; 15.0 ; 59.9 ; -   ;4;27;206;0;4;1;3;2;2;4;0;0
9680; 76.1 ; 228.4 ; 42.1 ;3;130;183;0;3;0;3;1;2;0;0;3
9681; 20.0 ; 40.1 ; 7.6 ;2;5;258;0;2;0;2;0;2;2;0;0
9682; 59.1 ; 295.5 ; 17.6 ;5;83;89;0;5;2;3;2;3;0;0;5
9683; 44.6 ; 133.7 ; 18.0 ;3;81;152;1;2;1;2;1;2;1;1;1
9684; 30.2 ; 60.4 ; -   ;2;133;259;0;2;2;0;1;1;0;2;0
9685; 57.9 ; 173.8 ; 14.7 ;3;148;10;0;3;0;3;3;0;0;0;3
9686; 20.8 ; 83.1 ; 7.2 ;4;21;106;4;0;0;4;1;3;4;0;0
9687; 19.0 ; 95.1 ; 5.9 ;5;11;1;0;5;0;5;5;0;5;0;0
9688; 59.3 ; 948.7 ; 20.6 ;16;11;7;0;16;10;6;5;11;0;0;16
9689; 24.7 ; 419.2 ; 11.4 ;17;16;32;0;17;7;10;9;8;11;6;0
9690; 47.7 ; 620.1 ; 15.7 ;13;18;29;0;13;8;5;3;10;0;9;4
9691; 76.2 ; 228.6 ; 28.4 ;3;89;90;0;3;2;1;3;0;0;0;3
9692; 36.7 ; 146.9 ; 5.8 ;4;63;5;3;1;0;4;3;1;0;4;0
9693; 40.9 ; 245.3 ; 10.7 ;6;26;14;0;6;2;4;6;0;0;6;0
9694; 65.6 ; 131.2 ; 31.8 ;2;57;68;0;2;0;2;2;0;0;0;2
9695; 25.2 ; 276.9 ; 14.1 ;11;12;24;0;11;7;4;2;9;7;4;0
9696; 54.4 ; 543.8 ; 25.8 ;10;19;92;0;10;2;8;9;1;3;4;3
9697; 48.1 ; 240.7 ; 9.7 ;5;17;152;0;5;1;4;3;2;0;3;2
9698; 48.2 ; 144.5 ; 2.6 ;3;113;157;1;2;0;3;3;0;0;3;0
9699; 53.5 ; 1,177.7 ; 16.4 ;22;17;5;0;22;0;22;21;1;0;15;7
9700; 29.3 ; 87.8 ; 6.7 ;3;15;58;1;2;0;3;1;2;2;1;0
9701; 31.4 ; 1,006.1 ; 5.4 ;32;7;5;0;32;3;29;20;12;11;21;0
9702; 69.2 ; 277.0 ; 89.4 ;4;40;22;0;4;0;4;3;1;1;0;3
9703; 39.1 ; 117.2 ; 22.1 ;3;5;2;0;3;2;1;1;2;1;1;1
9704; 27.1 ; 135.5 ; 7.2 ;5;38;35;0;5;3;2;1;4;3;2;0
9705; 55.6 ; 444.7 ; 16.2 ;8;36;40;0;8;2;6;7;1;0;0;8
9706; 41.8 ; 334.4 ; 18.7 ;8;14;17;0;8;4;4;1;7;3;2;3
9707; 62.0 ; 309.9 ; 20.2 ;5;17;41;0;5;0;5;4;1;0;0;5
9708; 46.0 ; 92.0 ; 9.8 ;2;6;263;0;2;0;2;1;1;0;1;1
9709; 36.6 ; 73.2 ; -   ;2;40;15;0;2;1;1;1;1;0;2;0
9710; 47.1 ; 94.2 ; 0.5 ;2;257;57;0;2;0;2;2;0;0;2;0
9711; 41.3 ; 165.2 ; 3.3 ;4;76;127;0;4;1;3;4;0;0;4;0
9712; 37.2 ; 260.4 ; 17.2 ;7;25;109;0;7;0;7;3;4;2;5;0
9713; 51.6 ; 154.7 ; 11.8 ;3;22;83;0;3;0;3;3;0;0;2;1
9714; 47.1 ; 94.2 ; 0.5 ;2;287;32;0;2;1;1;1;1;0;2;0
9715; 49.4 ; 247.0 ; 9.3 ;5;47;26;0;5;1;4;0;5;0;3;2
9716; 19.1 ; 420.0 ; 8.6 ;22;16;41;0;22;10;12;6;16;22;0;0
9717; 29.6 ; 266.5 ; 16.8 ;9;11;129;1;8;8;1;8;1;6;3;0
9718; 20.0 ; 80.1 ; 6.2 ;4;19;205;0;4;1;3;2;2;4;0;0
9719; 33.0 ; 98.9 ; 14.0 ;3;13;10;0;3;1;2;2;1;1;2;0
9720; 28.2 ; 366.5 ; 13.1 ;13;17;95;0;13;5;8;4;9;9;4;0
9721; 94.5 ; 189.0 ; 16.6 ;2;58;14;0;2;1;1;0;2;0;0;2
9722; 181.5 ; 726.0 ; 33.1 ;4;27;156;0;4;2;2;2;2;0;0;4
9723; 32.4 ; 97.3 ; 13.1 ;3;18;242;0;3;0;3;1;2;1;2;0
9724; 53.3 ; 160.0 ; 8.5 ;3;113;5;0;3;1;2;3;0;0;2;1
9725; 70.7 ; 141.3 ; 35.3 ;2;4;117;0;2;1;1;1;1;0;0;2
9726; 25.6 ; 128.1 ; 8.7 ;5;65;8;4;1;1;4;1;4;3;2;0
9727; 22.6 ; 45.2 ; 11.4 ;2;16;258;0;2;1;1;1;1;1;1;0
9728; 18.3 ; 73.1 ; 6.9 ;4;23;15;0;4;1;3;1;3;4;0;0
9729; 20.7 ; 103.7 ; 4.1 ;5;54;15;0;5;0;5;3;2;5;0;0
9730; 61.6 ; 123.1 ; 7.2 ;2;107;157;0;2;0;2;2;0;0;0;2
9731; 67.7 ; 135.4 ; 68.7 ;2;194;113;0;2;2;0;0;2;1;0;1
9732; 25.8 ; 51.6 ; 16.2 ;2;5;284;0;2;0;2;0;2;1;1;0
9733; 44.3 ; 309.9 ; 12.6 ;7;13;26;0;7;1;6;5;2;0;5;2
9734; 25.1 ; 100.3 ; -   ;4;2;246;0;4;1;3;3;1;4;0;0
9735; 45.7 ; 91.4 ; 3.2 ;2;36;32;0;2;0;2;1;1;0;2;0
9736; 28.2 ; 225.4 ; 14.6 ;8;10;213;0;8;5;3;4;4;5;3;0
9737; 18.5 ; 92.7 ; 3.4 ;5;9;170;1;4;2;3;2;3;5;0;0
9738; 20.5 ; 123.1 ; 5.8 ;6;52;4;0;6;1;5;2;4;6;0;0
9739; 48.4 ; 145.2 ; 2.4 ;3;65;52;0;3;1;2;3;0;0;3;0
9740; 47.8 ; 573.3 ; 33.2 ;12;40;0;0;12;3;9;8;4;4;4;4
9741; 47.4 ; 521.0 ; 21.1 ;11;25;5;0;11;0;11;6;5;4;3;4
9742; 41.2 ; 82.5 ; 16.9 ;2;34;233;0;2;1;1;0;2;1;0;1
9743; 28.2 ; 140.9 ; 11.9 ;5;36;125;0;5;2;3;1;4;3;2;0
9744; 104.9 ; 209.8 ; 6.9 ;2;31;173;0;2;0;2;2;0;0;0;2
9745; 36.5 ; 621.2 ; 11.1 ;17;16;10;0;17;0;17;11;6;6;11;0
9746; 35.7 ; 71.3 ; 23.8 ;2;9;167;0;2;1;1;0;2;1;0;1
9747; 40.5 ; 202.4 ; 19.2 ;5;41;89;0;5;0;5;2;3;2;1;2
9748; 33.0 ; 65.9 ; 11.8 ;2;164;89;0;2;0;2;0;2;1;1;0
9749; 18.9 ; 37.9 ; 5.9 ;2;86;261;0;2;2;0;2;0;2;0;0
9750; 41.5 ; 83.1 ; 7.8 ;2;8;146;0;2;1;1;0;2;0;2;0
9751; 29.6 ; 88.9 ; 15.8 ;3;7;187;0;3;1;2;2;1;2;1;0
9752; 39.9 ; 2,674.9 ; 19.8 ;67;5;20;0;67;33;34;40;27;22;23;22
9753; 53.4 ; 106.8 ; 11.5 ;2;10;258;0;2;0;2;2;0;0;1;1
9754; 36.3 ; 181.7 ; 16.3 ;5;42;34;0;5;2;3;1;4;2;3;0
9755; 37.6 ; 112.9 ; 18.1 ;3;85;54;2;1;1;2;1;2;1;1;1
9756; 48.7 ; 146.2 ; 13.7 ;3;32;268;0;3;0;3;2;1;0;2;1
9757; 15.0 ; 45.0 ; -   ;3;97;148;0;3;0;3;2;1;3;0;0
9758; 17.0 ; 51.0 ; 1.9 ;3;37;43;3;0;0;3;2;1;3;0;0
9759; 23.1 ; 1,039.3 ; 16.2 ;45;10;0;0;45;27;18;34;11;30;15;0
9760; 47.8 ; 95.7 ; -   ;2;3;48;0;2;1;1;2;0;0;2;0
9761; 36.0 ; 72.0 ; 24.4 ;2;5;266;0;2;2;0;1;1;1;0;1
9762; 52.5 ; 105.0 ; -   ;2;9;302;0;2;1;1;0;2;0;2;0
9763; 53.9 ; 269.5 ; 6.4 ;5;27;41;0;5;2;3;5;0;0;3;2
9764; 18.3 ; 55.0 ; 6.2 ;3;1;143;0;3;3;0;0;3;3;0;0
9765; 15.0 ; 30.0 ; -   ;2;3;278;0;2;1;1;1;1;2;0;0
9766; 22.4 ; 111.8 ; 5.9 ;5;29;63;0;5;1;4;2;3;5;0;0
9767; 15.0 ; 74.9 ; -   ;5;52;71;0;5;4;1;1;4;5;0;0
9768; 70.3 ; 351.3 ; 12.0 ;5;12;230;0;5;0;5;1;4;0;0;5
9769; 40.2 ; 402.0 ; 20.6 ;10;14;84;0;10;1;9;10;0;3;4;3
9770; 19.8 ; 99.2 ; 5.6 ;5;47;68;0;5;1;4;0;5;5;0;0
9771; 24.6 ; 98.3 ; 9.8 ;4;30;62;0;4;1;3;2;2;3;1;0
9772; 28.6 ; 114.3 ; 17.4 ;4;36;257;0;4;0;4;1;3;3;1;0
9773; 103.8 ; 207.6 ; 60.2 ;2;26;241;0;2;0;2;0;2;0;0;2
9774; 30.0 ; 60.1 ; -   ;2;19;8;0;2;2;0;2;0;0;2;0
9775; 24.9 ; 49.9 ; 7.9 ;2;5;233;0;2;1;1;2;0;1;1;0
9776; 28.5 ; 170.8 ; 11.3 ;6;16;74;0;6;4;2;4;2;4;2;0
9777; 17.1 ; 120.0 ; 3.8 ;7;17;5;0;7;1;6;4;3;7;0;0
9778; 47.0 ; 234.9 ; 0.4 ;5;26;68;0;5;0;5;3;2;0;5;0
9779; 18.6 ; 92.9 ; 9.3 ;5;28;36;0;5;0;5;2;3;5;0;0
9780; 51.7 ; 258.5 ; 11.0 ;5;36;21;0;5;2;3;3;2;0;3;2
9781; 47.9 ; 95.9 ; 6.5 ;2;246;74;1;1;0;2;1;1;0;2;0
9782; 31.0 ; 93.1 ; 16.5 ;3;32;235;0;3;2;1;2;1;1;2;0
9783; 77.8 ; 233.4 ; 51.7 ;3;61;257;0;3;1;2;2;1;1;0;2
9784; 50.3 ; 201.3 ; 20.9 ;4;50;136;0;4;1;3;4;0;1;2;1
9785; 74.1 ; 444.6 ; 15.3 ;6;79;15;1;5;0;6;4;2;0;0;6
9786; 35.5 ; 248.2 ; 5.9 ;7;25;11;0;7;0;7;6;1;2;5;0
9787; 33.7 ; 67.4 ; 23.5 ;2;49;101;0;2;0;2;0;2;1;0;1
9788; 41.7 ; 125.1 ; 10.6 ;3;94;69;0;3;0;3;2;1;0;3;0
9789; 39.4 ; 118.3 ; 26.4 ;3;7;94;0;3;2;1;0;3;1;1;1
9790; 43.6 ; 130.7 ; 13.4 ;3;177;17;1;2;2;1;2;1;0;2;1
9791; 20.6 ; 144.5 ; 8.7 ;7;19;170;0;7;3;4;4;3;7;0;0
9792; 63.9 ; 127.7 ; 24.5 ;2;29;69;1;1;0;2;2;0;0;0;2
9793; 17.3 ; 51.9 ; 3.5 ;3;29;7;1;2;3;0;1;2;3;0;0
9794; 34.1 ; 102.2 ; -   ;3;5;122;0;3;3;0;3;0;0;3;0
9795; 21.0 ; 83.8 ; 5.0 ;4;16;113;0;4;3;1;1;3;4;0;0
9796; 71.8 ; 143.6 ; -   ;2;197;197;0;2;1;1;0;2;0;0;2
9797; 39.5 ; 237.0 ; 9.4 ;6;12;32;0;6;0;6;1;5;0;6;0
9798; 25.1 ; 50.1 ; -   ;2;14;75;1;1;2;0;1;1;2;0;0
9799; 21.0 ; 105.2 ; 5.9 ;5;32;284;0;5;2;3;1;4;5;0;0
9800; 66.2 ; 132.4 ; 20.0 ;2;107;73;0;2;0;2;1;1;0;0;2
9801; 48.3 ; 676.5 ; 8.9 ;14;24;26;0;14;3;11;12;2;0;9;5
9802; 32.6 ; 130.5 ; 15.0 ;4;46;101;0;4;1;3;1;3;1;3;0
9803; 30.4 ; 213.1 ; 14.2 ;7;37;14;0;7;1;6;3;4;2;5;0
9804; 49.2 ; 1,279.4 ; 5.1 ;26;9;3;0;26;4;22;11;15;0;26;0
9805; 32.3 ; 64.5 ; 25.9 ;2;1;261;0;2;1;1;0;2;1;0;1
9806; 45.3 ; 181.2 ; 17.5 ;4;65;226;0;4;0;4;2;2;1;2;1
9807; 20.0 ; 40.1 ; 7.6 ;2;148;146;0;2;1;1;1;1;2;0;0
9808; 62.3 ; 249.0 ; 23.8 ;4;32;125;0;4;0;4;4;0;0;0;4
9809; 48.2 ; 1,011.9 ; 7.4 ;21;14;9;0;21;9;12;7;14;0;14;7
9810; 61.7 ; 123.4 ; 15.2 ;2;1;254;0;2;2;0;2;0;0;0;2
9811; 47.9 ; 814.3 ; 18.8 ;17;9;20;0;17;3;14;7;10;6;5;6
9812; 47.8 ; 95.7 ; 0.5 ;2;29;17;0;2;1;1;0;2;0;2;0
9813; 35.6 ; 71.1 ; 8.0 ;2;12;128;0;2;2;0;0;2;1;1;0
9814; 26.4 ; 79.2 ; 10.6 ;3;60;163;0;3;1;2;0;3;2;1;0
9815; 32.6 ; 163.1 ; 9.1 ;5;51;68;0;5;3;2;2;3;2;3;0
9816; 18.3 ; 55.0 ; 6.2 ;3;9;9;0;3;2;1;1;2;3;0;0
9817; 37.2 ; 74.5 ; 1.0 ;2;152;250;0;2;1;1;1;1;0;2;0
9818; 36.2 ; 144.9 ; 9.6 ;4;81;47;0;4;1;3;3;1;1;3;0
9819; 23.0 ; 68.9 ; 6.4 ;3;22;233;0;3;2;1;2;1;3;0;0
9820; 15.0 ; 30.0 ; -   ;2;19;28;0;2;2;0;2;0;2;0;0
9821; 52.8 ; 369.3 ; 1.5 ;7;44;10;0;7;1;6;5;2;0;7;0
9822; 15.3 ; 76.4 ; -   ;5;6;53;0;5;3;2;4;1;5;0;0
9823; 32.2 ; 580.2 ; 17.6 ;18;23;47;0;18;4;14;9;9;6;12;0
9824; 91.1 ; 182.1 ; 5.8 ;2;16;85;0;2;0;2;1;1;0;0;2
9825; 48.8 ; 146.3 ; 10.3 ;3;70;73;0;3;1;2;3;0;0;2;1
9826; 94.3 ; 282.9 ; 41.1 ;3;209;40;0;3;1;2;3;0;0;0;3
9827; 20.4 ; 61.1 ; 5.4 ;3;5;86;0;3;2;1;1;2;3;0;0
9828; 15.0 ; 45.0 ; -   ;3;72;33;0;3;2;1;1;2;3;0;0
9829; 69.7 ; 278.8 ; 33.0 ;4;83;83;0;4;1;3;3;1;0;0;4
9830; 49.4 ; 444.8 ; 28.0 ;9;21;71;0;9;6;3;7;2;3;3;3
9831; 20.6 ; 82.6 ; 15.4 ;4;32;93;0;4;4;0;1;3;3;1;0
9832; 39.9 ; 199.7 ; 17.7 ;5;82;33;0;5;3;2;4;1;2;1;2
9833; 46.6 ; 373.2 ; 8.8 ;8;29;47;0;8;0;8;7;1;0;5;3
9834; 25.0 ; 50.0 ; 15.0 ;2;45;147;0;2;0;2;0;2;1;1;0
9835; 54.2 ; 162.6 ; 10.2 ;3;19;52;0;3;0;3;3;0;0;2;1
9836; 20.4 ; 81.6 ; 11.4 ;4;81;18;0;4;3;1;3;1;3;1;0
9837; 38.8 ; 77.6 ; 20.5 ;2;75;152;0;2;0;2;0;2;1;0;1
9838; 26.2 ; 78.7 ; 20.6 ;3;145;68;0;3;1;2;1;2;2;1;0
9839; 22.4 ; 44.7 ; 4.0 ;2;2;299;0;2;1;1;1;1;2;0;0
9840; 51.9 ; 103.9 ; 7.8 ;2;157;158;1;1;0;2;2;0;0;1;1
9841; 19.7 ; 275.7 ; 11.5 ;14;17;5;0;14;2;12;10;4;9;5;0
9842; 44.8 ; 89.6 ; -   ;2;8;163;0;2;1;1;2;0;0;2;0
9843; 62.1 ; 124.3 ; 8.0 ;2;6;189;0;2;0;2;2;0;0;0;2
9844; 27.4 ; 82.3 ; 12.3 ;3;21;275;0;3;1;2;1;2;2;1;0
9845; 22.6 ; 293.8 ; 13.3 ;13;23;45;0;13;10;3;6;7;9;4;0
9846; 36.8 ; 183.8 ; 14.4 ;5;50;47;0;5;2;3;1;4;2;3;0
9847; 57.9 ; 173.7 ; 16.9 ;3;49;137;0;3;2;1;1;2;0;0;3
9848; 48.1 ; 96.1 ; 0.9 ;2;48;99;0;2;1;1;2;0;0;2;0
9849; 63.2 ; 189.7 ; -   ;3;25;131;0;3;0;3;1;2;0;0;3
9850; 15.0 ; 30.0 ; -   ;2;55;48;0;2;0;2;1;1;2;0;0
9851; 41.2 ; 370.6 ; 13.8 ;9;23;56;0;9;6;3;5;4;3;6;0
9852; 27.8 ; 139.0 ; 19.1 ;5;40;89;0;5;3;2;2;3;3;2;0
9853; 49.5 ; 99.0 ; 9.9 ;2;35;161;2;0;2;0;2;0;0;1;1
9854; 24.7 ; 49.4 ; 7.0 ;2;26;277;0;2;1;1;0;2;1;1;0
9855; 61.5 ; 246.2 ; 18.1 ;4;84;8;0;4;2;2;1;3;0;0;4
9856; 46.8 ; 140.3 ; -   ;3;59;161;0;3;2;1;3;0;0;3;0
9857; 50.6 ; 151.8 ; 59.8 ;3;77;103;1;2;2;1;1;2;1;1;1
9858; 53.1 ; 159.3 ; 27.2 ;3;5;20;0;3;1;2;2;1;1;1;1
9859; 22.5 ; 561.4 ; 12.4 ;25;9;6;0;25;15;10;15;10;17;8;0
9860; 49.6 ; 99.3 ; 4.3 ;2;36;217;0;2;1;1;2;0;0;2;0
9861; 25.1 ; 50.1 ; -   ;2;12;40;0;2;2;0;2;0;2;0;0
9862; 26.6 ; 53.2 ; 2.3 ;2;17;98;0;2;2;0;0;2;2;0;0
9863; 26.6 ; 159.3 ; 19.0 ;6;17;195;0;6;2;4;5;1;4;2;0
9864; 40.0 ; 119.9 ; 10.1 ;3;4;258;0;3;1;2;3;0;1;2;0
9865; 25.1 ; 75.2 ; -   ;3;31;92;0;3;1;2;2;1;3;0;0
9866; 28.9 ; 115.5 ; 13.0 ;4;111;97;0;4;3;1;4;0;3;1;0
9867; 23.5 ; 400.3 ; 16.5 ;17;17;0;0;17;3;14;8;9;11;6;0
9868; 32.9 ; 361.7 ; 40.2 ;11;17;32;0;11;2;9;6;5;4;3;4
9869; 37.9 ; 530.4 ; 11.8 ;14;17;1;0;14;7;7;11;3;5;9;0
9870; 28.1 ; 56.3 ; 4.6 ;2;58;251;0;2;0;2;1;1;1;1;0
9871; 36.8 ; 184.1 ; 18.3 ;5;62;57;0;5;2;3;4;1;2;1;2
9872; 42.5 ; 127.5 ; 16.0 ;3;19;56;0;3;2;1;1;2;1;1;1
9873; 74.5 ; 372.3 ; 35.7 ;5;17;335;0;5;1;4;3;2;0;0;5
9874; 23.9 ; 71.7 ; 5.8 ;3;140;147;0;3;2;1;1;2;3;0;0
9875; 40.1 ; 120.4 ; 29.3 ;3;99;53;0;3;1;2;1;2;1;1;1
9876; 46.8 ; 93.5 ; -   ;2;62;147;0;2;0;2;0;2;0;2;0
9877; 83.3 ; 166.7 ; 15.2 ;2;86;35;0;2;2;0;2;0;0;0;2
9878; 44.0 ; 220.2 ; 25.1 ;5;42;5;0;5;1;4;3;2;2;1;2
9879; 29.0 ; 174.2 ; 17.4 ;6;40;37;0;6;0;6;2;4;4;2;0
9880; 45.5 ; 182.1 ; 2.4 ;4;8;82;0;4;4;0;1;3;0;4;0
9881; 30.2 ; 60.4 ; -   ;2;5;283;0;2;0;2;2;0;0;2;0
9882; 55.5 ; 277.6 ; 17.6 ;5;45;47;0;5;0;5;3;2;0;0;5
9883; 47.5 ; 142.4 ; 0.8 ;3;68;2;1;2;1;2;1;2;0;3;0
9884; 56.3 ; 787.8 ; 17.6 ;14;14;0;0;14;1;13;3;11;0;0;14
9885; 29.1 ; 87.4 ; 12.4 ;3;74;179;0;3;2;1;0;3;2;1;0
9886; 30.2 ; 60.4 ; -   ;2;38;257;0;2;0;2;1;1;0;2;0
9887; 29.0 ; 145.2 ; 28.0 ;5;45;109;0;5;3;2;5;0;3;0;2
9888; 42.1 ; 294.5 ; 10.7 ;7;47;26;0;7;0;7;6;1;0;7;0
9889; 51.2 ; 307.5 ; 24.0 ;6;40;26;0;6;1;5;4;2;2;2;2
9890; 34.3 ; 68.5 ; 4.6 ;2;48;179;0;2;1;1;1;1;1;1;0
9891; 17.3 ; 207.4 ; 0.9 ;12;5;56;12;0;7;5;3;9;12;0;0
9892; 23.7 ; 71.2 ; 2.4 ;3;95;36;0;3;1;2;2;1;3;0;0
9893; 22.6 ; 45.2 ; 11.4 ;2;37;281;0;2;2;0;1;1;1;1;0
9894; 32.9 ; 65.8 ; 10.7 ;2;27;364;0;2;2;0;1;1;1;1;0
9895; 56.2 ; 281.1 ; 25.2 ;5;73;84;0;5;0;5;3;2;0;0;5
9896; 23.4 ; 210.8 ; 7.5 ;9;5;168;0;9;4;5;3;6;6;3;0
9897; 26.7 ; 186.9 ; 11.5 ;7;16;26;0;7;3;4;2;5;5;2;0
9898; 51.4 ; 154.1 ; 16.1 ;3;22;310;0;3;0;3;2;1;0;2;1
9899; 57.7 ; 115.4 ; 17.4 ;2;65;287;0;2;1;1;1;1;0;0;2
9900; 47.7 ; 95.5 ; 1.5 ;2;12;260;0;2;2;0;2;0;0;2;0
9901; 25.9 ; 129.5 ; 8.9 ;5;78;53;0;5;0;5;3;2;3;2;0
9902; 39.9 ; 199.4 ; 14.6 ;5;48;53;0;5;0;5;1;4;2;3;0
9903; 23.0 ; 69.0 ; 5.2 ;3;29;143;0;3;2;1;1;2;3;0;0
9904; 52.8 ; 105.7 ; 8.0 ;2;11;53;0;2;0;2;1;1;0;1;1
9905; 37.1 ; 111.3 ; 27.1 ;3;49;194;0;3;1;2;2;1;1;1;1
9906; 69.2 ; 138.4 ; 42.0 ;2;247;41;0;2;1;1;1;1;1;0;1
9907; 46.8 ; 93.5 ; -   ;2;126;162;0;2;0;2;2;0;0;2;0
9908; 19.7 ; 789.8 ; 7.2 ;40;7;3;0;40;12;28;8;32;40;0;0
9909; 34.2 ; 102.6 ; 16.8 ;3;24;113;0;3;1;2;2;1;1;2;0
9910; 49.6 ; 99.3 ; 4.3 ;2;4;268;0;2;1;1;0;2;0;2;0
9911; 39.1 ; 156.3 ; 17.6 ;4;68;100;0;4;3;1;1;3;1;2;1
9912; 25.6 ; 51.3 ; -   ;2;5;215;0;2;0;2;0;2;2;0;0
9913; 45.7 ; 182.6 ; 7.0 ;4;49;146;0;4;0;4;3;1;0;4;0
9914; 24.1 ; 530.3 ; 14.5 ;22;12;12;0;22;11;11;10;12;15;7;0
9915; 38.8 ; 77.6 ; 20.5 ;2;32;315;0;2;1;1;0;2;1;0;1
9916; 20.1 ; 60.2 ; 9.3 ;3;5;93;0;3;2;1;3;0;3;0;0
9917; 47.1 ; 94.1 ; 2.4 ;2;24;220;0;2;1;1;2;0;0;2;0
9918; 39.0 ; 77.9 ; 11.7 ;2;2;157;0;2;0;2;0;2;1;1;0
9919; 32.8 ; 131.3 ; 8.1 ;4;14;186;0;4;4;0;1;3;1;3;0
9920; 47.2 ; 141.7 ; 0.9 ;3;142;10;0;3;0;3;3;0;0;3;0
9921; 20.1 ; 60.2 ; 9.3 ;3;56;158;0;3;1;2;3;0;3;0;0
9922; 53.4 ; 213.6 ; 1.4 ;4;70;99;0;4;2;2;4;0;0;4;0
9923; 51.6 ; 103.2 ; 7.7 ;2;26;377;0;2;0;2;2;0;0;1;1
9924; 30.8 ; 61.7 ; 8.6 ;2;2;95;0;2;1;1;1;1;1;1;0
9925; 44.0 ; 88.0 ; 11.1 ;2;13;131;0;2;0;2;1;1;0;1;1
9926; 43.8 ; 526.1 ; 11.8 ;12;4;4;0;12;7;5;2;10;0;8;4
9927; 70.0 ; 350.1 ; 20.5 ;5;59;83;0;5;1;4;5;0;0;0;5
9928; 35.9 ; 71.8 ; 16.2 ;2;104;160;0;2;1;1;1;1;1;1;0
9929; 38.6 ; 308.9 ; 16.1 ;8;38;20;0;8;2;6;5;3;3;5;0
9930; 41.7 ; 125.1 ; 10.6 ;3;13;63;0;3;0;3;2;1;0;3;0
9931; 43.4 ; 955.8 ; 5.2 ;22;21;8;0;22;9;13;8;14;0;22;0
9932; 18.7 ; 1,102.8 ; 8.8 ;59;8;2;0;59;28;31;10;49;59;0;0
9933; 56.8 ; 113.7 ; -   ;2;5;26;2;0;0;2;2;0;0;0;2
9934; 15.0 ; 30.0 ; -   ;2;7;37;0;2;1;1;1;1;2;0;0
9935; 64.9 ; 324.4 ; 24.1 ;5;44;164;0;5;0;5;4;1;0;0;5
9936; 46.6 ; 139.8 ; 3.8 ;3;122;62;0;3;0;3;3;0;0;3;0
9937; 25.1 ; 50.1 ; -   ;2;120;146;0;2;0;2;2;0;2;0;0
9938; 41.1 ; 82.2 ; 11.3 ;2;41;136;0;2;1;1;2;0;1;1;0
9939; 53.4 ; 160.1 ; 1.8 ;3;40;200;0;3;2;1;1;2;0;2;1
9940; 75.2 ; 451.1 ; 28.4 ;6;41;26;2;4;0;6;5;1;0;0;6
9941; 50.6 ; 151.9 ; 5.2 ;3;32;19;0;3;1;2;1;2;0;2;1
9942; 36.8 ; 257.5 ; 12.1 ;7;14;182;0;7;1;6;3;4;2;5;0
9943; 33.0 ; 66.0 ; 27.0 ;2;111;21;0;2;1;1;0;2;1;0;1
9944; 30.1 ; 90.3 ; 5.3 ;3;18;98;3;0;3;0;1;2;1;2;0
9945; 79.9 ; 719.0 ; 20.1 ;9;35;89;0;9;1;8;9;0;0;0;9
9946; 30.6 ; 91.7 ; 18.9 ;3;16;208;0;3;3;0;1;2;1;2;0
9947; 26.0 ; 103.8 ; 9.0 ;4;36;91;0;4;3;1;1;3;3;1;0
9948; 21.5 ; 64.5 ; 2.4 ;3;11;277;0;3;3;0;0;3;3;0;0
9949; 46.8 ; 140.3 ; -   ;3;45;185;0;3;2;1;1;2;0;3;0
9950; 83.1 ; 249.4 ; 34.5 ;3;31;107;0;3;2;1;1;2;0;0;3
9951; 34.5 ; 69.0 ; 22.5 ;2;175;110;0;2;1;1;2;0;1;0;1
9952; 47.5 ; 94.9 ; -   ;2;4;29;0;2;2;0;1;1;0;2;0
9953; 49.4 ; 494.4 ; 27.6 ;10;32;22;0;10;3;7;6;4;3;4;3
9954; 36.8 ; 368.1 ; 16.3 ;10;11;80;0;10;5;5;5;5;3;7;0
9955; 61.5 ; 184.4 ; 3.9 ;3;69;84;0;3;0;3;3;0;0;0;3
9956; 78.3 ; 156.6 ; -   ;2;12;73;0;2;0;2;2;0;0;0;2
9957; 38.5 ; 115.4 ; 18.7 ;3;47;106;0;3;0;3;1;2;1;1;1
9958; 59.4 ; 297.1 ; 37.9 ;5;16;269;0;5;1;4;4;1;2;0;3
9959; 17.3 ; 69.0 ; 1.6 ;4;45;49;0;4;2;2;3;1;4;0;0
9960; 16.7 ; 116.8 ; 2.0 ;7;11;0;0;7;2;5;4;3;7;0;0
9961; 21.6 ; 862.6 ; 13.0 ;40;8;2;0;40;5;35;27;13;27;13;0
9962; 16.7 ; 50.0 ; 3.1 ;3;23;14;0;3;2;1;1;2;3;0;0
9963; 15.0 ; 74.9 ; -   ;5;58;70;3;2;3;2;5;0;5;0;0
9964; 24.7 ; 99.0 ; 10.1 ;4;93;17;0;4;3;1;4;0;3;1;0
9965; 27.6 ; 55.3 ; 3.8 ;2;70;235;0;2;1;1;2;0;1;1;0
9966; 15.0 ; 30.0 ; -   ;2;50;80;0;2;2;0;0;2;2;0;0
9967; 49.9 ; 199.5 ; 8.1 ;4;7;30;4;0;2;2;2;2;0;3;1
9968; 44.5 ; 178.1 ; 15.2 ;4;97;73;0;4;0;4;4;0;1;2;1
9969; 38.9 ; 466.9 ; 8.8 ;12;23;11;0;12;1;11;9;3;0;12;0
9970; 34.4 ; 377.9 ; 14.4 ;11;26;26;0;11;0;11;11;0;4;7;0
9971; 23.9 ; 47.8 ; 2.3 ;2;59;34;0;2;2;0;0;2;2;0;0
9972; 26.1 ; 104.3 ; 4.0 ;4;85;53;0;4;1;3;3;1;3;1;0
9973; 48.4 ; 435.8 ; 32.1 ;9;48;20;0;9;2;7;6;3;3;3;3
9974; 28.4 ; 85.1 ; 12.9 ;3;5;212;0;3;2;1;3;0;2;1;0
9975; 18.4 ; 184.1 ; 2.3 ;10;13;18;10;0;5;5;3;7;10;0;0
9976; 24.1 ; 337.4 ; 8.7 ;14;5;185;0;14;5;9;8;6;9;5;0
9977; 47.2 ; 377.4 ; 19.1 ;8;29;1;0;8;5;3;3;5;3;2;3
9978; 24.9 ; 274.3 ; 13.3 ;11;13;83;0;11;0;11;5;6;7;4;0
9979; 68.3 ; 341.5 ; 12.9 ;5;27;69;0;5;1;4;5;0;0;0;5
9980; 38.7 ; 77.4 ; 20.4 ;2;5;146;0;2;1;1;2;0;1;0;1
9981; 38.8 ; 77.7 ; 14.7 ;2;5;290;0;2;2;0;0;2;1;1;0
9982; 60.9 ; 121.9 ; 0.9 ;2;3;115;0;2;1;1;0;2;0;0;2
9983; 94.9 ; 189.9 ; 71.1 ;2;27;76;1;1;2;0;0;2;1;0;1
9984; 22.0 ; 132.1 ; 14.0 ;6;16;174;0;6;4;2;6;0;4;2;0
9985; 20.3 ; 40.6 ; 8.0 ;2;203;3;0;2;1;1;1;1;2;0;0
9986; 30.2 ; 90.6 ; -   ;3;41;90;3;0;2;1;3;0;0;3;0
9987; 71.2 ; 213.5 ; 43.5 ;3;58;33;0;3;1;2;3;0;1;0;2
9988; 22.8 ; 45.6 ; 0.2 ;2;94;6;0;2;0;2;2;0;2;0;0
9989; 15.0 ; 30.0 ; -   ;2;5;154;0;2;1;1;2;0;2;0;0
9990; 64.9 ; 194.7 ; 14.9 ;3;88;110;0;3;0;3;2;1;0;0;3
9991; 29.0 ; 58.1 ; 1.7 ;2;49;185;0;2;1;1;0;2;1;1;0
9992; 40.3 ; 201.4 ; 12.3 ;5;40;144;0;5;2;3;1;4;2;3;0
9993; 17.1 ; 34.2 ; 3.2 ;2;92;23;2;0;1;1;2;0;2;0;0
9994; 39.7 ; 158.6 ; 10.8 ;4;86;59;0;4;0;4;2;2;1;3;0
9995; 33.2 ; 66.4 ; 5.1 ;2;358;43;0;2;0;2;0;2;1;1;0
9996; 53.7 ; 268.3 ; 30.2 ;5;32;26;0;5;0;5;4;1;2;1;2
9997; 55.2 ; 110.4 ; 12.7 ;2;56;337;0;2;0;2;0;2;0;0;2
9998; 39.8 ; 517.4 ; 41.0 ;13;11;183;0;13;7;6;12;1;4;5;4
9999; 110.7 ; 221.4 ; 30.9 ;2;192;187;0;2;1;1;0;2;0;0;2
10000; 35.9 ; 71.8 ; 16.2 ;2;200;132;0;2;0;2;2;0;1;1;0
10001; 27.5 ; 55.0 ; 3.7 ;2;11;17;0;2;1;1;0;2;1;1;0
10002; 20.7 ; 620.9 ; 4.6 ;30;5;8;30;0;27;3;30;0;30;0;0
10003; 49.6 ; 99.3 ; 4.3 ;2;38;236;0;2;0;2;2;0;0;2;0
10004; 30.2 ; 60.4 ; -   ;2;17;144;0;2;1;1;0;2;0;2;0
10005; 39.6 ; 79.1 ; 12.9 ;2;1;15;2;0;0;2;0;2;1;1;0
10006; 31.6 ; 63.2 ; 24.9 ;2;306;9;0;2;2;0;1;1;1;0;1
10007; 48.6 ; 194.2 ; 2.9 ;4;103;10;0;4;0;4;2;2;0;4;0
10008; 48.7 ; 97.4 ; 15.5 ;2;3;272;0;2;1;1;1;1;0;1;1
10009; 27.4 ; 410.6 ; 13.8 ;15;14;94;0;15;11;4;2;13;10;5;0
10010; 47.1 ; 94.2 ; 0.5 ;2;232;80;0;2;2;0;0;2;0;2;0
10011; 63.1 ; 126.3 ; 20.7 ;2;107;94;0;2;0;2;1;1;0;0;2
10012; 50.0 ; 99.9 ; 2.6 ;2;28;18;0;2;1;1;1;1;0;2;0
10013; 48.2 ; 1,157.7 ; 15.6 ;24;4;182;0;24;11;13;18;6;0;16;8
10014; 26.7 ; 80.1 ; 13.4 ;3;85;169;0;3;0;3;1;2;2;1;0
10015; 51.3 ; 358.9 ; 3.9 ;7;44;74;0;7;1;6;3;4;0;5;2
10016; 38.8 ; 77.7 ; 12.9 ;2;55;49;2;0;1;1;1;1;1;1;0
10017; 33.5 ; 939.4 ; 30.2 ;28;9;49;0;28;27;1;28;0;9;10;9
10018; 41.1 ; 164.4 ; 8.2 ;4;5;219;0;4;1;3;4;0;0;4;0
10019; 33.0 ; 296.7 ; 11.4 ;9;24;5;0;9;5;4;8;1;3;6;0
10020; 38.5 ; 76.9 ; 12.4 ;2;12;162;2;0;0;2;2;0;1;1;0
10021; 17.2 ; 360.7 ; 4.5 ;21;9;26;0;21;6;15;16;5;21;0;0
10022; 32.8 ; 98.3 ; 17.2 ;3;19;262;0;3;0;3;1;2;1;2;0
10023; 39.0 ; 273.2 ; 16.2 ;7;3;233;0;7;6;1;3;4;2;3;2
10024; 26.7 ; 1,093.2 ; 14.6 ;41;7;34;0;41;18;23;21;20;27;14;0
10025; 53.6 ; 268.0 ; 7.0 ;5;39;115;0;5;0;5;4;1;0;3;2
10026; 59.3 ; 118.6 ; 18.8 ;2;104;161;0;2;1;1;0;2;0;0;2
10027; 35.4 ; 177.1 ; 15.5 ;5;6;237;0;5;1;4;3;2;2;3;0
10028; 38.5 ; 231.2 ; 17.2 ;6;16;200;0;6;2;4;1;5;2;2;2
10029; 85.3 ; 170.6 ; 91.0 ;2;71;106;0;2;1;1;0;2;1;0;1
10030; 71.1 ; 426.8 ; 22.2 ;6;24;160;0;6;0;6;3;3;0;0;6
10031; 38.4 ; 153.6 ; 9.4 ;4;13;318;0;4;4;0;2;2;1;3;0
10032; 39.5 ; 197.7 ; 21.2 ;5;32;132;0;5;0;5;1;4;2;1;2
10033; 67.3 ; 470.9 ; 32.5 ;7;32;62;0;7;0;7;5;2;0;0;7
10034; 42.0 ; 84.1 ; 8.1 ;2;65;45;0;2;1;1;2;0;0;2;0
10035; 48.6 ; 97.2 ; -   ;2;50;225;0;2;0;2;2;0;0;2;0
10036; 26.1 ; 130.3 ; 11.1 ;5;11;278;0;5;0;5;4;1;3;2;0
10037; 65.4 ; 130.8 ; 16.6 ;2;5;301;0;2;1;1;0;2;0;0;2
10038; 23.1 ; 46.2 ; 3.0 ;2;24;84;0;2;0;2;2;0;2;0;0
10039; 68.9 ; 137.7 ; 24.8 ;2;62;216;0;2;0;2;1;1;0;0;2
10040; 27.8 ; 139.0 ; 6.5 ;5;76;10;0;5;1;4;4;1;3;2;0
10041; 17.9 ; 35.8 ; 0.2 ;2;224;28;0;2;1;1;0;2;2;0;0
10042; 43.4 ; 520.4 ; 9.0 ;12;15;4;0;12;1;11;4;8;0;12;0
10043; 31.0 ; 124.1 ; 7.9 ;4;29;179;0;4;0;4;4;0;1;3;0
10044; 56.4 ; 225.6 ; 14.4 ;4;28;32;0;4;3;1;4;0;0;0;4
10045; 65.8 ; 328.8 ; 11.4 ;5;91;3;0;5;2;3;3;2;0;0;5
10046; 38.3 ; 1,800.1 ; 12.1 ;47;7;2;0;47;28;19;18;29;16;31;0
10047; 25.9 ; 155.3 ; 7.9 ;6;10;45;6;0;3;3;0;6;4;2;0
10048; 21.2 ; 616.0 ; 8.4 ;29;6;11;0;29;12;17;21;8;29;0;0
10049; 51.8 ; 155.5 ; 20.6 ;3;50;238;0;3;3;0;1;2;0;2;1
10050; 51.8 ; 414.3 ; 22.5 ;8;41;11;0;8;3;5;1;7;3;2;3
10051; 49.6 ; 99.1 ; -   ;2;4;227;0;2;0;2;2;0;0;2;0
10052; 27.6 ; 55.3 ; 3.8 ;2;24;178;0;2;0;2;0;2;1;1;0
10053; 44.9 ; 404.4 ; 11.8 ;9;16;2;0;9;6;3;5;4;0;6;3
10054; 36.7 ; 183.3 ; 14.3 ;5;40;20;0;5;2;3;3;2;2;3;0
10055; 27.7 ; 55.3 ; 19.0 ;2;19;246;0;2;0;2;1;1;1;1;0
10056; 47.7 ; 95.5 ; 1.5 ;2;5;268;0;2;1;1;0;2;0;2;0
10057; 40.3 ; 201.3 ; 8.0 ;5;19;148;0;5;3;2;1;4;0;5;0
10058; 30.7 ; 61.4 ; 0.7 ;2;18;165;0;2;2;0;0;2;1;1;0
10059; 27.1 ; 81.3 ; 3.7 ;3;72;31;0;3;0;3;2;1;2;1;0
10060; 28.9 ; 57.9 ; 20.9 ;2;31;241;0;2;1;1;1;1;1;1;0
10061; 30.9 ; 92.8 ; 5.5 ;3;28;31;0;3;1;2;1;2;1;2;0
10062; 64.7 ; 258.8 ; 31.0 ;4;79;13;4;0;4;0;3;1;0;0;4
10063; 49.2 ; 98.3 ; 20.3 ;2;1;194;0;2;0;2;0;2;1;0;1
10064; 47.2 ; 377.3 ; 1.2 ;8;23;0;0;8;0;8;8;0;0;8;0
10065; 28.4 ; 113.5 ; 7.0 ;4;24;228;0;4;2;2;1;3;3;1;0
10066; 22.0 ; 65.9 ; 8.1 ;3;29;27;1;2;1;2;1;2;2;1;0
10067; 22.8 ; 136.6 ; 9.7 ;6;46;100;0;6;3;3;1;5;4;2;0
10068; 44.7 ; 268.4 ; 17.7 ;6;42;10;0;6;2;4;4;2;2;2;2
10069; 31.3 ; 93.8 ; 14.6 ;3;47;160;0;3;3;0;1;2;1;2;0
10070; 30.2 ; 60.4 ; -   ;2;6;137;0;2;0;2;2;0;0;2;0
10071; 15.0 ; 45.0 ; -   ;3;173;37;0;3;0;3;1;2;3;0;0
10072; 28.0 ; 84.0 ; 21.2 ;3;8;107;0;3;1;2;2;1;2;1;0
10073; 48.5 ; 242.3 ; 19.5 ;5;39;102;0;5;2;3;3;2;2;1;2
10074; 47.1 ; 94.2 ; 0.5 ;2;180;99;0;2;1;1;1;1;0;2;0
10075; 36.6 ; 183.1 ; 12.4 ;5;37;10;2;3;2;3;4;1;2;3;0
10076; 16.6 ; 99.4 ; 4.4 ;6;23;36;0;6;2;4;3;3;6;0;0
10077; 18.6 ; 37.2 ; 1.2 ;2;61;222;0;2;1;1;1;1;2;0;0
10078; 25.2 ; 75.6 ; 7.9 ;3;45;130;0;3;1;2;2;1;2;1;0
10079; 19.7 ; 39.5 ; -   ;2;7;232;0;2;1;1;2;0;2;0;0
10080; 48.5 ; 97.0 ; 11.4 ;2;72;108;2;0;1;1;1;1;0;1;1
10081; 30.2 ; 90.6 ; -   ;3;14;239;0;3;2;1;1;2;0;3;0
10082; 16.7 ; 133.2 ; 5.3 ;8;23;122;1;7;6;2;3;5;8;0;0
10083; 24.6 ; 418.8 ; 10.9 ;17;19;8;0;17;6;11;5;12;11;6;0
10084; 33.0 ; 66.0 ; 4.2 ;2;225;71;0;2;2;0;0;2;1;1;0
10085; 65.4 ; 392.3 ; 5.9 ;6;45;21;0;6;1;5;0;6;0;0;6
10086; 24.0 ; 48.0 ; 8.9 ;2;5;110;1;1;0;2;0;2;1;1;0
10087; 27.8 ; 111.0 ; 5.7 ;4;31;224;0;4;4;0;4;0;3;1;0
10088; 47.6 ; 142.7 ; 17.3 ;3;81;2;0;3;2;1;1;2;0;2;1
10089; 70.2 ; 140.4 ; 18.4 ;2;94;74;0;2;0;2;1;1;0;0;2
10090; 16.5 ; 231.6 ; 3.9 ;14;21;0;0;14;0;14;1;13;14;0;0
10091; 124.5 ; 747.1 ; 73.1 ;6;37;32;6;0;2;4;6;0;0;0;6
10092; 18.0 ; 90.1 ; 7.2 ;5;31;126;0;5;1;4;4;1;5;0;0
10093; 46.9 ; 187.4 ; 39.5 ;4;13;89;0;4;1;3;2;2;1;2;1
10094; 47.8 ; 95.7 ; 0.5 ;2;27;7;0;2;2;0;0;2;0;2;0
10095; 74.7 ; 224.2 ; 45.5 ;3;41;20;0;3;0;3;2;1;1;0;2
10096; 39.9 ; 518.9 ; 11.2 ;13;24;17;0;13;6;7;11;2;4;9;0
10097; 34.7 ; 69.4 ; 14.5 ;2;2;266;0;2;1;1;2;0;1;1;0
10098; 54.3 ; 163.0 ; 8.1 ;3;40;179;0;3;2;1;1;2;0;2;1
10099; 29.7 ; 416.1 ; 21.7 ;14;19;26;0;14;0;14;12;2;9;5;0
10100; 33.3 ; 66.6 ; 11.4 ;2;50;94;1;1;0;2;1;1;1;1;0
10101; 36.9 ; 73.8 ; 17.7 ;2;9;288;0;2;1;1;0;2;1;1;0
10102; 35.5 ; 106.4 ; 14.3 ;3;40;206;0;3;1;2;1;2;1;2;0
10103; 48.6 ; 97.2 ; -   ;2;24;110;0;2;0;2;1;1;0;2;0
10104; 26.2 ; 52.4 ; 12.3 ;2;162;65;2;0;1;1;2;0;1;1;0
10105; 25.8 ; 361.3 ; 10.5 ;14;20;1;0;14;4;10;8;6;9;5;0
10106; 47.1 ; 94.2 ; 0.5 ;2;188;52;1;1;0;2;2;0;0;2;0
10107; 32.7 ; 163.5 ; 10.7 ;5;67;51;0;5;3;2;1;4;2;3;0
10108; 26.3 ; 131.5 ; 2.3 ;5;41;134;0;5;2;3;5;0;5;0;0
10109; 32.9 ; 98.8 ; 14.4 ;3;76;147;0;3;0;3;1;2;1;2;0
10110; 48.3 ; 144.9 ; 42.6 ;3;33;34;0;3;1;2;1;2;1;1;1
10111; 84.6 ; 592.1 ; 18.5 ;7;47;5;0;7;0;7;7;0;0;0;7
10112; 33.4 ; 66.8 ; 4.8 ;2;94;58;0;2;0;2;1;1;1;1;0
10113; 25.1 ; 75.2 ; -   ;3;31;194;0;3;0;3;0;3;3;0;0
10114; 22.2 ; 575.9 ; 4.3 ;26;14;4;0;26;5;21;11;15;26;0;0
10115; 70.1 ; 140.1 ; 40.7 ;2;5;146;0;2;1;1;2;0;1;0;1
10116; 52.5 ; 262.5 ; 29.7 ;5;77;3;0;5;1;4;2;3;2;1;2
10117; 54.5 ; 108.9 ; 7.3 ;2;20;236;0;2;1;1;0;2;0;1;1
10118; 39.1 ; 78.2 ; 16.5 ;2;12;17;0;2;0;2;1;1;1;0;1
10119; 31.8 ; 95.4 ; 14.6 ;3;79;122;0;3;3;0;3;0;1;2;0
10120; 27.0 ; 134.9 ; 2.2 ;5;56;34;0;5;3;2;5;0;5;0;0
10121; 55.2 ; 110.4 ; 12.6 ;2;137;117;0;2;1;1;2;0;0;0;2
10122; 30.9 ; 61.7 ; 23.8 ;2;22;260;0;2;1;1;2;0;1;1;0
10123; 37.0 ; 148.0 ; 8.7 ;4;14;230;0;4;3;1;2;2;1;3;0
10124; 53.6 ; 214.4 ; 4.8 ;4;105;32;0;4;2;2;0;4;0;3;1
10125; 50.5 ; 252.4 ; 1.8 ;5;41;99;0;5;1;4;3;2;0;5;0
10126; 56.6 ; 169.7 ; 20.4 ;3;119;28;0;3;3;0;1;2;0;0;3
10127; 41.4 ; 207.0 ; 8.1 ;5;50;157;0;5;1;4;4;1;0;5;0
10128; 36.6 ; 109.8 ; -   ;3;13;146;3;0;0;3;3;0;0;3;0
10129; 30.6 ; 61.2 ; 14.2 ;2;264;27;0;2;0;2;1;1;1;1;0
10130; 54.8 ; 219.1 ; 4.8 ;4;55;117;0;4;2;2;3;1;0;3;1
10131; 36.6 ; 109.9 ; 19.9 ;3;173;5;0;3;1;2;3;0;1;1;1
10132; 62.2 ; 124.4 ; 23.1 ;2;69;95;0;2;0;2;2;0;0;0;2
10133; 42.9 ; 171.5 ; 8.0 ;4;37;295;0;4;0;4;1;3;0;4;0
10134; 54.1 ; 108.1 ; 4.6 ;2;39;131;0;2;0;2;2;0;0;1;1
10135; 15.0 ; 30.0 ; -   ;2;338;0;0;2;1;1;0;2;2;0;0
10136; 24.8 ; 720.5 ; 7.4 ;29;11;10;0;29;14;15;12;17;19;10;0
10137; 64.6 ; 387.6 ; 21.9 ;6;50;21;0;6;0;6;5;1;0;0;6
10138; 50.0 ; 100.0 ; 3.8 ;2;31;95;0;2;0;2;1;1;0;2;0
10139; 59.9 ; 838.0 ; 19.5 ;14;17;0;14;0;6;8;6;8;0;0;14
10140; 51.3 ; 256.7 ; 26.2 ;5;18;297;0;5;3;2;3;2;2;1;2
10141; 15.0 ; 45.0 ; -   ;3;31;187;0;3;1;2;3;0;3;0;0
10142; 36.2 ; 181.0 ; 11.3 ;5;19;83;0;5;3;2;2;3;2;3;0
10143; 25.3 ; 101.0 ; 12.9 ;4;75;49;0;4;2;2;3;1;3;1;0
10144; 35.0 ; 280.0 ; 14.8 ;8;32;73;0;8;1;7;1;7;3;5;0
10145; 33.7 ; 134.9 ; 2.6 ;4;36;14;0;4;4;0;1;3;0;4;0
10146; 31.8 ; 127.4 ; 8.9 ;4;43;152;0;4;0;4;4;0;1;3;0
10147; 61.7 ; 185.2 ; 54.5 ;3;84;173;0;3;2;1;3;0;1;0;2
10148; 19.4 ; 58.2 ; 8.1 ;3;5;38;0;3;2;1;1;2;3;0;0
10149; 20.6 ; 576.4 ; 5.8 ;28;12;0;1;27;14;14;3;25;28;0;0
10150; 20.9 ; 188.4 ; 6.9 ;9;30;6;0;9;0;9;2;7;9;0;0
10151; 59.7 ; 358.1 ; 13.0 ;6;37;110;0;6;0;6;2;4;0;0;6
10152; 22.4 ; 44.7 ; 4.0 ;2;2;112;2;0;2;0;0;2;2;0;0
10153; 19.4 ; 445.5 ; 4.9 ;23;9;33;0;23;11;12;4;19;23;0;0
10154; 25.9 ; 51.7 ; -   ;2;5;225;0;2;0;2;0;2;2;0;0
10155; 27.6 ; 55.3 ; 3.8 ;2;285;40;0;2;1;1;0;2;1;1;0
10156; 17.3 ; 207.7 ; 6.0 ;12;9;279;0;12;7;5;12;0;12;0;0
10157; 27.6 ; 55.3 ; 3.8 ;2;82;217;1;1;2;0;2;0;1;1;0
10158; 15.0 ; 45.0 ; -   ;3;32;91;0;3;3;0;1;2;3;0;0
10159; 100.6 ; 301.7 ; 49.9 ;3;5;27;0;3;1;2;0;3;0;0;3
10160; 41.1 ; 164.6 ; 8.3 ;4;134;37;0;4;2;2;1;3;0;4;0
10161; 54.6 ; 272.8 ; 25.1 ;5;55;99;0;5;0;5;5;0;2;1;2
10162; 46.4 ; 231.8 ; 23.1 ;5;83;18;0;5;2;3;1;4;2;1;2
10163; 15.0 ; 209.8 ; -   ;14;2;2;0;14;8;6;2;12;14;0;0
10164; 58.3 ; 524.7 ; 11.7 ;9;34;10;0;9;0;9;3;6;0;0;9
10165; 62.4 ; 124.8 ; 1.3 ;2;73;212;0;2;1;1;1;1;0;0;2
10166; 38.3 ; 76.7 ; 34.9 ;2;38;89;0;2;0;2;0;2;1;0;1
10167; 36.6 ; 73.2 ; -   ;2;4;230;0;2;1;1;1;1;0;2;0
10168; 34.3 ; 68.6 ; 13.9 ;2;37;15;0;2;0;2;1;1;1;1;0
10169; 37.9 ; 379.2 ; 17.7 ;10;27;47;0;10;6;4;7;3;3;4;3
10170; 43.1 ; 129.4 ; 5.7 ;3;31;341;0;3;1;2;1;2;0;3;0
10171; 42.1 ; 210.4 ; 12.3 ;5;79;2;0;5;2;3;1;4;2;3;0
10172; 46.8 ; 140.3 ; -   ;3;22;178;0;3;0;3;3;0;0;3;0
10173; 38.6 ; 115.7 ; 20.3 ;3;9;8;1;2;2;1;2;1;1;1;1
10174; 85.7 ; 171.4 ; 18.8 ;2;20;368;0;2;1;1;2;0;0;0;2
10175; 45.4 ; 136.3 ; 20.9 ;3;16;182;0;3;2;1;2;1;1;1;1
10176; 27.2 ; 54.4 ; 3.7 ;2;32;302;0;2;2;0;2;0;1;1;0
10177; 25.6 ; 76.7 ; 11.4 ;3;13;247;0;3;0;3;1;2;2;1;0
10178; 15.0 ; 30.0 ; -   ;2;5;182;0;2;2;0;2;0;2;0;0
10179; 28.1 ; 224.9 ; 11.2 ;8;59;11;0;8;1;7;3;5;5;3;0
10180; 31.0 ; 93.0 ; 9.9 ;3;13;86;3;0;3;0;1;2;1;2;0
10181; 59.3 ; 237.3 ; 19.7 ;4;40;0;0;4;0;4;4;0;0;0;4
10182; 50.5 ; 101.0 ; 1.6 ;2;14;107;2;0;2;0;0;2;0;2;0
10183; 17.6 ; 35.2 ; 2.6 ;2;88;121;0;2;0;2;2;0;2;0;0
10184; 26.8 ; 322.1 ; 9.4 ;12;26;5;0;12;7;5;3;9;8;4;0
10185; 68.7 ; 343.3 ; 34.6 ;5;38;36;0;5;0;5;5;0;0;0;5
10186; 25.5 ; 255.0 ; 15.6 ;10;23;99;0;10;4;6;6;4;7;3;0
10187; 19.6 ; 255.1 ; 7.1 ;13;32;6;0;13;8;5;9;4;13;0;0
10188; 26.5 ; 265.1 ; 10.7 ;10;41;24;0;10;7;3;8;2;7;3;0
10189; 30.0 ; 60.0 ; 20.1 ;2;3;47;0;2;1;1;1;1;1;1;0
10190; 64.1 ; 192.3 ; 11.1 ;3;47;126;0;3;0;3;2;1;0;0;3
10191; 58.2 ; 174.7 ; 5.7 ;3;27;48;0;3;1;2;1;2;0;0;3
10192; 54.6 ; 109.1 ; 28.6 ;2;17;362;0;2;0;2;2;0;1;0;1
10193; 140.7 ; 703.7 ; 73.7 ;5;33;83;0;5;1;4;3;2;0;0;5
10194; 39.5 ; 434.9 ; 15.4 ;11;22;0;0;11;1;10;5;6;4;7;0
10195; 34.7 ; 173.7 ; 14.4 ;5;56;5;0;5;1;4;5;0;2;3;0
10196; 32.7 ; 65.3 ; 21.1 ;2;150;213;0;2;2;0;1;1;1;1;0
10197; 22.9 ; 68.6 ; 5.4 ;3;63;152;0;3;0;3;2;1;3;0;0
10198; 25.3 ; 126.7 ; 2.6 ;5;23;154;0;5;2;3;4;1;5;0;0
10199; 38.1 ; 152.3 ; 10.6 ;4;23;13;0;4;1;3;2;2;1;3;0
10200; 15.0 ; 30.0 ; -   ;2;1;20;2;0;0;2;0;2;2;0;0
10201; 29.4 ; 88.2 ; 13.2 ;3;7;41;0;3;1;2;1;2;2;1;0
10202; 59.1 ; 118.1 ; 15.0 ;2;114;209;0;2;0;2;2;0;0;0;2
10203; 27.6 ; 55.3 ; 3.8 ;2;5;235;0;2;2;0;2;0;1;1;0
10204; 69.8 ; 139.7 ; 34.6 ;2;10;389;0;2;0;2;2;0;0;0;2
10205; 30.4 ; 485.8 ; 9.4 ;16;13;6;0;16;0;16;11;5;5;11;0
10206; 57.2 ; 286.1 ; 32.8 ;5;42;9;0;5;5;0;4;1;2;0;3
10207; 23.3 ; 116.5 ; 7.4 ;5;32;287;0;5;2;3;5;0;3;2;0
10208; 36.1 ; 180.6 ; 12.9 ;5;58;26;0;5;3;2;5;0;2;3;0
10209; 45.4 ; 272.2 ; 14.5 ;6;41;173;0;6;2;4;0;6;0;4;2
10210; 47.1 ; 94.2 ; 0.5 ;2;132;31;1;1;0;2;2;0;0;2;0
10211; 26.5 ; 212.3 ; 14.9 ;8;34;10;0;8;3;5;3;5;5;3;0
10212; 32.2 ; 128.9 ; 9.6 ;4;108;73;0;4;1;3;4;0;1;3;0
10213; 31.8 ; 190.8 ; 4.6 ;6;4;42;6;0;2;4;2;4;2;4;0
10214; 47.0 ; 281.8 ; 12.6 ;6;14;70;0;6;5;1;3;3;0;4;2
10215; 55.8 ; 223.2 ; 30.9 ;4;15;3;0;4;1;3;3;1;1;0;3
10216; 35.9 ; 215.4 ; 12.4 ;6;20;15;0;6;3;3;1;5;2;4;0
10217; 54.8 ; 1,314.6 ; 17.3 ;24;17;4;0;24;3;21;3;21;0;16;8
10218; 26.5 ; 476.7 ; 9.0 ;18;14;12;0;18;4;14;10;8;12;6;0
10219; 47.1 ; 282.6 ; 36.6 ;6;59;11;0;6;1;5;3;3;2;2;2
10220; 26.5 ; 238.8 ; 16.8 ;9;42;5;0;9;3;6;1;8;6;3;0
10221; 47.1 ; 94.2 ; 0.5 ;2;116;46;0;2;2;0;1;1;0;2;0
10222; 46.9 ; 93.9 ; 0.3 ;2;24;236;0;2;0;2;2;0;0;2;0
10223; 24.5 ; 563.0 ; 12.5 ;23;10;70;0;23;13;10;12;11;15;8;0
10224; 43.6 ; 479.7 ; 12.5 ;11;27;5;0;11;6;5;10;1;0;7;4
10225; 20.0 ; 59.9 ; 9.2 ;3;67;68;2;1;1;2;2;1;3;0;0
10226; 42.8 ; 171.2 ; 8.4 ;4;121;1;0;4;2;2;2;2;0;4;0
10227; 50.9 ; 152.6 ; 4.1 ;3;56;121;0;3;0;3;3;0;0;3;0
10228; 18.3 ; 55.0 ; 6.2 ;3;5;4;0;3;3;0;3;0;3;0;0
10229; 38.5 ; 192.3 ; 27.7 ;5;21;257;0;5;1;4;3;2;2;1;2
10230; 21.4 ; 42.9 ; 5.4 ;2;98;122;0;2;1;1;0;2;2;0;0
10231; 15.8 ; 31.7 ; -   ;2;5;146;0;2;2;0;2;0;2;0;0
10232; 66.8 ; 333.9 ; 15.1 ;5;31;35;0;5;3;2;1;4;0;0;5
10233; 30.2 ; 120.7 ; -   ;4;23;77;0;4;3;1;1;3;0;4;0
10234; 36.8 ; 110.4 ; 20.0 ;3;23;246;0;3;0;3;3;0;1;1;1
10235; 71.4 ; 857.2 ; 32.1 ;12;12;5;0;12;0;12;8;4;0;0;12
10236; 112.8 ; 1,014.8 ; 37.5 ;9;41;5;0;9;1;8;8;1;0;0;9
10237; 22.5 ; 44.9 ; 11.2 ;2;33;214;0;2;1;1;1;1;1;1;0
10238; 51.9 ; 311.3 ; 18.6 ;6;23;5;0;6;0;6;3;3;0;4;2
10239; 20.6 ; 103.2 ; 3.0 ;5;43;10;0;5;1;4;4;1;5;0;0
10240; 60.0 ; 120.1 ; 19.9 ;2;131;120;0;2;0;2;1;1;0;0;2
10241; 18.9 ; 75.7 ; 5.2 ;4;31;200;0;4;2;2;3;1;4;0;0
10242; 53.8 ; 1,667.4 ; 13.7 ;31;10;6;0;31;7;24;19;12;0;21;10
10243; 30.9 ; 432.8 ; 14.9 ;14;9;238;0;14;10;4;14;0;5;9;0
10244; 40.7 ; 162.9 ; 17.9 ;4;119;36;0;4;2;2;1;3;1;2;1
10245; 52.5 ; 262.6 ; -   ;5;19;307;0;5;2;3;3;2;0;5;0
10246; 35.3 ; 70.5 ; 25.8 ;2;49;167;0;2;1;1;1;1;1;0;1
10247; 48.1 ; 240.3 ; 10.6 ;5;32;116;0;5;2;3;1;4;0;3;2
10248; 20.1 ; 180.6 ; 7.9 ;9;12;84;0;9;2;7;5;4;9;0;0
10249; 62.7 ; 125.3 ; 1.5 ;2;239;74;1;1;1;1;0;2;0;0;2
10250; 38.6 ; 115.7 ; 23.0 ;3;92;109;0;3;3;0;3;0;1;1;1
10251; 57.7 ; 115.5 ; 2.4 ;2;49;147;0;2;0;2;2;0;0;0;2
10252; 23.6 ; 330.2 ; 15.7 ;14;8;173;0;14;5;9;4;10;9;5;0
10253; 62.1 ; 186.3 ; 19.4 ;3;53;52;0;3;0;3;3;0;0;0;3
10254; 54.6 ; 109.1 ; 26.9 ;2;19;84;0;2;0;2;0;2;1;0;1
10255; 30.5 ; 427.2 ; 10.1 ;14;19;163;0;14;0;14;12;2;5;9;0
10256; 52.3 ; 104.5 ; 14.1 ;2;14;269;0;2;1;1;0;2;0;1;1
10257; 46.1 ; 92.1 ; 24.2 ;2;389;70;0;2;1;1;1;1;1;0;1
10258; 134.2 ; 402.5 ; 44.7 ;3;72;64;0;3;1;2;1;2;0;0;3
10259; 24.6 ; 98.4 ; 6.9 ;4;2;271;0;4;4;0;4;0;3;1;0
10260; 25.1 ; 75.2 ; -   ;3;22;94;0;3;1;2;1;2;3;0;0
10261; 42.0 ; 840.7 ; 11.3 ;20;17;11;0;20;4;16;8;12;0;20;0
10262; 47.7 ; 143.1 ; 0.4 ;3;17;23;1;2;1;2;1;2;0;3;0
10263; 32.6 ; 65.3 ; 3.7 ;2;23;253;0;2;0;2;1;1;1;1;0
10264; 25.1 ; 125.3 ; -   ;5;7;13;0;5;4;1;1;4;5;0;0
10265; 42.0 ; 209.8 ; 16.0 ;5;14;188;0;5;2;3;2;3;2;1;2
10266; 63.3 ; 1,075.7 ; 25.1 ;17;15;19;0;17;7;10;3;14;0;0;17
10267; 120.5 ; 241.0 ; 36.1 ;2;8;0;0;2;1;1;0;2;0;0;2
10268; 22.8 ; 227.5 ; 6.9 ;10;8;1;0;10;1;9;2;8;10;0;0
10269; 25.1 ; 50.1 ; -   ;2;3;125;1;1;1;1;0;2;2;0;0
10270; 15.0 ; 30.0 ; -   ;2;23;1;0;2;0;2;1;1;2;0;0
10271; 50.1 ; 200.3 ; 6.8 ;4;82;5;0;4;0;4;2;2;0;3;1
10272; 36.5 ; 73.0 ; 9.5 ;2;43;231;0;2;0;2;1;1;1;1;0
10273; 44.4 ; 133.2 ; 25.1 ;3;83;52;0;3;0;3;3;0;1;1;1
10274; 25.1 ; 551.5 ; 15.9 ;22;14;8;0;22;11;11;7;15;15;7;0
10275; 19.3 ; 503.0 ; 12.5 ;26;9;26;0;26;14;12;4;22;17;9;0
10276; 41.7 ; 125.0 ; 12.4 ;3;43;5;0;3;0;3;0;3;1;2;0
10277; 34.5 ; 310.8 ; 18.6 ;9;36;1;0;9;1;8;3;6;3;6;0
10278; 55.5 ; 554.5 ; 9.8 ;10;15;68;10;0;0;10;10;0;0;0;10
10279; 57.9 ; 347.3 ; 57.3 ;6;11;29;0;6;3;3;4;2;2;0;4
10280; 90.1 ; 270.3 ; 17.1 ;3;100;41;0;3;2;1;1;2;0;0;3
10281; 34.2 ; 308.2 ; 15.2 ;9;24;86;0;9;4;5;5;4;3;6;0
10282; 33.4 ; 66.8 ; 22.2 ;2;163;5;0;2;0;2;2;0;1;0;1
10283; 30.2 ; 60.4 ; -   ;2;168;134;0;2;2;0;0;2;0;2;0
10284; 62.0 ; 309.9 ; 26.2 ;5;25;146;0;5;1;4;4;1;0;0;5
10285; 21.9 ; 131.5 ; 5.1 ;6;45;47;0;6;0;6;1;5;6;0;0
10286; 47.5 ; 94.9 ; -   ;2;14;71;0;2;1;1;1;1;0;2;0
10287; 35.8 ; 250.6 ; 20.4 ;7;31;131;0;7;2;5;4;3;2;3;2
10288; 40.2 ; 80.4 ; 9.8 ;2;18;200;1;1;0;2;1;1;0;2;0
10289; 36.1 ; 1,406.2 ; 16.3 ;39;8;20;0;39;22;17;31;8;13;26;0
10290; 24.3 ; 72.8 ; 17.0 ;3;5;271;0;3;3;0;2;1;2;1;0
10291; 38.3 ; 421.6 ; 11.0 ;11;31;95;0;11;1;10;6;5;4;7;0
10292; 46.1 ; 276.8 ; 6.9 ;6;49;35;0;6;4;2;2;4;0;6;0
10293; 22.5 ; 1,330.0 ; 10.6 ;59;6;5;0;59;30;29;31;28;39;20;0
10294; 115.7 ; 347.1 ; 23.1 ;3;79;26;0;3;0;3;2;1;0;0;3
10295; 51.6 ; 412.7 ; 21.2 ;8;28;0;0;8;0;8;5;3;0;5;3
10296; 27.7 ; 83.0 ; 19.4 ;3;37;266;0;3;2;1;1;2;2;1;0
10297; 28.9 ; 144.7 ; 13.5 ;5;35;23;0;5;4;1;1;4;3;2;0
10298; 54.9 ; 384.4 ; 17.2 ;7;67;2;0;7;2;5;4;3;0;5;2
10299; 46.9 ; 140.8 ; 10.2 ;3;83;31;0;3;1;2;3;0;0;2;1
10300; 39.7 ; 79.5 ; 4.7 ;2;43;225;0;2;0;2;2;0;0;2;0
10301; 36.6 ; 109.8 ; -   ;3;14;250;0;3;1;2;3;0;0;3;0
10302; 38.3 ; 76.5 ; 12.1 ;2;51;59;0;2;2;0;0;2;1;1;0
10303; 84.2 ; 336.9 ; 44.5 ;4;50;47;0;4;1;3;2;2;0;0;4
10304; 30.1 ; 60.1 ; 0.2 ;2;46;59;0;2;1;1;0;2;1;1;0
10305; 51.9 ; 207.7 ; 28.0 ;4;41;31;4;0;3;1;4;0;1;2;1
10306; 17.9 ; 214.6 ; 3.9 ;12;28;5;0;12;0;12;11;1;12;0;0
10307; 45.2 ; 226.0 ; 27.3 ;5;33;185;0;5;0;5;1;4;2;1;2
10308; 25.5 ; 254.9 ; 5.1 ;10;28;42;0;10;7;3;7;3;7;3;0
10309; 23.4 ; 93.7 ; 1.6 ;4;30;14;1;3;2;2;2;2;4;0;0
10310; 57.3 ; 114.7 ; 15.9 ;2;6;272;0;2;0;2;2;0;0;0;2
10311; 29.0 ; 1,277.6 ; 23.1 ;44;7;10;0;44;20;24;8;36;29;15;0
10312; 24.7 ; 49.5 ; 8.1 ;2;31;317;0;2;2;0;1;1;1;1;0
10313; 30.9 ; 61.7 ; 23.8 ;2;264;179;0;2;0;2;2;0;1;1;0
10314; 52.3 ; 156.9 ; 2.6 ;3;47;110;0;3;1;2;3;0;0;3;0
10315; 15.0 ; 30.0 ; -   ;2;6;74;0;2;1;1;0;2;2;0;0
10316; 85.0 ; 935.3 ; 21.4 ;11;24;62;0;11;0;11;2;9;0;0;11
10317; 34.0 ; 68.0 ; 6.0 ;2;8;152;0;2;1;1;1;1;1;1;0
10318; 53.8 ; 1,022.5 ; 14.1 ;19;14;17;0;19;5;14;8;11;0;13;6
10319; 27.4 ; 54.8 ; 4.9 ;2;13;233;0;2;2;0;2;0;1;1;0
10320; 47.5 ; 759.7 ; 7.8 ;16;26;0;0;16;8;8;3;13;0;11;5
10321; 33.5 ; 100.5 ; 3.1 ;3;33;22;3;0;0;3;1;2;0;3;0
10322; 53.5 ; 107.0 ; 9.1 ;2;29;50;2;0;1;1;0;2;0;1;1
10323; 73.8 ; 147.6 ; 26.5 ;2;50;146;0;2;0;2;2;0;0;0;2
10324; 44.1 ; 132.3 ; 13.1 ;3;11;10;0;3;1;2;3;0;0;2;1
10325; 47.2 ; 141.7 ; 0.9 ;3;76;10;1;2;0;3;3;0;0;3;0
10326; 41.0 ; 81.9 ; 16.1 ;2;304;61;0;2;1;1;1;1;1;0;1
10327; 27.4 ; 164.2 ; 2.5 ;6;36;88;0;6;6;0;5;1;6;0;0
10328; 35.9 ; 932.4 ; 17.5 ;26;11;2;0;26;14;12;5;21;9;17;0
10329; 43.3 ; 129.9 ; 12.1 ;3;95;104;0;3;1;2;2;1;0;2;1
10330; 28.9 ; 86.7 ; 7.0 ;3;5;65;0;3;1;2;1;2;2;1;0
10331; 30.0 ; 59.9 ; -   ;2;169;124;0;2;2;0;1;1;2;0;0
10332; 36.6 ; 109.8 ; -   ;3;35;155;0;3;1;2;1;2;0;3;0
10333; 57.1 ; 228.3 ; 0.4 ;4;35;40;0;4;2;2;2;2;0;0;4
10334; 46.3 ; 138.9 ; 7.0 ;3;70;154;0;3;3;0;1;2;0;3;0
10335; 15.0 ; 45.0 ; -   ;3;148;15;0;3;0;3;0;3;3;0;0
10336; 31.2 ; 62.5 ; 24.3 ;2;91;51;0;2;1;1;1;1;1;0;1
10337; 46.8 ; 93.5 ; -   ;2;76;131;0;2;0;2;0;2;0;2;0
10338; 45.5 ; 91.1 ; 2.9 ;2;34;60;0;2;1;1;1;1;0;2;0
10339; 93.6 ; 374.6 ; 17.5 ;4;102;11;0;4;1;3;2;2;0;0;4
10340; 97.4 ; 194.8 ; 72.9 ;2;40;47;0;2;1;1;0;2;1;0;1
10341; 34.7 ; 242.6 ; 21.5 ;7;29;13;7;0;3;4;5;2;2;3;2
10342; 50.1 ; 300.4 ; 31.6 ;6;59;62;0;6;1;5;2;4;2;2;2
10343; 27.5 ; 137.7 ; 10.5 ;5;11;325;0;5;2;3;0;5;3;2;0
10344; 46.2 ; 184.9 ; 1.9 ;4;45;26;0;4;2;2;3;1;0;4;0
10345; 47.7 ; 95.3 ; 6.1 ;2;5;42;0;2;0;2;2;0;0;2;0
10346; 51.6 ; 1,651.3 ; 13.2 ;32;5;55;0;32;18;14;7;25;0;21;11
10347; 37.2 ; 111.6 ; 13.2 ;3;52;68;0;3;2;1;1;2;1;2;0
10348; 60.3 ; 241.2 ; 9.2 ;4;10;23;0;4;1;3;3;1;0;0;4
10349; 18.0 ; 54.0 ; -   ;3;61;68;0;3;1;2;1;2;3;0;0
10350; 32.5 ; 65.0 ; 24.1 ;2;332;3;0;2;2;0;2;0;1;0;1
10351; 95.5 ; 1,146.1 ; 27.2 ;12;37;5;0;12;0;12;12;0;0;0;12
10352; 52.5 ; 105.0 ; -   ;2;15;160;0;2;1;1;2;0;0;2;0
10353; 53.8 ; 215.4 ; 8.3 ;4;84;68;0;4;0;4;4;0;0;3;1
10354; 60.2 ; 241.0 ; 12.9 ;4;35;139;0;4;4;0;1;3;0;0;4
10355; 54.7 ; 492.0 ; 68.8 ;9;5;225;0;9;4;5;4;5;3;3;3
10356; 134.0 ; 536.1 ; 185.4 ;4;61;6;0;4;2;2;1;3;1;0;3
10357; 36.6 ; 73.2 ; -   ;2;5;117;2;0;1;1;1;1;0;2;0
10358; 39.3 ; 78.5 ; 14.0 ;2;55;363;0;2;0;2;2;0;1;1;0
10359; 18.3 ; 256.4 ; 5.4 ;14;18;68;0;14;4;10;6;8;14;0;0
10360; 30.2 ; 181.1 ; -   ;6;13;288;0;6;0;6;6;0;0;6;0
10361; 20.7 ; 62.2 ; -   ;3;5;131;3;0;1;2;1;2;3;0;0
10362; 36.8 ; 110.4 ; 20.0 ;3;57;115;0;3;0;3;2;1;1;1;1
10363; 62.6 ; 688.2 ; 24.3 ;11;30;27;0;11;0;11;10;1;0;0;11
10364; 33.0 ; 197.9 ; 15.1 ;6;27;92;0;6;2;4;1;5;2;4;0
10365; 36.7 ; 110.2 ; 16.2 ;3;13;248;0;3;2;1;1;2;1;2;0
10366; 54.5 ; 272.4 ; 27.6 ;5;79;2;0;5;2;3;3;2;2;1;2
10367; 49.5 ; 247.4 ; 3.0 ;5;20;37;0;5;2;3;3;2;0;5;0
10368; 15.0 ; 30.0 ; -   ;2;19;336;0;2;0;2;2;0;2;0;0
10369; 41.9 ; 125.6 ; 10.8 ;3;90;122;0;3;0;3;3;0;0;3;0
10370; 21.8 ; 348.6 ; 3.4 ;16;20;22;0;16;5;11;7;9;16;0;0
10371; 72.9 ; 145.9 ; 39.2 ;2;7;247;0;2;1;1;2;0;0;0;2
10372; 49.7 ; 298.1 ; 47.6 ;6;16;11;0;6;0;6;1;5;2;2;2
10373; 30.0 ; 360.1 ; 18.0 ;12;15;32;0;12;2;10;6;6;4;8;0
10374; 55.8 ; 111.5 ; 30.4 ;2;9;278;0;2;1;1;2;0;1;0;1
10375; 38.5 ; 76.9 ; 12.4 ;2;44;297;0;2;2;0;2;0;1;1;0
10376; 43.4 ; 217.2 ; 7.8 ;5;49;225;0;5;1;4;4;1;0;5;0
10377; 59.9 ; 299.6 ; 13.9 ;5;40;0;0;5;0;5;2;3;0;0;5
10378; 33.0 ; 66.0 ; 11.9 ;2;3;245;0;2;1;1;1;1;1;1;0
10379; 22.6 ; 45.2 ; 11.4 ;2;148;240;0;2;1;1;1;1;1;1;0
10380; 26.6 ; 213.0 ; 10.3 ;8;38;6;0;8;6;2;4;4;5;3;0
10381; 43.4 ; 173.7 ; 9.9 ;4;51;4;0;4;1;3;4;0;0;4;0
10382; 45.6 ; 91.1 ; 1.8 ;2;95;168;0;2;0;2;2;0;0;2;0
10383; 56.4 ; 112.9 ; 39.3 ;2;6;100;2;0;0;2;2;0;1;0;1
10384; 32.4 ; 550.0 ; 24.5 ;17;18;42;0;17;13;4;16;1;6;5;6
10385; 38.5 ; 192.3 ; 27.9 ;5;45;5;0;5;3;2;4;1;2;1;2
10386; 63.0 ; 251.8 ; 26.8 ;4;58;29;0;4;1;3;2;2;0;0;4
10387; 30.0 ; 59.9 ; -   ;2;37;23;0;2;1;1;1;1;2;0;0
10388; 23.5 ; 234.9 ; 17.0 ;10;27;143;0;10;8;2;1;9;7;3;0
10389; 54.2 ; 759.3 ; 10.8 ;14;16;5;0;14;0;14;4;10;0;9;5
10390; 28.8 ; 230.5 ; 14.0 ;8;14;233;0;8;3;5;4;4;5;3;0
10391; 35.9 ; 71.8 ; 16.2 ;2;14;304;0;2;0;2;0;2;1;1;0
10392; 31.6 ; 1,011.0 ; 13.0 ;32;9;16;0;32;19;13;5;27;11;21;0
10393; 30.7 ; 183.9 ; 10.8 ;6;17;178;0;6;1;5;3;3;2;4;0
10394; 54.5 ; 109.0 ; 11.6 ;2;214;99;0;2;0;2;0;2;0;1;1
10395; 43.2 ; 259.4 ; 20.0 ;6;22;99;0;6;2;4;3;3;2;2;2
10396; 22.3 ; 602.9 ; 7.8 ;27;9;5;0;27;10;17;11;16;18;9;0
10397; 16.5 ; 82.5 ; 2.3 ;5;39;29;0;5;3;2;1;4;5;0;0
10398; 43.8 ; 482.1 ; 14.9 ;11;23;53;0;11;1;10;7;4;4;3;4
10399; 42.9 ; 214.7 ; 18.8 ;5;21;162;0;5;2;3;3;2;2;1;2
10400; 32.6 ; 130.6 ; 7.1 ;4;13;189;0;4;0;4;3;1;1;3;0
10401; 58.4 ; 175.1 ; 14.3 ;3;100;18;3;0;2;1;1;2;0;0;3
10402; 47.5 ; 237.3 ; 1.8 ;5;31;145;0;5;1;4;1;4;0;5;0
10403; 59.3 ; 118.6 ; 10.5 ;2;16;251;0;2;2;0;0;2;0;0;2
10404; 39.1 ; 508.1 ; 31.2 ;13;28;8;0;13;4;9;6;7;4;5;4
10405; 56.9 ; 398.2 ; 25.7 ;7;47;5;0;7;1;6;1;6;0;0;7
10406; 35.6 ; 106.8 ; 14.9 ;3;13;5;0;3;1;2;1;2;1;2;0
10407; 25.8 ; 154.8 ; 12.2 ;6;37;10;0;6;0;6;0;6;4;2;0
10408; 21.1 ; 42.2 ; -   ;2;2;263;0;2;1;1;1;1;2;0;0
10409; 43.8 ; 175.1 ; 15.9 ;4;12;95;0;4;2;2;2;2;1;2;1
10410; 44.5 ; 1,022.7 ; 20.5 ;23;13;13;0;23;5;18;23;0;8;7;8
10411; 46.8 ; 93.5 ; -   ;2;43;176;0;2;2;0;0;2;0;2;0
10412; 34.4 ; 240.7 ; 13.7 ;7;46;47;0;7;5;2;1;6;2;5;0
10413; 21.9 ; 65.6 ; 2.2 ;3;17;280;0;3;2;1;1;2;3;0;0
10414; 25.5 ; 51.0 ; 16.2 ;2;1;137;0;2;1;1;0;2;1;1;0
10415; 26.9 ; 134.5 ; 15.0 ;5;58;47;1;4;0;5;5;0;3;2;0
10416; 37.8 ; 794.3 ; 17.1 ;21;12;0;0;21;2;19;19;2;7;14;0
10417; 32.5 ; 97.6 ; 13.7 ;3;32;0;0;3;2;1;1;2;1;2;0
10418; 70.1 ; 350.6 ; 18.1 ;5;32;102;0;5;1;4;1;4;0;0;5
10419; 25.1 ; 50.1 ; -   ;2;4;178;0;2;1;1;1;1;2;0;0
10420; 48.5 ; 679.5 ; 8.4 ;14;23;5;1;13;9;5;7;7;0;9;5
10421; 21.7 ; 173.7 ; 5.3 ;8;9;9;0;8;4;4;1;7;8;0;0
10422; 43.4 ; 130.1 ; 14.9 ;3;68;38;0;3;1;2;1;2;1;1;1
10423; 30.8 ; 61.7 ; 8.6 ;2;53;299;0;2;1;1;0;2;1;1;0
10424; 33.6 ; 167.8 ; 10.2 ;5;23;63;0;5;0;5;3;2;2;3;0
10425; 20.7 ; 166.0 ; -   ;8;18;51;0;8;3;5;5;3;8;0;0
10426; 98.0 ; 294.0 ; 67.6 ;3;22;110;0;3;0;3;1;2;0;0;3
10427; 58.6 ; 234.5 ; 24.6 ;4;76;98;0;4;2;2;2;2;0;0;4
10428; 37.8 ; 75.6 ; 14.5 ;2;24;43;0;2;0;2;0;2;1;1;0
10429; 34.4 ; 68.9 ; 14.0 ;2;40;170;0;2;1;1;1;1;1;1;0
10430; 36.6 ; 73.2 ; -   ;2;19;120;0;2;0;2;1;1;0;2;0
10431; 53.9 ; 107.8 ; 2.1 ;2;31;249;0;2;2;0;2;0;0;1;1
10432; 41.0 ; 204.9 ; 14.2 ;5;80;40;0;5;3;2;1;4;2;1;2
10433; 60.5 ; 121.1 ; 19.3 ;2;182;116;0;2;0;2;1;1;0;0;2
10434; 55.3 ; 166.0 ; 33.6 ;3;94;107;0;3;3;0;1;2;1;0;2
10435; 32.7 ; 163.3 ; 11.6 ;5;11;272;0;5;3;2;1;4;2;3;0
10436; 34.2 ; 307.5 ; 7.3 ;9;20;22;0;9;0;9;3;6;3;6;0
10437; 22.2 ; 88.8 ; 4.3 ;4;2;97;0;4;2;2;1;3;4;0;0
10438; 19.0 ; 76.1 ; 0.9 ;4;23;177;0;4;3;1;4;0;4;0;0
10439; 152.1 ; 760.7 ; 80.6 ;5;76;36;0;5;2;3;5;0;0;0;5
10440; 38.2 ; 191.0 ; 8.7 ;5;74;17;0;5;1;4;3;2;2;3;0
10441; 66.4 ; 132.8 ; 29.4 ;2;24;272;0;2;0;2;2;0;0;0;2
10442; 52.5 ; 105.0 ; -   ;2;132;158;1;1;0;2;2;0;0;2;0
10443; 58.8 ; 176.4 ; 18.0 ;3;77;230;0;3;2;1;1;2;0;0;3
10444; 23.4 ; 93.4 ; 5.4 ;4;44;5;0;4;0;4;3;1;4;0;0
10445; 40.6 ; 162.3 ; 16.8 ;4;95;22;0;4;3;1;1;3;1;2;1
10446; 30.2 ; 181.0 ; 13.5 ;6;57;22;0;6;1;5;4;2;2;4;0
10447; 40.1 ; 80.3 ; 33.1 ;2;128;41;0;2;1;1;1;1;1;0;1
10448; 51.7 ; 310.1 ; 3.2 ;6;27;57;0;6;0;6;5;1;0;6;0
10449; 62.0 ; 124.0 ; 60.8 ;2;248;5;0;2;1;1;2;0;1;0;1
10450; 42.5 ; 212.7 ; 13.3 ;5;56;5;0;5;1;4;4;1;2;1;2
10451; 19.9 ; 79.7 ; 7.8 ;4;41;56;0;4;3;1;4;0;4;0;0
10452; 50.0 ; 99.9 ; 4.8 ;2;190;5;0;2;0;2;2;0;0;2;0
10453; 44.1 ; 749.7 ; 11.0 ;17;16;13;0;17;7;10;6;11;0;11;6
10454; 71.2 ; 142.4 ; 35.5 ;2;11;32;0;2;0;2;0;2;0;0;2
10455; 64.0 ; 256.0 ; 22.0 ;4;69;115;0;4;1;3;2;2;0;0;4
10456; 47.7 ; 95.4 ; 1.4 ;2;6;352;0;2;0;2;1;1;0;2;0
10457; 21.5 ; 43.1 ; 5.3 ;2;7;78;0;2;0;2;1;1;2;0;0
10458; 64.5 ; 903.2 ; 31.5 ;14;21;15;0;14;1;13;12;2;0;0;14
10459; 43.4 ; 173.6 ; 13.0 ;4;82;37;0;4;0;4;1;3;0;3;1
10460; 24.3 ; 48.6 ; 13.9 ;2;221;152;0;2;0;2;2;0;1;1;0
10461; 47.8 ; 143.4 ; 16.7 ;3;66;152;0;3;0;3;1;2;0;2;1
10462; 15.0 ; 30.0 ; -   ;2;3;233;0;2;1;1;0;2;2;0;0
10463; 39.0 ; 937.2 ; 12.9 ;24;7;212;0;24;10;14;6;18;8;16;0
10464; 47.2 ; 141.7 ; 0.9 ;3;152;7;0;3;2;1;1;2;0;3;0
10465; 44.1 ; 396.8 ; 25.4 ;9;30;50;0;9;5;4;3;6;3;3;3
10466; 50.0 ; 100.0 ; 3.8 ;2;163;43;0;2;0;2;0;2;0;2;0
10467; 36.9 ; 73.8 ; 17.7 ;2;155;138;0;2;1;1;1;1;1;1;0
10468; 30.8 ; 185.1 ; 8.5 ;6;57;74;0;6;2;4;5;1;2;4;0
10469; 50.1 ; 200.3 ; 3.3 ;4;71;5;0;4;2;2;1;3;0;4;0
10470; 99.5 ; 597.0 ; 49.1 ;6;52;15;0;6;0;6;4;2;0;0;6
10471; 41.9 ; 125.7 ; 9.7 ;3;93;8;0;3;1;2;3;0;0;3;0
10472; 20.0 ; 40.1 ; 7.6 ;2;44;235;0;2;1;1;1;1;2;0;0
10473; 71.2 ; 356.0 ; 54.4 ;5;2;296;0;5;3;2;2;3;2;0;3
10474; 42.1 ; 378.7 ; 20.5 ;9;27;56;0;9;4;5;5;4;3;3;3
10475; 45.7 ; 457.3 ; 14.4 ;10;24;121;0;10;3;7;5;5;0;7;3
10476; 39.7 ; 79.4 ; 21.2 ;2;225;92;0;2;2;0;2;0;1;0;1
10477; 51.5 ; 154.4 ; 2.6 ;3;185;16;0;3;1;2;2;1;0;3;0
10478; 37.8 ; 113.5 ; 8.8 ;3;129;104;0;3;0;3;3;0;1;2;0
10479; 30.6 ; 183.3 ; 18.5 ;6;16;95;0;6;2;4;5;1;2;4;0
10480; 16.9 ; 67.4 ; 4.0 ;4;80;8;0;4;2;2;2;2;4;0;0
10481; 15.0 ; 30.0 ; -   ;2;413;32;0;2;0;2;0;2;2;0;0
10482; 42.5 ; 127.6 ; 6.1 ;3;72;16;0;3;0;3;1;2;0;3;0
10483; 25.2 ; 126.2 ; 10.2 ;5;25;188;0;5;0;5;3;2;3;2;0
10484; 57.1 ; 114.1 ; 11.2 ;2;5;137;2;0;0;2;2;0;0;0;2
10485; 51.2 ; 717.3 ; 15.9 ;14;19;134;0;14;7;7;9;5;0;9;5
10486; 44.3 ; 487.3 ; 11.0 ;11;39;5;0;11;0;11;4;7;0;7;4
10487; 23.4 ; 70.2 ; 8.2 ;3;22;149;0;3;1;2;1;2;2;1;0
10488; 46.8 ; 93.5 ; -   ;2;25;356;0;2;0;2;2;0;0;2;0
10489; 88.8 ; 266.3 ; 26.8 ;3;11;62;0;3;1;2;3;0;0;0;3
10490; 84.7 ; 507.9 ; 22.5 ;6;52;5;0;6;2;4;6;0;0;0;6
10491; 66.2 ; 463.6 ; 12.3 ;7;49;99;0;7;3;4;4;3;0;0;7
10492; 48.5 ; 97.0 ; 1.6 ;2;176;68;0;2;0;2;2;0;0;2;0
10493; 49.4 ; 296.4 ; 31.1 ;6;70;59;0;6;0;6;2;4;2;2;2
10494; 51.9 ; 103.9 ; 1.4 ;2;201;104;0;2;0;2;2;0;0;2;0
10495; 89.4 ; 446.9 ; 67.7 ;5;104;1;0;5;1;4;4;1;2;0;3
10496; 60.9 ; 487.1 ; 11.1 ;8;23;103;0;8;2;6;2;6;0;0;8
10497; 48.7 ; 97.4 ; -   ;2;19;175;0;2;2;0;0;2;0;2;0
10498; 52.0 ; 156.0 ; 6.0 ;3;104;93;0;3;1;2;2;1;0;2;1
10499; 53.1 ; 106.2 ; 10.7 ;2;103;264;0;2;2;0;0;2;0;1;1
10500; 16.8 ; 84.2 ; 4.4 ;5;34;248;0;5;3;2;1;4;5;0;0
10501; 58.3 ; 291.3 ; 40.6 ;5;83;20;0;5;1;4;3;2;2;0;3
10502; 59.1 ; 354.4 ; 17.0 ;6;32;222;0;6;4;2;5;1;0;0;6
10503; 31.7 ; 63.3 ; 25.4 ;2;9;338;0;2;1;1;1;1;1;0;1
10504; 44.4 ; 488.4 ; 11.0 ;11;32;115;0;11;5;6;11;0;0;7;4
10505; 30.2 ; 60.5 ; 18.3 ;2;12;78;2;0;0;2;1;1;1;1;0
10506; 36.1 ; 829.7 ; 17.9 ;23;11;13;0;23;6;17;13;10;8;15;0
10507; 35.0 ; 70.0 ; 7.6 ;2;11;169;0;2;0;2;0;2;1;1;0
10508; 25.1 ; 50.1 ; -   ;2;6;284;0;2;0;2;2;0;2;0;0
10509; 27.9 ; 111.5 ; 3.5 ;4;95;42;0;4;0;4;2;2;3;1;0
10510; 59.9 ; 119.8 ; 25.5 ;2;135;269;0;2;1;1;0;2;0;0;2
10511; 78.7 ; 157.3 ; 0.5 ;2;76;2;0;2;2;0;2;0;0;0;2
10512; 51.9 ; 155.7 ; 8.8 ;3;98;47;0;3;2;1;1;2;0;2;1
10513; 34.0 ; 67.9 ; 13.3 ;2;68;173;0;2;1;1;0;2;1;1;0
10514; 54.0 ; 270.1 ; 22.3 ;5;49;47;0;5;0;5;3;2;0;3;2
10515; 55.6 ; 278.0 ; 13.0 ;5;58;27;0;5;0;5;5;0;0;0;5
10516; 22.6 ; 112.8 ; 9.0 ;5;82;5;0;5;1;4;3;2;3;2;0
10517; 26.6 ; 373.1 ; 15.4 ;14;23;4;0;14;8;6;6;8;9;5;0
10518; 36.6 ; 73.2 ; -   ;2;224;14;1;1;1;1;0;2;0;2;0
10519; 57.8 ; 288.9 ; 19.1 ;5;37;121;0;5;1;4;0;5;0;0;5
10520; 24.3 ; 145.6 ; 11.0 ;6;42;64;0;6;3;3;2;4;4;2;0
10521; 78.8 ; 157.5 ; 39.3 ;2;13;257;0;2;0;2;1;1;0;0;2
10522; 38.4 ; 153.6 ; 10.2 ;4;35;188;0;4;2;2;1;3;1;3;0
10523; 61.4 ; 245.5 ; 9.0 ;4;36;189;0;4;1;3;4;0;0;0;4
10524; 15.9 ; 47.8 ; 1.8 ;3;61;194;0;3;2;1;1;2;3;0;0
10525; 19.4 ; 290.8 ; 4.8 ;15;19;5;0;15;0;15;14;1;15;0;0
10526; 27.8 ; 166.9 ; 10.9 ;6;48;23;0;6;2;4;4;2;4;2;0
10527; 35.0 ; 978.7 ; 16.9 ;28;14;11;0;28;2;26;13;15;9;19;0
10528; 33.0 ; 165.1 ; 17.0 ;5;25;5;0;5;0;5;5;0;2;3;0
10529; 38.8 ; 232.9 ; 27.6 ;6;47;30;0;6;3;3;2;4;2;2;2
10530; 15.5 ; 77.3 ; 1.2 ;5;32;86;0;5;5;0;0;5;5;0;0
10531; 16.0 ; 144.0 ; 3.4 ;9;25;19;0;9;7;2;7;2;9;0;0
10532; 53.2 ; 372.3 ; 4.5 ;7;30;10;1;6;0;7;2;5;0;5;2
10533; 45.4 ; 227.2 ; 30.4 ;5;24;5;0;5;1;4;2;3;2;1;2
10534; 106.3 ; 212.5 ; 13.9 ;2;81;94;0;2;0;2;2;0;0;0;2
10535; 51.7 ; 1,498.2 ; 19.7 ;29;15;11;0;29;6;23;20;9;0;19;10
10536; 46.2 ; 92.4 ; 3.8 ;2;124;89;1;1;0;2;2;0;0;2;0
10537; 43.4 ; 260.5 ; 8.8 ;6;31;4;0;6;2;4;4;2;0;6;0
10538; 37.5 ; 412.8 ; 9.0 ;11;12;283;0;11;6;5;4;7;4;7;0
10539; 24.0 ; 982.8 ; 11.8 ;41;6;121;0;41;12;29;13;28;27;14;0
10540; 34.8 ; 173.8 ; 11.0 ;5;26;107;0;5;2;3;2;3;2;3;0
10541; 52.6 ; 368.5 ; 43.4 ;7;45;15;0;7;2;5;4;3;2;3;2
10542; 46.8 ; 187.0 ; -   ;4;40;128;0;4;3;1;1;3;0;4;0
10543; 35.9 ; 71.8 ; 16.2 ;2;8;249;0;2;1;1;1;1;1;1;0
10544; 30.0 ; 60.1 ; 7.4 ;2;101;41;0;2;0;2;1;1;1;1;0
10545; 49.8 ; 149.3 ; 4.0 ;3;122;22;0;3;0;3;2;1;0;3;0
10546; 65.8 ; 131.7 ; 46.3 ;2;96;188;0;2;1;1;1;1;1;0;1
10547; 42.6 ; 85.3 ; 9.1 ;2;208;16;0;2;0;2;2;0;0;2;0
10548; 58.2 ; 116.4 ; 1.1 ;2;305;5;0;2;1;1;1;1;0;0;2
10549; 60.4 ; 181.2 ; 47.6 ;3;3;268;0;3;1;2;1;2;1;0;2
10550; 80.3 ; 241.0 ; 15.6 ;3;110;42;0;3;0;3;1;2;0;0;3
10551; 63.9 ; 319.3 ; 20.3 ;5;8;80;5;0;4;1;0;5;0;0;5
10552; 15.0 ; 389.6 ; -   ;26;4;3;0;26;9;17;26;0;26;0;0
10553; 48.7 ; 194.8 ; -   ;4;52;26;0;4;1;3;3;1;0;4;0
10554; 116.1 ; 232.1 ; 11.4 ;2;32;125;1;1;0;2;2;0;0;0;2
10555; 70.1 ; 140.3 ; 35.0 ;2;18;147;0;2;0;2;2;0;0;0;2
10556; 46.6 ; 139.9 ; 11.6 ;3;73;141;0;3;1;2;0;3;0;2;1
10557; 39.2 ; 117.7 ; 22.6 ;3;59;83;0;3;0;3;1;2;1;1;1
10558; 41.8 ; 334.5 ; 11.7 ;8;29;16;0;8;2;6;4;4;0;8;0
10559; 50.3 ; 201.3 ; 4.5 ;4;76;37;0;4;2;2;4;0;0;4;0
10560; 47.4 ; 284.3 ; 29.5 ;6;14;7;0;6;3;3;5;1;2;2;2
10561; 22.0 ; 483.0 ; 10.2 ;22;16;53;0;22;8;14;15;7;15;7;0
10562; 70.3 ; 351.7 ; 51.2 ;5;2;236;0;5;0;5;5;0;2;0;3
10563; 28.9 ; 57.9 ; 17.6 ;2;289;15;0;2;0;2;2;0;1;1;0
10564; 68.6 ; 205.8 ; 29.5 ;3;44;14;0;3;1;2;1;2;0;0;3
10565; 46.1 ; 415.0 ; 20.9 ;9;41;5;0;9;3;6;7;2;3;3;3
10566; 81.0 ; 324.1 ; 66.4 ;4;114;20;1;3;1;3;2;2;1;0;3
10567; 22.7 ; 113.4 ; 7.6 ;5;22;11;0;5;0;5;3;2;3;2;0
10568; 36.7 ; 733.4 ; 4.4 ;20;17;15;0;20;0;20;20;0;0;20;0
10569; 28.4 ; 170.1 ; 6.0 ;6;26;0;0;6;1;5;2;4;4;2;0
10570; 27.5 ; 137.4 ; 12.2 ;5;23;96;0;5;2;3;2;3;3;2;0
10571; 37.1 ; 74.1 ; 10.3 ;2;63;212;0;2;2;0;1;1;1;1;0
10572; 49.7 ; 546.2 ; 26.4 ;11;14;182;0;11;11;0;1;10;4;3;4
10573; 48.7 ; 97.4 ; -   ;2;35;106;0;2;0;2;0;2;0;2;0
10574; 64.2 ; 256.8 ; 7.9 ;4;10;278;0;4;1;3;3;1;0;0;4
10575; 37.0 ; 110.9 ; 6.4 ;3;4;269;0;3;1;2;2;1;0;3;0
10576; 33.2 ; 132.7 ; 17.2 ;4;11;247;0;4;0;4;2;2;1;3;0
10577; 53.4 ; 160.1 ; 7.9 ;3;30;2;1;2;1;2;0;3;0;2;1
10578; 54.1 ; 108.3 ; 11.1 ;2;99;194;0;2;0;2;2;0;0;1;1
10579; 23.6 ; 164.9 ; 5.9 ;7;19;8;0;7;3;4;1;6;7;0;0
10580; 15.0 ; 45.0 ; -   ;3;32;116;0;3;0;3;2;1;3;0;0
10581; 73.0 ; 365.2 ; 20.3 ;5;18;40;0;5;0;5;2;3;0;0;5
10582; 17.3 ; 34.7 ; 3.5 ;2;2;136;0;2;1;1;1;1;2;0;0
10583; 15.8 ; 110.3 ; 1.8 ;7;16;1;0;7;2;5;3;4;7;0;0
10584; 136.2 ; 681.1 ; 26.8 ;5;48;62;0;5;0;5;5;0;0;0;5
10585; 30.8 ; 92.4 ; 16.3 ;3;73;73;0;3;0;3;2;1;1;2;0
10586; 32.1 ; 96.2 ; 22.7 ;3;68;160;0;3;1;2;2;1;1;2;0
10587; 15.2 ; 76.1 ; 0.6 ;5;11;2;0;5;5;0;5;0;5;0;0
10588; 45.8 ; 183.3 ; 10.9 ;4;57;131;0;4;0;4;2;2;0;3;1
10589; 39.8 ; 198.9 ; 14.1 ;5;5;185;0;5;3;2;1;4;2;3;0
10590; 44.0 ; 703.5 ; 18.8 ;16;18;26;0;16;4;12;8;8;5;6;5
10591; 91.0 ; 182.0 ; 21.0 ;2;6;216;2;0;0;2;0;2;0;0;2
10592; 51.0 ; 102.1 ; 6.4 ;2;15;144;0;2;1;1;0;2;0;1;1
10593; 25.7 ; 154.1 ; 9.9 ;6;43;59;0;6;3;3;4;2;4;2;0
10594; 27.4 ; 82.3 ; 19.6 ;3;20;35;0;3;2;1;1;2;2;1;0
10595; 53.2 ; 106.5 ; 5.4 ;2;7;42;2;0;0;2;1;1;0;1;1
10596; 26.0 ; 130.0 ; 16.9 ;5;13;5;5;0;1;4;5;0;3;2;0
10597; 63.3 ; 253.2 ; 30.9 ;4;64;83;0;4;2;2;4;0;0;0;4
10598; 39.7 ; 158.8 ; 8.7 ;4;7;235;0;4;2;2;1;3;0;4;0
10599; 43.7 ; 218.5 ; 4.9 ;5;64;11;0;5;2;3;4;1;0;5;0
10600; 32.7 ; 163.6 ; 13.7 ;5;59;31;0;5;0;5;2;3;2;3;0
10601; 73.3 ; 146.7 ; 32.4 ;2;18;84;0;2;0;2;2;0;0;0;2
10602; 32.2 ; 64.3 ; 25.7 ;2;262;36;0;2;1;1;2;0;1;0;1
10603; 21.0 ; 83.8 ; 9.8 ;4;5;281;0;4;4;0;3;1;3;1;0
10604; 53.1 ; 106.1 ; 6.6 ;2;164;126;0;2;0;2;1;1;0;1;1
10605; 27.1 ; 162.7 ; 16.0 ;6;33;170;0;6;4;2;5;1;4;2;0
10606; 27.4 ; 274.0 ; 25.5 ;10;40;5;0;10;2;8;5;5;7;3;0
10607; 28.4 ; 85.1 ; 6.1 ;3;5;10;0;3;1;2;2;1;2;1;0
10608; 26.9 ; 80.7 ; 2.8 ;3;14;151;0;3;1;2;1;2;3;0;0
10609; 31.8 ; 63.7 ; 25.2 ;2;5;74;2;0;0;2;0;2;1;0;1
10610; 39.6 ; 198.1 ; 9.6 ;5;47;53;0;5;1;4;3;2;0;5;0
10611; 45.9 ; 91.8 ; 1.3 ;2;129;165;0;2;1;1;0;2;0;2;0
10612; 35.1 ; 210.5 ; 11.3 ;6;31;164;0;6;2;4;3;3;2;4;0
10613; 24.1 ; 72.2 ; 5.4 ;3;4;21;0;3;1;2;1;2;3;0;0
10614; 49.5 ; 692.3 ; 12.8 ;14;27;0;0;14;0;14;5;9;0;9;5
10615; 47.1 ; 141.2 ; 23.7 ;3;13;167;0;3;0;3;1;2;1;1;1
10616; 33.7 ; 168.6 ; 18.6 ;5;91;63;0;5;2;3;4;1;2;3;0
10617; 36.6 ; 73.2 ; -   ;2;9;257;0;2;1;1;2;0;0;2;0
10618; 32.5 ; 454.8 ; 9.0 ;14;18;1;0;14;4;10;11;3;5;9;0
10619; 49.3 ; 246.5 ; 2.5 ;5;77;21;0;5;1;4;5;0;0;5;0
10620; 19.3 ; 96.6 ; 4.6 ;5;9;237;0;5;2;3;5;0;5;0;0
10621; 21.4 ; 42.8 ; 6.4 ;2;13;157;0;2;0;2;0;2;2;0;0
10622; 33.3 ; 166.5 ; 10.9 ;5;79;20;0;5;0;5;4;1;2;3;0
10623; 50.1 ; 100.1 ; -   ;2;18;5;0;2;0;2;0;2;0;2;0
10624; 21.7 ; 65.1 ; 6.2 ;3;5;116;0;3;1;2;3;0;3;0;0
10625; 77.0 ; 1,769.9 ; 29.0 ;23;14;10;0;23;6;17;21;2;0;0;23
10626; 30.4 ; 60.7 ; 9.3 ;2;44;89;1;1;0;2;1;1;1;1;0
10627; 41.5 ; 83.1 ; 17.0 ;2;16;83;1;1;2;0;1;1;1;0;1
10628; 33.0 ; 131.9 ; 10.8 ;4;10;200;0;4;2;2;2;2;1;3;0
10629; 27.6 ; 55.3 ; 3.8 ;2;22;30;0;2;1;1;0;2;1;1;0
10630; 40.0 ; 160.1 ; 18.6 ;4;118;17;0;4;0;4;2;2;1;2;1
10631; 20.7 ; 62.0 ; 0.4 ;3;191;54;0;3;2;1;1;2;3;0;0
10632; 26.2 ; 78.7 ; 3.6 ;3;11;19;3;0;2;1;2;1;3;0;0
10633; 30.2 ; 60.4 ; -   ;2;101;43;2;0;0;2;2;0;0;2;0
10634; 41.3 ; 82.6 ; 24.3 ;2;56;223;0;2;2;0;2;0;1;0;1
10635; 48.9 ; 97.8 ; 3.2 ;2;176;116;0;2;0;2;2;0;0;2;0
10636; 45.8 ; 640.8 ; 11.7 ;14;18;59;0;14;5;9;3;11;0;9;5
10637; 51.7 ; 103.4 ; 39.9 ;2;50;47;0;2;0;2;0;2;1;0;1
10638; 23.1 ; 138.3 ; 10.8 ;6;16;1;0;6;0;6;4;2;4;2;0
10639; 15.9 ; 127.3 ; 1.8 ;8;36;81;0;8;5;3;2;6;8;0;0
10640; 59.4 ; 534.7 ; 29.6 ;9;32;58;0;9;0;9;7;2;3;0;6
10641; 24.5 ; 539.5 ; 8.0 ;22;13;56;0;22;13;9;6;16;15;7;0
10642; 32.9 ; 559.9 ; 21.9 ;17;15;48;0;17;0;17;10;7;6;11;0
10643; 43.0 ; 128.9 ; 12.0 ;3;60;99;0;3;1;2;0;3;0;3;0
10644; 42.6 ; 255.5 ; 20.1 ;6;31;121;0;6;1;5;5;1;2;2;2
10645; 63.8 ; 1,084.9 ; 21.9 ;17;17;40;0;17;6;11;10;7;0;0;17
10646; 39.3 ; 117.9 ; 8.9 ;3;85;128;2;1;2;1;1;2;0;3;0
10647; 54.1 ; 108.3 ; 58.6 ;2;5;77;0;2;2;0;2;0;1;0;1
10648; 30.4 ; 60.9 ; 8.0 ;2;7;31;1;1;0;2;0;2;1;1;0
10649; 24.2 ; 145.0 ; 13.5 ;6;16;0;0;6;0;6;4;2;4;2;0
10650; 22.3 ; 312.0 ; 12.8 ;14;29;23;0;14;8;6;8;6;9;5;0
10651; 38.3 ; 76.6 ; 30.4 ;2;158;162;0;2;0;2;0;2;1;0;1
10652; 48.5 ; 339.4 ; 16.8 ;7;36;20;0;7;5;2;5;2;0;5;2
10653; 41.9 ; 125.6 ; 16.0 ;3;13;287;0;3;3;0;1;2;1;1;1
10654; 27.7 ; 525.8 ; 7.9 ;19;14;10;0;19;0;19;11;8;13;6;0
10655; 51.3 ; 102.6 ; 4.0 ;2;331;15;0;2;1;1;1;1;0;1;1
10656; 21.8 ; 87.3 ; 8.9 ;4;95;26;1;3;0;4;1;3;3;1;0
10657; 20.3 ; 60.9 ; 9.7 ;3;63;23;0;3;2;1;2;1;2;1;0
10658; 59.8 ; 119.6 ; 60.6 ;2;55;222;0;2;1;1;1;1;1;0;1
10659; 55.4 ; 831.0 ; 35.8 ;15;12;222;0;15;5;10;6;9;5;0;10
10660; 24.8 ; 49.6 ; 4.8 ;2;53;19;2;0;1;1;1;1;2;0;0
10661; 48.7 ; 194.8 ; 26.3 ;4;24;92;0;4;2;2;4;0;1;2;1
10662; 48.7 ; 146.0 ; 3.5 ;3;38;205;0;3;0;3;3;0;0;3;0
10663; 41.8 ; 460.1 ; 13.8 ;11;26;26;0;11;3;8;5;6;4;3;4
10664; 59.4 ; 296.9 ; 21.6 ;5;38;5;0;5;0;5;1;4;0;0;5
10665; 36.0 ; 539.3 ; 13.2 ;15;20;2;0;15;12;3;11;4;5;10;0
10666; 22.0 ; 43.9 ; 3.8 ;2;10;167;0;2;2;0;2;0;2;0;0
10667; 20.5 ; 41.1 ; 8.3 ;2;65;127;0;2;1;1;2;0;2;0;0
10668; 28.1 ; 84.2 ; 21.1 ;3;92;3;0;3;1;2;3;0;2;1;0
10669; 42.4 ; 211.9 ; 8.7 ;5;12;5;0;5;1;4;4;1;0;5;0
10670; 23.9 ; 262.5 ; 6.7 ;11;5;105;2;9;9;2;11;0;7;4;0
10671; 45.1 ; 90.2 ; 12.7 ;2;18;57;0;2;0;2;2;0;0;1;1
10672; 43.4 ; 564.7 ; 11.4 ;13;35;21;0;13;2;11;7;6;0;13;0
10673; 49.5 ; 247.7 ; 4.9 ;5;64;17;0;5;1;4;3;2;0;5;0
10674; 60.7 ; 121.4 ; 18.8 ;2;5;15;0;2;1;1;2;0;0;0;2
10675; 22.2 ; 66.6 ; 13.2 ;3;2;296;0;3;2;1;2;1;2;1;0
10676; 30.5 ; 274.7 ; 15.6 ;9;16;8;0;9;4;5;2;7;3;6;0
10677; 28.2 ; 197.3 ; 15.4 ;7;59;54;0;7;2;5;5;2;5;2;0
10678; 62.0 ; 186.0 ; 41.8 ;3;71;244;0;3;2;1;0;3;1;0;2
10679; 15.0 ; 30.0 ; -   ;2;7;92;0;2;2;0;0;2;2;0;0
10680; 58.1 ; 465.2 ; 17.9 ;8;26;202;0;8;5;3;6;2;0;0;8
10681; 21.5 ; 129.0 ; 8.6 ;6;23;1;0;6;3;3;0;6;4;2;0
10682; 50.0 ; 199.8 ; 13.0 ;4;73;54;0;4;3;1;4;0;0;3;1
10683; 65.3 ; 326.7 ; 15.4 ;5;29;52;0;5;0;5;4;1;0;0;5
10684; 70.1 ; 140.3 ; 35.0 ;2;24;110;0;2;0;2;2;0;0;0;2
10685; 96.9 ; 387.8 ; 53.1 ;4;87;77;0;4;3;1;1;3;0;0;4
10686; 43.2 ; 215.9 ; 10.4 ;5;47;110;0;5;1;4;3;2;0;5;0
10687; 75.4 ; 980.7 ; 48.5 ;13;36;5;0;13;5;8;3;10;4;0;9
10688; 30.8 ; 61.7 ; 8.6 ;2;14;116;0;2;1;1;0;2;1;1;0
10689; 48.3 ; 144.9 ; 2.5 ;3;52;171;0;3;1;2;2;1;0;3;0
10690; 32.3 ; 161.5 ; 16.8 ;5;62;134;0;5;2;3;2;3;2;3;0
10691; 54.7 ; 602.0 ; 35.5 ;11;12;164;0;11;2;9;6;5;4;3;4
10692; 53.9 ; 161.8 ; 5.3 ;3;32;13;0;3;2;1;2;1;0;2;1
10693; 63.3 ; 380.1 ; 32.3 ;6;50;20;0;6;2;4;1;5;0;0;6
10694; 31.0 ; 92.9 ; 1.9 ;3;144;38;0;3;2;1;1;2;1;2;0
10695; 19.8 ; 454.9 ; 5.1 ;23;9;1;0;23;13;10;15;8;23;0;0
10696; 23.1 ; 46.1 ; 3.0 ;2;18;226;0;2;0;2;2;0;2;0;0
10697; 24.8 ; 322.4 ; 6.2 ;13;24;4;0;13;7;6;13;0;9;4;0
10698; 48.2 ; 337.7 ; 13.3 ;7;59;36;0;7;0;7;6;1;0;5;2
10699; 21.7 ; 65.1 ; 6.2 ;3;48;9;0;3;2;1;1;2;3;0;0
10700; 19.2 ; 57.6 ; 4.2 ;3;169;1;0;3;0;3;2;1;3;0;0
10701; 47.0 ; 141.0 ; 0.4 ;3;167;98;0;3;1;2;1;2;0;3;0
10702; 30.4 ; 121.4 ; 0.4 ;4;104;9;0;4;3;1;2;2;1;3;0
10703; 47.6 ; 333.2 ; 16.7 ;7;22;65;0;7;3;4;3;4;0;5;2
10704; 50.3 ; 1,055.6 ; 16.8 ;21;18;26;1;20;10;11;9;12;0;14;7
10705; 25.4 ; 1,623.8 ; 11.4 ;64;4;1;0;64;29;35;19;45;43;21;0
10706; 45.4 ; 272.2 ; 7.3 ;6;20;26;6;0;1;5;2;4;0;6;0
10707; 26.8 ; 53.5 ; 2.5 ;2;236;5;0;2;1;1;1;1;2;0;0
10708; 22.5 ; 44.9 ; 4.8 ;2;91;224;0;2;1;1;1;1;2;0;0
10709; 15.0 ; 104.9 ; -   ;7;7;4;0;7;5;2;0;7;7;0;0
10710; 47.8 ; 95.5 ; 1.5 ;2;10;299;0;2;1;1;1;1;0;2;0
10711; 18.0 ; 89.9 ; 4.5 ;5;4;3;5;0;5;0;5;0;5;0;0
10712; 27.6 ; 55.3 ; 3.8 ;2;113;121;1;1;0;2;1;1;1;1;0
10713; 33.8 ; 101.4 ; 13.7 ;3;116;101;0;3;0;3;1;2;1;2;0
10714; 39.0 ; 351.2 ; 12.3 ;9;29;29;0;9;2;7;5;4;3;6;0
10715; 22.3 ; 67.0 ; 5.9 ;3;54;4;0;3;1;2;2;1;3;0;0
10716; 21.8 ; 87.4 ; 5.9 ;4;29;98;0;4;3;1;2;2;4;0;0
10717; 45.5 ; 318.8 ; 14.5 ;7;62;27;0;7;5;2;7;0;0;5;2
10718; 70.7 ; 282.7 ; 7.0 ;4;33;263;0;4;0;4;4;0;0;0;4
10719; 56.7 ; 396.8 ; 23.6 ;7;42;42;0;7;0;7;4;3;0;0;7
10720; 83.1 ; 581.6 ; 69.4 ;7;30;23;0;7;1;6;3;4;2;0;5
10721; 26.4 ; 131.8 ; 9.4 ;5;8;1;0;5;3;2;3;2;3;2;0
10722; 30.7 ; 153.3 ; 8.9 ;5;11;128;0;5;3;2;1;4;2;3;0
10723; 72.1 ; 648.5 ; 16.5 ;9;26;5;9;0;0;9;7;2;0;0;9
10724; 32.3 ; 64.5 ; -   ;2;5;233;0;2;1;1;0;2;0;2;0
10725; 27.3 ; 164.0 ; 3.0 ;6;9;176;0;6;4;2;2;4;4;2;0
10726; 47.2 ; 141.7 ; 0.4 ;3;59;26;0;3;2;1;2;1;0;3;0
10727; 34.8 ; 139.3 ; 10.2 ;4;40;2;0;4;3;1;2;2;1;3;0
10728; 31.2 ; 62.5 ; 24.3 ;2;140;29;2;0;2;0;2;0;1;0;1
10729; 73.3 ; 586.3 ; 28.7 ;8;36;8;0;8;2;6;5;3;0;0;8
10730; 32.2 ; 96.7 ; 24.0 ;3;143;30;0;3;3;0;1;2;1;1;1
10731; 57.6 ; 172.8 ; 10.0 ;3;87;99;0;3;1;2;2;1;0;0;3
10732; 44.8 ; 89.6 ; 2.9 ;2;6;154;0;2;2;0;0;2;0;2;0
10733; 76.6 ; 382.8 ; 10.1 ;5;24;167;0;5;0;5;5;0;0;0;5
10734; 60.0 ; 239.9 ; 19.0 ;4;90;110;0;4;0;4;4;0;0;0;4
10735; 23.1 ; 115.3 ; 4.8 ;5;28;60;0;5;2;3;3;2;5;0;0
10736; 15.0 ; 74.9 ; -   ;5;59;35;0;5;0;5;2;3;5;0;0
10737; 15.0 ; 30.0 ; -   ;2;37;258;0;2;0;2;2;0;2;0;0
10738; 35.9 ; 71.8 ; 16.2 ;2;16;121;0;2;1;1;2;0;1;1;0
10739; 46.3 ; 231.5 ; 13.1 ;5;94;73;0;5;2;3;4;1;0;3;2
10740; 24.5 ; 49.1 ; 2.4 ;2;82;161;0;2;2;0;2;0;2;0;0
10741; 46.6 ; 233.0 ; 9.9 ;5;25;0;0;5;0;5;5;0;0;3;2
10742; 28.0 ; 335.7 ; 5.2 ;12;20;21;0;12;5;7;2;10;8;4;0
10743; 47.5 ; 94.9 ; -   ;2;80;26;0;2;0;2;0;2;0;2;0
10744; 15.0 ; 30.0 ; -   ;2;105;116;0;2;0;2;1;1;2;0;0
10745; 41.1 ; 369.8 ; 20.1 ;9;23;17;0;9;5;4;3;6;3;3;3
10746; 25.4 ; 76.3 ; 0.4 ;3;2;176;0;3;1;2;1;2;3;0;0
10747; 108.8 ; 870.1 ; 51.1 ;8;25;14;0;8;3;5;6;2;0;0;8
10748; 35.9 ; 179.6 ; 11.0 ;5;38;63;0;5;0;5;3;2;2;3;0
10749; 30.8 ; 61.7 ; 8.6 ;2;8;277;0;2;1;1;0;2;1;1;0
10750; 51.2 ; 306.9 ; 9.2 ;6;27;32;0;6;0;6;4;2;0;4;2
10751; 44.9 ; 899.0 ; 15.3 ;20;16;10;0;20;0;20;16;4;7;6;7
10752; 48.2 ; 96.3 ; 0.8 ;2;9;175;2;0;2;0;1;1;0;2;0
10753; 44.1 ; 176.5 ; 28.6 ;4;11;110;0;4;2;2;4;0;1;2;1
10754; 39.0 ; 78.0 ; 0.1 ;2;52;299;0;2;0;2;0;2;0;2;0
10755; 39.8 ; 796.1 ; 14.6 ;20;14;60;0;20;6;14;8;12;7;13;0
10756; 38.5 ; 76.9 ; 12.4 ;2;5;231;0;2;0;2;0;2;1;1;0
10757; 28.5 ; 114.0 ; 7.5 ;4;31;3;4;0;3;1;1;3;3;1;0
10758; 47.7 ; 95.5 ; 1.5 ;2;131;168;0;2;0;2;1;1;0;2;0
10759; 72.1 ; 144.3 ; 11.2 ;2;283;23;1;1;2;0;2;0;0;0;2
10760; 16.7 ; 150.5 ; 3.1 ;9;23;101;0;9;4;5;9;0;9;0;0
10761; 36.3 ; 290.3 ; 35.0 ;8;24;100;0;8;5;3;2;6;3;2;3
10762; 22.5 ; 112.4 ; 8.7 ;5;8;145;0;5;3;2;3;2;3;2;0
10763; 22.7 ; 522.2 ; 10.6 ;23;14;0;0;23;5;18;20;3;15;8;0
10764; 35.4 ; 389.1 ; 14.1 ;11;17;171;0;11;6;5;2;9;4;7;0
10765; 24.5 ; 73.4 ; 2.2 ;3;14;233;0;3;3;0;3;0;3;0;0
10766; 38.8 ; 232.9 ; 13.8 ;6;17;32;0;6;3;3;3;3;2;4;0
10767; 32.1 ; 128.4 ; 9.9 ;4;91;40;0;4;1;3;4;0;1;3;0
10768; 37.7 ; 415.1 ; 20.4 ;11;23;0;0;11;2;9;11;0;4;3;4
10769; 39.7 ; 79.5 ; 15.5 ;2;56;22;0;2;0;2;2;0;1;0;1
10770; 27.7 ; 194.1 ; 13.7 ;7;17;229;0;7;2;5;3;4;5;2;0
10771; 38.0 ; 341.8 ; 9.6 ;9;30;30;0;9;3;6;5;4;3;6;0
10772; 25.5 ; 561.9 ; 24.5 ;22;14;9;0;22;17;5;22;0;15;7;0
10773; 42.9 ; 171.4 ; 13.3 ;4;5;254;0;4;4;0;1;3;1;2;1
10774; 47.3 ; 330.8 ; 13.3 ;7;26;73;0;7;0;7;1;6;0;5;2
10775; 15.0 ; 134.9 ; -   ;9;9;16;0;9;5;4;8;1;9;0;0
10776; 21.5 ; 258.6 ; 3.6 ;12;22;2;12;0;11;1;12;0;12;0;0
10777; 44.0 ; 263.7 ; 19.8 ;6;49;8;0;6;5;1;4;2;2;2;2
10778; 43.6 ; 87.2 ; 10.5 ;2;13;110;0;2;0;2;2;0;0;2;0
10779; 68.1 ; 136.2 ; 3.2 ;2;12;203;0;2;2;0;2;0;0;0;2
10780; 21.4 ; 150.0 ; 6.2 ;7;15;6;0;7;3;4;5;2;7;0;0
10781; 41.2 ; 123.5 ; 48.0 ;3;96;116;0;3;1;2;2;1;1;1;1
10782; 50.0 ; 100.0 ; 30.0 ;2;38;147;0;2;0;2;1;1;1;0;1
10783; 30.1 ; 301.0 ; 12.8 ;10;23;23;10;0;3;7;1;9;3;7;0
10784; 49.0 ; 637.6 ; 12.7 ;13;14;20;0;13;4;9;7;6;0;9;4
10785; 33.4 ; 66.8 ; 4.8 ;2;140;99;2;0;1;1;0;2;1;1;0
10786; 21.7 ; 649.7 ; 7.2 ;30;10;5;1;29;7;23;25;5;30;0;0
10787; 45.2 ; 90.4 ; 12.0 ;2;251;52;0;2;0;2;1;1;0;1;1
10788; 15.6 ; 46.7 ; 1.9 ;3;49;17;0;3;1;2;1;2;3;0;0
10789; 43.0 ; 86.1 ; 5.6 ;2;10;262;0;2;1;1;0;2;0;2;0
10790; 32.8 ; 983.8 ; 11.8 ;30;10;8;0;30;14;16;29;1;10;20;0
10791; 30.2 ; 90.6 ; -   ;3;83;136;0;3;1;2;2;1;0;3;0
10792; 30.5 ; 122.0 ; 11.5 ;4;52;107;1;3;3;1;2;2;1;3;0
10793; 49.4 ; 98.8 ; 36.5 ;2;5;350;0;2;2;0;2;0;1;0;1
10794; 46.3 ; 138.9 ; 3.2 ;3;132;42;0;3;0;3;1;2;0;3;0
10795; 20.0 ; 40.1 ; 7.6 ;2;98;106;0;2;0;2;1;1;2;0;0
10796; 28.4 ; 198.7 ; 20.8 ;7;13;14;7;0;7;0;0;7;5;2;0
10797; 54.8 ; 109.6 ; 27.3 ;2;163;125;0;2;0;2;2;0;1;0;1
10798; 21.9 ; 109.3 ; 4.8 ;5;27;2;0;5;2;3;1;4;5;0;0
10799; 50.6 ; 101.2 ; 1.5 ;2;56;173;0;2;0;2;2;0;0;2;0
10800; 22.8 ; 159.5 ; 12.8 ;7;33;99;0;7;0;7;4;3;5;2;0
10801; 64.3 ; 128.6 ; 8.0 ;2;10;8;0;2;1;1;0;2;0;0;2
10802; 50.5 ; 303.0 ; 30.9 ;6;22;202;0;6;5;1;1;5;2;2;2
10803; 29.7 ; 118.9 ; 14.8 ;4;5;275;0;4;2;2;0;4;3;1;0
10804; 76.3 ; 152.5 ; 43.1 ;2;113;79;0;2;0;2;2;0;0;0;2
10805; 36.0 ; 180.1 ; 33.4 ;5;20;31;0;5;2;3;4;1;2;1;2
10806; 15.9 ; 111.2 ; 1.8 ;7;18;80;7;0;3;4;7;0;7;0;0
10807; 49.7 ; 547.0 ; 5.9 ;11;10;16;1;10;0;11;9;2;0;7;4
10808; 20.6 ; 103.2 ; 5.2 ;5;36;19;0;5;3;2;2;3;5;0;0
10809; 41.8 ; 83.6 ; 40.1 ;2;69;5;0;2;0;2;0;2;1;0;1
10810; 51.6 ; 361.3 ; 12.2 ;7;39;146;0;7;3;4;4;3;0;5;2
10811; 27.6 ; 55.3 ; 3.8 ;2;128;158;0;2;1;1;0;2;1;1;0
10812; 64.0 ; 320.0 ; 35.6 ;5;48;14;0;5;5;0;2;3;2;0;3
10813; 88.6 ; 265.7 ; 31.2 ;3;55;67;2;1;2;1;1;2;0;0;3
10814; 21.6 ; 108.2 ; 14.1 ;5;58;12;0;5;1;4;1;4;3;2;0
10815; 38.7 ; 116.1 ; 16.0 ;3;185;24;0;3;3;0;1;2;1;2;0
10816; 45.0 ; 495.4 ; 22.7 ;11;44;0;0;11;0;11;6;5;4;3;4
10817; 48.5 ; 97.0 ; 27.4 ;2;177;183;1;1;0;2;2;0;1;0;1
10818; 47.1 ; 94.2 ; 0.5 ;2;62;88;2;0;2;0;0;2;0;2;0
10819; 39.6 ; 197.8 ; 19.3 ;5;8;214;0;5;2;3;1;4;2;1;2
10820; 52.8 ; 158.5 ; 19.7 ;3;12;221;0;3;0;3;1;2;0;2;1
10821; 93.2 ; 372.9 ; 5.7 ;4;76;10;0;4;0;4;2;2;0;0;4
10822; 35.6 ; 426.7 ; 14.7 ;12;25;10;0;12;2;10;9;3;4;8;0
10823; 32.6 ; 130.3 ; 3.7 ;4;5;380;0;4;4;0;1;3;1;3;0
10824; 33.8 ; 67.5 ; 28.1 ;2;144;152;0;2;1;1;2;0;1;0;1
10825; 48.4 ; 96.7 ; 15.4 ;2;50;152;2;0;0;2;1;1;0;1;1
10826; 23.3 ; 326.8 ; 3.6 ;14;5;89;0;14;7;7;9;5;14;0;0
10827; 40.6 ; 81.2 ; 23.2 ;2;18;299;0;2;1;1;2;0;1;0;1
10828; 31.0 ; 154.9 ; 17.6 ;5;78;23;0;5;2;3;3;2;2;3;0
10829; 19.1 ; 133.8 ; 11.1 ;7;25;167;0;7;0;7;1;6;5;2;0
10830; 18.5 ; 73.8 ; 1.5 ;4;10;72;0;4;3;1;1;3;4;0;0
10831; 45.0 ; 585.2 ; 15.6 ;13;19;65;0;13;4;9;4;9;4;5;4
10832; 59.2 ; 473.2 ; 17.7 ;8;39;15;0;8;1;7;5;3;0;0;8
10833; 31.1 ; 62.2 ; 9.1 ;2;41;122;0;2;1;1;2;0;1;1;0
10834; 26.5 ; 53.0 ; 2.1 ;2;6;181;0;2;2;0;0;2;2;0;0
10835; 56.6 ; 226.3 ; 21.3 ;4;46;189;0;4;2;2;3;1;0;0;4
10836; 39.6 ; 1,069.9 ; 10.4 ;27;11;6;0;27;0;27;3;24;9;18;0
10837; 36.0 ; 108.0 ; 20.4 ;3;70;140;0;3;2;1;2;1;1;1;1
10838; 34.2 ; 409.8 ; 9.6 ;12;26;116;0;12;3;9;6;6;4;8;0
10839; 64.7 ; 129.5 ; 26.9 ;2;4;259;0;2;1;1;0;2;0;0;2
10840; 47.8 ; 95.7 ; 0.5 ;2;79;7;0;2;1;1;1;1;0;2;0
10841; 48.5 ; 290.8 ; 19.8 ;6;45;10;0;6;0;6;6;0;2;2;2
10842; 45.7 ; 274.3 ; 14.4 ;6;51;12;0;6;0;6;3;3;0;4;2
10843; 37.1 ; 185.6 ; 11.3 ;5;7;0;0;5;2;3;4;1;2;3;0
10844; 24.5 ; 196.4 ; 11.6 ;8;18;36;0;8;1;7;4;4;5;3;0
10845; 20.0 ; 59.9 ; 9.2 ;3;104;26;0;3;0;3;3;0;3;0;0
10846; 56.0 ; 335.9 ; 45.4 ;6;46;41;0;6;1;5;4;2;2;0;4
10847; 36.0 ; 252.3 ; 4.4 ;7;14;8;0;7;1;6;3;4;0;7;0
10848; 21.1 ; 358.5 ; 2.6 ;17;17;11;0;17;0;17;5;12;17;0;0
10849; 54.8 ; 109.6 ; 8.2 ;2;89;15;0;2;0;2;2;0;0;1;1
10850; 70.7 ; 353.3 ; 20.0 ;5;7;22;0;5;1;4;5;0;0;0;5
10851; 50.0 ; 449.7 ; 17.1 ;9;15;78;0;9;0;9;8;1;0;6;3
10852; 35.1 ; 105.3 ; 5.7 ;3;34;134;0;3;3;0;0;3;1;2;0
10853; 37.6 ; 413.6 ; 20.1 ;11;11;173;0;11;3;8;3;8;4;3;4
10854; 46.2 ; 138.7 ; 15.9 ;3;72;110;0;3;0;3;3;0;0;2;1
10855; 25.1 ; 50.1 ; -   ;2;130;8;2;0;1;1;0;2;2;0;0
10856; 59.8 ; 836.7 ; 21.8 ;14;21;10;0;14;0;14;13;1;0;0;14
10857; 74.5 ; 148.9 ; 41.5 ;2;270;7;1;1;2;0;0;2;0;0;2
10858; 61.4 ; 122.8 ; 22.0 ;2;94;116;0;2;0;2;1;1;0;0;2
10859; 31.1 ; 124.3 ; 19.2 ;4;49;159;1;3;3;1;4;0;1;3;0
10860; 35.7 ; 178.5 ; 13.6 ;5;11;59;0;5;1;4;4;1;2;3;0
10861; 25.4 ; 101.7 ; 14.8 ;4;40;11;0;4;0;4;2;2;3;1;0
10862; 38.8 ; 77.6 ; 20.5 ;2;16;336;0;2;1;1;1;1;1;0;1
10863; 79.8 ; 159.7 ; 14.6 ;2;26;120;0;2;0;2;1;1;0;0;2
10864; 52.2 ; 261.1 ; 2.9 ;5;17;214;0;5;3;2;2;3;0;3;2
10865; 19.3 ; 38.6 ; 1.1 ;2;16;2;2;0;1;1;0;2;2;0;0
10866; 40.5 ; 162.1 ; 14.2 ;4;86;5;0;4;1;3;2;2;1;3;0
10867; 23.6 ; 70.7 ; 9.2 ;3;54;203;0;3;2;1;1;2;2;1;0
10868; 15.0 ; 30.0 ; -   ;2;7;378;0;2;1;1;2;0;2;0;0
10869; 25.1 ; 50.1 ; -   ;2;5;369;0;2;1;1;2;0;2;0;0
10870; 51.3 ; 154.0 ; 31.4 ;3;50;90;0;3;0;3;1;2;1;1;1
10871; 33.3 ; 133.3 ; 9.7 ;4;70;9;0;4;3;1;2;2;1;3;0
10872; 30.1 ; 271.0 ; 8.0 ;9;34;0;0;9;1;8;4;5;3;6;0
10873; 17.9 ; 107.6 ; 4.3 ;6;16;27;0;6;3;3;1;5;6;0;0
10874; 22.7 ; 999.7 ; 13.9 ;44;11;2;0;44;16;28;17;27;29;15;0
10875; 49.6 ; 99.2 ; 3.2 ;2;6;84;2;0;0;2;2;0;0;2;0
10876; 41.8 ; 418.5 ; 8.2 ;10;31;5;0;10;6;4;3;7;0;10;0
10877; 54.5 ; 163.6 ; 17.9 ;3;59;62;0;3;1;2;2;1;0;2;1
10878; 56.4 ; 112.7 ; 26.0 ;2;11;253;0;2;0;2;0;2;0;0;2
10879; 23.3 ; 116.5 ; 4.8 ;5;60;148;0;5;3;2;4;1;5;0;0
10880; 30.3 ; 121.2 ; 30.3 ;4;34;109;0;4;2;2;2;2;1;2;1
10881; 40.4 ; 323.5 ; 16.8 ;8;28;18;0;8;3;5;2;6;3;2;3
10882; 47.4 ; 379.0 ; 15.0 ;8;22;162;0;8;0;8;7;1;0;5;3
10883; 45.8 ; 91.6 ; 31.1 ;2;81;142;0;2;0;2;1;1;1;0;1
10884; 41.8 ; 167.2 ; 13.8 ;4;66;47;0;4;1;3;2;2;1;2;1
10885; 39.1 ; 195.6 ; 15.2 ;5;13;272;0;5;2;3;3;2;2;3;0
10886; 40.6 ; 81.2 ; 4.0 ;2;50;49;0;2;1;1;0;2;0;2;0
10887; 45.8 ; 91.6 ; 10.0 ;2;60;218;0;2;1;1;2;0;0;1;1
10888; 60.5 ; 181.4 ; 57.0 ;3;160;101;0;3;0;3;3;0;1;0;2
10889; 30.6 ; 122.5 ; 6.8 ;4;13;178;0;4;0;4;2;2;1;3;0
10890; 31.7 ; 63.5 ; 7.3 ;2;68;22;0;2;0;2;1;1;1;1;0
10891; 18.8 ; 751.1 ; 10.1 ;40;11;5;0;40;13;27;29;11;40;0;0
10892; 38.3 ; 306.4 ; 9.3 ;8;44;0;0;8;1;7;2;6;3;5;0
10893; 46.8 ; 93.5 ; -   ;2;119;105;0;2;0;2;2;0;0;2;0
10894; 55.2 ; 386.2 ; 25.2 ;7;23;5;0;7;0;7;6;1;2;0;5
10895; 32.0 ; 672.9 ; 16.3 ;21;20;31;0;21;14;7;12;9;7;14;0
10896; 30.5 ; 183.1 ; 12.2 ;6;19;92;0;6;0;6;4;2;2;4;0
10897; 27.6 ; 55.3 ; 3.8 ;2;122;204;0;2;1;1;2;0;1;1;0
10898; 41.7 ; 83.4 ; 7.6 ;2;6;178;0;2;0;2;2;0;0;2;0
10899; 24.0 ; 120.1 ; 13.6 ;5;23;183;0;5;1;4;3;2;3;2;0
10900; 42.6 ; 85.2 ; 11.4 ;2;17;269;0;2;0;2;1;1;0;2;0
10901; 24.4 ; 48.8 ; 8.7 ;2;6;267;0;2;0;2;1;1;1;1;0
10902; 17.1 ; 34.2 ; 3.2 ;2;58;35;0;2;1;1;1;1;2;0;0
10903; 61.0 ; 304.9 ; 40.0 ;5;11;29;0;5;3;2;0;5;2;0;3
10904; 38.2 ; 152.6 ; 3.3 ;4;41;192;0;4;3;1;1;3;0;4;0
10905; 30.8 ; 339.0 ; 19.4 ;11;21;78;0;11;5;6;4;7;4;7;0
10906; 48.1 ; 96.1 ; 1.9 ;2;295;32;0;2;0;2;0;2;0;2;0
10907; 23.1 ; 46.2 ; 3.9 ;2;163;134;0;2;2;0;2;0;2;0;0
10908; 47.5 ; 94.9 ; 1.1 ;2;151;10;0;2;0;2;2;0;0;2;0
10909; 32.8 ; 98.3 ; 7.0 ;3;1;2;0;3;2;1;2;1;1;2;0
10910; 74.0 ; 665.8 ; 17.9 ;9;23;93;0;9;2;7;3;6;0;0;9
10911; 32.3 ; 64.5 ; 21.7 ;2;12;213;0;2;2;0;0;2;1;1;0
10912; 74.4 ; 148.8 ; 3.8 ;2;163;110;0;2;0;2;2;0;0;0;2
10913; 26.8 ; 80.4 ; 14.0 ;3;5;217;0;3;3;0;2;1;2;1;0
10914; 87.3 ; 349.2 ; 17.9 ;4;92;22;0;4;1;3;4;0;0;0;4
10915; 28.1 ; 253.1 ; 15.7 ;9;25;239;0;9;2;7;5;4;6;3;0
10916; 37.0 ; 73.9 ; 0.5 ;2;2;5;0;2;1;1;1;1;0;2;0
10917; 19.0 ; 341.5 ; 11.5 ;18;17;8;0;18;18;0;5;13;12;6;0
10918; 15.0 ; 45.0 ; -   ;3;41;83;0;3;2;1;0;3;3;0;0
10919; 71.1 ; 142.1 ; 33.6 ;2;7;110;0;2;0;2;2;0;0;0;2
10920; 55.2 ; 110.4 ; 12.6 ;2;4;203;2;0;2;0;0;2;0;0;2
10921; 21.3 ; 85.1 ; 4.9 ;4;36;268;0;4;0;4;2;2;4;0;0
10922; 28.7 ; 143.7 ; 13.1 ;5;10;239;0;5;2;3;0;5;3;2;0
10923; 47.5 ; 570.3 ; 12.8 ;12;15;47;0;12;2;10;8;4;0;8;4
10924; 42.7 ; 128.0 ; 8.0 ;3;13;78;0;3;0;3;1;2;0;3;0
10925; 27.9 ; 725.5 ; 16.9 ;26;5;274;0;26;15;11;6;20;17;9;0
10926; 24.3 ; 48.6 ; 13.9 ;2;3;188;0;2;1;1;2;0;1;1;0
10927; 18.6 ; 55.7 ; -   ;3;7;266;0;3;3;0;1;2;3;0;0
10928; 52.0 ; 104.0 ; 32.6 ;2;35;317;0;2;1;1;1;1;1;0;1
10929; 59.4 ; 831.5 ; 29.7 ;14;20;0;0;14;0;14;11;3;5;0;9
10930; 20.4 ; 143.1 ; 4.9 ;7;14;35;0;7;3;4;1;6;7;0;0
10931; 51.5 ; 257.3 ; 14.9 ;5;16;242;0;5;2;3;4;1;0;3;2
10932; 49.0 ; 147.0 ; 0.5 ;3;92;47;0;3;1;2;2;1;0;3;0
10933; 21.1 ; 63.3 ; 2.6 ;3;19;278;0;3;0;3;1;2;3;0;0
10934; 30.0 ; 479.4 ; 12.5 ;16;18;10;0;16;1;15;12;4;11;5;0
10935; 59.2 ; 355.2 ; 36.1 ;6;25;127;0;6;0;6;4;2;2;0;4
10936; 20.3 ; 874.3 ; 7.6 ;43;10;10;0;43;19;24;25;18;43;0;0
10937; 28.5 ; 142.5 ; 19.7 ;5;45;62;0;5;0;5;1;4;3;2;0
10938; 40.6 ; 81.1 ; 18.7 ;2;12;64;0;2;0;2;0;2;1;0;1
10939; 34.8 ; 243.6 ; 21.2 ;7;40;41;0;7;3;4;7;0;2;3;2
10940; 15.0 ; 45.0 ; -   ;3;3;38;0;3;2;1;1;2;3;0;0
10941; 17.0 ; 51.1 ; 3.7 ;3;60;5;0;3;0;3;3;0;3;0;0
10942; 24.6 ; 615.6 ; 7.7 ;25;5;128;0;25;15;10;3;22;17;8;0
10943; 48.7 ; 146.2 ; 48.8 ;3;6;254;0;3;3;0;1;2;1;1;1
10944; 21.7 ; 65.1 ; 6.2 ;3;43;89;0;3;0;3;1;2;3;0;0
10945; 21.8 ; 108.8 ; 9.1 ;5;6;161;0;5;5;0;0;5;3;2;0
10946; 50.3 ; 251.5 ; 15.0 ;5;25;179;0;5;1;4;3;2;0;3;2
10947; 19.3 ; 232.2 ; 4.2 ;12;10;24;0;12;5;7;8;4;12;0;0
10948; 16.8 ; 151.2 ; 3.2 ;9;30;43;0;9;2;7;1;8;9;0;0
10949; 26.1 ; 78.4 ; -   ;3;7;17;0;3;2;1;1;2;3;0;0
10950; 15.0 ; 30.0 ; -   ;2;112;87;2;0;2;0;1;1;2;0;0
10951; 57.1 ; 342.6 ; 27.2 ;6;30;97;0;6;3;3;2;4;2;0;4
10952; 30.5 ; 91.6 ; 14.4 ;3;29;209;0;3;1;2;1;2;1;2;0
10953; 35.4 ; 106.1 ; 15.8 ;3;25;204;0;3;0;3;2;1;1;2;0
10954; 50.2 ; 551.7 ; 20.7 ;11;22;47;0;11;3;8;4;7;4;3;4
10955; 42.3 ; 84.6 ; 21.6 ;2;220;16;0;2;0;2;0;2;1;0;1
10956; 38.7 ; 154.9 ; 29.7 ;4;8;254;0;4;3;1;2;2;1;2;1
10957; 26.1 ; 52.3 ; -   ;2;13;176;0;2;2;0;2;0;2;0;0
10958; 21.7 ; 65.1 ; 6.2 ;3;59;184;0;3;0;3;3;0;3;0;0
10959; 47.1 ; 94.2 ; 0.5 ;2;157;63;2;0;0;2;1;1;0;2;0
10960; 47.7 ; 95.5 ; 1.5 ;2;12;236;0;2;0;2;1;1;0;2;0
10961; 29.9 ; 89.6 ; 8.7 ;3;49;221;0;3;1;2;1;2;2;1;0
10962; 27.9 ; 167.3 ; 5.1 ;6;26;26;0;6;2;4;3;3;4;2;0
10963; 35.0 ; 139.8 ; 12.9 ;4;2;268;0;4;0;4;2;2;1;3;0
10964; 15.0 ; 30.0 ; -   ;2;7;235;0;2;1;1;1;1;2;0;0
10965; 37.9 ; 189.6 ; 9.6 ;5;85;26;0;5;1;4;1;4;2;3;0
10966; 15.9 ; 159.0 ; 3.2 ;10;17;39;4;6;10;0;8;2;10;0;0
10967; 30.6 ; 520.1 ; 12.3 ;17;20;26;0;17;9;8;9;8;6;11;0
10968; 66.7 ; 400.2 ; 74.1 ;6;29;12;0;6;4;2;0;6;2;0;4
10969; 20.3 ; 81.1 ; 7.5 ;4;44;157;0;4;1;3;2;2;4;0;0
10970; 47.4 ; 237.1 ; 1.0 ;5;79;5;0;5;1;4;3;2;0;5;0
10971; 25.6 ; 76.7 ; 11.4 ;3;16;93;0;3;1;2;2;1;2;1;0
10972; 25.4 ; 126.9 ; 5.8 ;5;5;246;0;5;0;5;0;5;3;2;0
10973; 63.6 ; 127.3 ; 3.2 ;2;7;220;0;2;0;2;2;0;0;0;2
10974; 47.1 ; 94.2 ; 0.5 ;2;75;73;0;2;0;2;2;0;0;2;0
10975; 78.7 ; 157.4 ; 24.3 ;2;3;65;0;2;2;0;0;2;0;0;2
10976; 43.8 ; 175.1 ; 16.6 ;4;14;272;0;4;2;2;2;2;1;2;1
10977; 31.0 ; 155.1 ; 12.9 ;5;14;160;0;5;1;4;4;1;2;3;0
10978; 28.7 ; 86.0 ; 22.6 ;3;115;75;0;3;2;1;1;2;2;1;0
10979; 49.1 ; 245.4 ; 2.7 ;5;96;26;2;3;0;5;4;1;0;5;0
10980; 42.6 ; 85.3 ; 9.1 ;2;11;259;0;2;1;1;1;1;0;2;0
10981; 41.1 ; 575.4 ; 17.7 ;14;20;21;0;14;3;11;8;6;5;4;5
10982; 49.6 ; 99.2 ; 3.2 ;2;14;45;0;2;2;0;1;1;0;2;0
10983; 55.7 ; 278.7 ; 5.1 ;5;23;11;0;5;1;4;1;4;0;0;5
10984; 90.2 ; 180.3 ; 42.6 ;2;50;134;2;0;2;0;0;2;0;0;2
10985; 39.2 ; 235.0 ; 21.9 ;6;59;47;0;6;0;6;4;2;2;2;2
10986; 38.0 ; 114.0 ; 17.8 ;3;67;272;0;3;0;3;3;0;1;1;1
10987; 25.8 ; 51.6 ; 16.2 ;2;45;170;0;2;2;0;2;0;1;1;0
10988; 46.3 ; 92.6 ; 24.2 ;2;5;28;0;2;2;0;2;0;1;0;1
10989; 40.3 ; 563.7 ; 55.2 ;14;21;3;0;14;5;9;3;11;5;4;5
10990; 51.4 ; 102.8 ; 2.7 ;2;194;86;0;2;1;1;2;0;0;2;0
10991; 38.6 ; 386.2 ; 14.8 ;10;15;0;0;10;1;9;1;9;3;7;0
10992; 28.2 ; 423.3 ; 8.6 ;15;12;2;0;15;7;8;7;8;10;5;0
10993; 52.7 ; 263.3 ; 0.3 ;5;54;41;0;5;4;1;1;4;0;5;0
10994; 84.4 ; 168.8 ; 81.2 ;2;19;140;2;0;2;0;0;2;1;0;1
10995; 33.3 ; 166.7 ; 14.7 ;5;23;14;0;5;4;1;3;2;2;3;0
10996; 32.7 ; 392.6 ; 17.4 ;12;23;52;0;12;5;7;3;9;4;8;0
10997; 49.4 ; 197.6 ; 3.6 ;4;42;10;0;4;0;4;4;0;0;4;0
10998; 31.1 ; 62.2 ; 15.5 ;2;5;284;0;2;0;2;1;1;1;1;0
10999; 15.0 ; 30.0 ; -   ;2;31;291;0;2;2;0;1;1;2;0;0
11000; 69.9 ; 209.8 ; 24.6 ;3;55;39;0;3;2;1;3;0;0;0;3
11001; 36.4 ; 291.6 ; 13.7 ;8;31;131;0;8;4;4;7;1;3;5;0
11002; 36.0 ; 180.0 ; 26.5 ;5;41;3;0;5;2;3;3;2;2;1;2
11003; 52.8 ; 105.7 ; 8.0 ;2;9;92;0;2;1;1;1;1;0;1;1
11004; 52.5 ; 105.0 ; 8.6 ;2;208;99;0;2;0;2;2;0;0;1;1
11005; 41.6 ; 83.2 ; 7.7 ;2;71;225;0;2;1;1;1;1;0;2;0
11006; 30.5 ; 274.8 ; 17.1 ;9;14;64;0;9;5;4;4;5;3;6;0
11007; 41.2 ; 617.5 ; 11.0 ;15;19;13;0;15;6;9;11;4;0;15;0
11008; 40.9 ; 122.8 ; 10.7 ;3;76;246;0;3;1;2;3;0;0;3;0
11009; 30.4 ; 212.7 ; 11.9 ;7;29;92;0;7;3;4;1;6;2;5;0
11010; 54.0 ; 216.1 ; 21.2 ;4;60;62;0;4;1;3;3;1;0;3;1
11011; 19.1 ; 38.3 ; 0.8 ;2;20;251;0;2;0;2;2;0;2;0;0
11012; 90.2 ; 180.5 ; 49.0 ;2;5;251;0;2;1;1;1;1;0;0;2
11013; 64.0 ; 256.0 ; 21.0 ;4;14;190;0;4;0;4;4;0;0;0;4
11014; 19.7 ; 78.9 ; 0.0 ;4;16;318;0;4;4;0;4;0;4;0;0
11015; 20.0 ; 59.9 ; 9.2 ;3;41;83;0;3;3;0;3;0;3;0;0
11016; 20.5 ; 225.5 ; 7.4 ;11;18;89;0;11;0;11;11;0;11;0;0
11017; 62.1 ; 310.4 ; 17.2 ;5;41;40;0;5;3;2;5;0;0;0;5
11018; 26.4 ; 211.5 ; 9.5 ;8;23;24;0;8;4;4;1;7;5;3;0
11019; 43.8 ; 87.7 ; 4.4 ;2;205;93;0;2;2;0;1;1;0;2;0
11020; 52.4 ; 104.8 ; 1.2 ;2;11;39;0;2;1;1;1;1;0;2;0
11021; 46.7 ; 233.6 ; 35.2 ;5;26;144;0;5;0;5;3;2;2;1;2
11022; 54.9 ; 109.8 ; 27.4 ;2;23;68;0;2;1;1;1;1;1;0;1
11023; 27.4 ; 82.3 ; 7.1 ;3;73;5;0;3;0;3;3;0;2;1;0
11024; 43.2 ; 259.5 ; 12.0 ;6;39;11;0;6;1;5;5;1;0;4;2
11025; 28.7 ; 343.9 ; 22.6 ;12;30;0;0;12;7;5;2;10;8;4;0
11026; 28.2 ; 56.5 ; 13.4 ;2;12;266;0;2;2;0;0;2;1;1;0
11027; 30.4 ; 152.0 ; 9.0 ;5;27;147;0;5;0;5;2;3;2;3;0
11028; 25.1 ; 100.3 ; -   ;4;24;23;0;4;1;3;2;2;4;0;0
11029; 19.2 ; 249.3 ; 4.5 ;13;23;57;7;6;3;10;13;0;13;0;0
11030; 49.3 ; 295.6 ; 11.8 ;6;35;89;0;6;0;6;3;3;0;4;2
11031; 20.0 ; 40.1 ; 7.6 ;2;34;112;0;2;2;0;0;2;2;0;0
11032; 38.3 ; 191.3 ; 6.1 ;5;36;110;0;5;0;5;3;2;0;5;0
11033; 31.2 ; 405.2 ; 8.0 ;13;19;210;0;13;0;13;12;1;4;9;0
11034; 33.7 ; 101.1 ; 15.8 ;3;38;211;0;3;1;2;3;0;1;2;0
11035; 21.2 ; 105.9 ; 3.0 ;5;34;15;0;5;1;4;1;4;5;0;0
11036; 20.8 ; 62.4 ; 5.5 ;3;14;242;0;3;2;1;1;2;3;0;0
11037; 42.2 ; 84.4 ; 25.7 ;2;126;95;0;2;0;2;0;2;1;0;1
11038; 26.2 ; 104.9 ; 7.9 ;4;6;62;0;4;0;4;4;0;3;1;0
11039; 29.1 ; 232.6 ; 8.3 ;8;36;6;0;8;5;3;2;6;5;3;0
11040; 73.1 ; 438.7 ; 22.4 ;6;19;40;0;6;1;5;3;3;0;0;6
11041; 43.7 ; 131.2 ; 21.1 ;3;110;78;0;3;0;3;3;0;1;1;1
11042; 47.2 ; 141.7 ; 0.4 ;3;45;57;0;3;1;2;0;3;0;3;0
11043; 50.5 ; 151.4 ; 25.3 ;3;53;38;0;3;0;3;2;1;1;1;1
11044; 53.6 ; 107.2 ; 0.5 ;2;7;22;0;2;1;1;0;2;0;2;0
11045; 27.5 ; 82.5 ; 22.9 ;3;160;5;0;3;0;3;0;3;2;1;0
11046; 17.2 ; 34.4 ; 3.3 ;2;37;233;0;2;2;0;1;1;2;0;0
11047; 52.4 ; 157.2 ; 9.0 ;3;14;68;0;3;1;2;3;0;0;2;1
11048; 80.5 ; 241.5 ; 51.1 ;3;107;83;0;3;0;3;2;1;1;0;2
11049; 61.6 ; 123.2 ; 1.0 ;2;43;5;0;2;0;2;2;0;0;0;2
11050; 62.6 ; 125.3 ; 35.8 ;2;20;142;0;2;1;1;0;2;1;0;1
11051; 34.4 ; 137.7 ; 9.3 ;4;36;40;0;4;3;1;3;1;1;3;0
11052; 42.1 ; 168.3 ; 8.0 ;4;82;57;0;4;1;3;2;2;0;4;0
11053; 21.7 ; 65.1 ; 6.2 ;3;91;14;3;0;3;0;1;2;3;0;0
11054; 56.3 ; 393.8 ; 14.0 ;7;44;21;0;7;1;6;3;4;0;0;7
11055; 15.0 ; 104.9 ; -   ;7;41;43;0;7;5;2;6;1;7;0;0
11056; 25.1 ; 201.1 ; 3.1 ;8;5;194;0;8;1;7;2;6;8;0;0
11057; 59.3 ; 118.6 ; 51.2 ;2;122;64;0;2;1;1;1;1;1;0;1
11058; 25.4 ; 101.8 ; 15.9 ;4;24;262;0;4;1;3;3;1;3;1;0
11059; 33.0 ; 132.0 ; 19.2 ;4;38;73;0;4;0;4;3;1;1;3;0
11060; 69.9 ; 209.6 ; 69.9 ;3;34;95;1;2;0;3;2;1;1;0;2
11061; 57.3 ; 229.2 ; 29.9 ;4;141;25;0;4;1;3;3;1;1;0;3
11062; 19.3 ; 96.5 ; 5.3 ;5;17;158;0;5;2;3;3;2;5;0;0
11063; 29.6 ; 266.7 ; 12.0 ;9;11;133;0;9;4;5;3;6;6;3;0
11064; 58.0 ; 753.4 ; 43.3 ;13;28;0;0;13;8;5;4;9;4;0;9
11065; 49.1 ; 98.1 ; 2.9 ;2;24;131;0;2;0;2;2;0;0;2;0
11066; 36.1 ; 361.2 ; 4.4 ;10;23;11;0;10;0;10;3;7;0;10;0
11067; 15.0 ; 30.0 ; -   ;2;4;172;0;2;2;0;1;1;2;0;0
11068; 47.0 ; 94.0 ; 8.8 ;2;23;251;0;2;1;1;0;2;0;1;1
11069; 40.7 ; 122.0 ; 27.9 ;3;122;36;0;3;1;2;0;3;1;1;1
11070; 56.6 ; 113.2 ; 10.5 ;2;24;141;0;2;0;2;2;0;0;0;2
11071; 40.2 ; 80.5 ; 5.4 ;2;37;12;0;2;2;0;0;2;0;2;0
11072; 68.9 ; 344.6 ; 63.8 ;5;26;241;0;5;0;5;2;3;2;0;3
11073; 19.8 ; 39.7 ; 1.9 ;2;31;245;0;2;2;0;1;1;2;0;0
11074; 36.8 ; 515.5 ; 18.0 ;14;18;32;0;14;0;14;11;3;5;9;0
11075; 101.5 ; 203.0 ; 72.3 ;2;163;41;0;2;0;2;2;0;1;0;1
11076; 29.9 ; 89.7 ; 18.1 ;3;88;66;1;2;2;1;1;2;2;1;0
11077; 83.3 ; 499.5 ; 24.5 ;6;32;157;0;6;1;5;4;2;0;0;6
11078; 32.7 ; 65.3 ; 21.1 ;2;5;335;0;2;1;1;2;0;1;1;0
11079; 51.0 ; 254.8 ; 37.4 ;5;43;127;0;5;1;4;2;3;2;1;2
11080; 36.6 ; 73.2 ; -   ;2;34;331;0;2;1;1;0;2;0;2;0
11081; 27.6 ; 55.3 ; 3.8 ;2;3;353;0;2;1;1;1;1;1;1;0
11082; 68.6 ; 343.0 ; 21.5 ;5;27;40;0;5;0;5;3;2;0;0;5
11083; 38.6 ; 77.1 ; 6.4 ;2;117;166;0;2;2;0;1;1;0;2;0
11084; 41.2 ; 123.7 ; 10.1 ;3;54;156;0;3;2;1;1;2;0;3;0
11085; 29.6 ; 88.7 ; 18.3 ;3;67;161;0;3;1;2;1;2;2;1;0
11086; 38.3 ; 153.2 ; 15.2 ;4;25;204;0;4;0;4;4;0;1;3;0
11087; 22.5 ; 337.2 ; 13.9 ;15;15;0;0;15;2;13;2;13;10;5;0
11088; 47.2 ; 424.5 ; 6.6 ;9;11;127;0;9;5;4;4;5;0;9;0
11089; 182.4 ; 912.0 ; 94.3 ;5;17;94;0;5;0;5;2;3;0;0;5
11090; 31.1 ; 124.5 ; 6.7 ;4;58;12;0;4;4;0;2;2;1;3;0
11091; 21.6 ; 258.9 ; 5.9 ;12;26;14;0;12;6;6;8;4;12;0;0
11092; 30.8 ; 61.7 ; 8.6 ;2;213;32;0;2;0;2;1;1;1;1;0
11093; 24.7 ; 123.5 ; 5.3 ;5;27;190;0;5;1;4;1;4;5;0;0
11094; 17.5 ; 87.4 ; 6.5 ;5;19;320;0;5;1;4;4;1;5;0;0
11095; 15.3 ; 107.3 ; 1.1 ;7;11;200;0;7;1;6;4;3;7;0;0
11096; 28.9 ; 173.6 ; 15.1 ;6;27;69;0;6;1;5;5;1;4;2;0
11097; 45.7 ; 137.1 ; 2.6 ;3;74;100;0;3;2;1;1;2;0;3;0
11098; 55.8 ; 334.8 ; 19.4 ;6;21;163;0;6;0;6;4;2;0;0;6
11099; 68.6 ; 274.3 ; 27.5 ;4;25;31;0;4;1;3;0;4;0;0;4
11100; 49.2 ; 98.4 ; 5.0 ;2;47;281;0;2;1;1;1;1;0;2;0
11101; 48.8 ; 195.3 ; 7.0 ;4;123;23;0;4;1;3;1;3;0;3;1
11102; 15.4 ; 154.4 ; 1.1 ;10;9;2;0;10;6;4;6;4;10;0;0
11103; 34.5 ; 69.0 ; 24.7 ;2;48;174;0;2;1;1;0;2;1;0;1
11104; 51.4 ; 719.4 ; 30.0 ;14;24;4;0;14;5;9;13;1;5;4;5
11105; 19.7 ; 335.5 ; 6.7 ;17;15;115;0;17;3;14;8;9;17;0;0
11106; 15.9 ; 47.8 ; 1.7 ;3;88;63;0;3;0;3;0;3;3;0;0
11107; 57.6 ; 115.1 ; 1.0 ;2;24;94;1;1;0;2;2;0;0;0;2
11108; 57.3 ; 745.5 ; 9.9 ;13;23;26;0;13;4;9;9;4;0;0;13
11109; 23.6 ; 94.3 ; 18.2 ;4;106;32;0;4;2;2;1;3;3;1;0
11110; 54.3 ; 271.7 ; 30.4 ;5;41;118;0;5;1;4;2;3;2;1;2
11111; 36.6 ; 73.2 ; -   ;2;50;26;0;2;0;2;2;0;0;2;0
11112; 77.9 ; 155.9 ; 1.1 ;2;12;162;2;0;0;2;2;0;0;0;2
11113; 46.6 ; 233.0 ; 11.5 ;5;55;184;0;5;0;5;4;1;0;3;2
11114; 43.2 ; 86.4 ; 0.5 ;2;28;98;0;2;1;1;0;2;0;2;0
11115; 50.0 ; 249.8 ; 19.9 ;5;11;2;0;5;1;4;1;4;0;3;2
11116; 55.4 ; 277.1 ; 12.1 ;5;60;37;0;5;0;5;5;0;0;0;5
11117; 30.7 ; 61.4 ; 0.7 ;2;185;142;0;2;1;1;1;1;1;1;0
11118; 63.8 ; 255.1 ; 21.2 ;4;17;158;4;0;1;3;4;0;0;0;4
11119; 45.9 ; 367.3 ; 38.2 ;8;45;74;0;8;1;7;3;5;3;2;3
11120; 64.4 ; 257.7 ; 7.4 ;4;40;162;0;4;0;4;4;0;0;0;4
11121; 67.5 ; 135.1 ; 24.8 ;2;188;79;0;2;0;2;0;2;0;0;2
11122; 65.4 ; 196.3 ; 28.4 ;3;11;21;0;3;2;1;2;1;0;0;3
11123; 35.9 ; 143.7 ; 8.3 ;4;46;32;0;4;1;3;2;2;1;3;0
11124; 60.4 ; 120.8 ; 35.6 ;2;90;86;0;2;2;0;2;0;1;0;1
11125; 36.6 ; 73.2 ; -   ;2;3;257;0;2;1;1;0;2;0;2;0
11126; 39.4 ; 276.0 ; 10.4 ;7;49;8;0;7;1;6;1;6;2;5;0
11127; 16.5 ; 33.0 ; 2.3 ;2;258;65;0;2;2;0;2;0;2;0;0
11128; 35.1 ; 351.2 ; 10.1 ;10;40;28;1;9;2;8;7;3;3;7;0
11129; 44.6 ; 445.9 ; 11.8 ;10;31;11;0;10;1;9;3;7;0;7;3
11130; 58.0 ; 173.9 ; 30.1 ;3;101;51;0;3;3;0;1;2;1;0;2
11131; 64.7 ; 129.3 ; 51.6 ;2;1;254;0;2;2;0;1;1;1;0;1
11132; 45.7 ; 91.5 ; 1.5 ;2;14;284;0;2;1;1;0;2;0;2;0
11133; 51.8 ; 103.5 ; 3.3 ;2;223;8;0;2;1;1;1;1;0;1;1
11134; 49.8 ; 99.7 ; 10.5 ;2;77;41;1;1;0;2;2;0;0;1;1
11135; 58.4 ; 408.7 ; 30.2 ;7;32;46;0;7;6;1;1;6;2;0;5
11136; 33.9 ; 169.3 ; 16.8 ;5;77;42;4;1;2;3;2;3;2;3;0
11137; 32.3 ; 1,581.5 ; 14.4 ;49;8;0;0;49;27;22;45;4;16;33;0
11138; 40.8 ; 856.4 ; 19.1 ;21;14;11;0;21;8;13;6;15;7;7;7
11139; 47.2 ; 141.7 ; 0.9 ;3;106;6;0;3;0;3;0;3;0;3;0
11140; 47.8 ; 95.7 ; 0.5 ;2;63;5;1;1;0;2;0;2;0;2;0
11141; 95.2 ; 190.5 ; 8.5 ;2;81;53;0;2;0;2;2;0;0;0;2
11142; 45.2 ; 180.6 ; 24.7 ;4;28;161;0;4;4;0;4;0;1;2;1
11143; 47.1 ; 94.2 ; 0.5 ;2;78;92;0;2;1;1;2;0;0;2;0
11144; 70.2 ; 351.2 ; 26.5 ;5;32;7;5;0;4;1;2;3;0;0;5
11145; 36.1 ; 108.2 ; 12.6 ;3;135;110;1;2;0;3;3;0;1;2;0
11146; 56.8 ; 113.5 ; 38.8 ;2;5;195;0;2;0;2;0;2;1;0;1
11147; 34.7 ; 173.7 ; 5.9 ;5;1;249;0;5;3;2;3;2;2;3;0
11148; 50.0 ; 100.0 ; 3.8 ;2;198;42;0;2;1;1;1;1;0;2;0
11149; 45.2 ; 225.8 ; 9.3 ;5;22;32;0;5;2;3;1;4;0;5;0
11150; 48.2 ; 96.3 ; 2.1 ;2;13;194;0;2;0;2;2;0;0;2;0
11151; 29.4 ; 147.2 ; 11.6 ;5;72;26;3;2;2;3;5;0;3;2;0
11152; 24.7 ; 49.4 ; 7.9 ;2;1;269;0;2;2;0;2;0;1;1;0
11153; 47.7 ; 95.4 ; 1.4 ;2;48;117;0;2;1;1;1;1;0;2;0
11154; 36.6 ; 109.8 ; -   ;3;54;147;0;3;0;3;3;0;0;3;0
11155; 47.1 ; 94.2 ; 0.5 ;2;76;52;2;0;0;2;1;1;0;2;0
11156; 60.5 ; 423.6 ; 14.0 ;7;25;35;0;7;3;4;2;5;0;0;7
11157; 44.0 ; 88.1 ; 28.4 ;2;2;252;0;2;1;1;2;0;1;0;1
11158; 67.2 ; 1,277.6 ; 33.3 ;19;17;5;0;19;0;19;19;0;0;0;19
11159; 26.5 ; 79.5 ; 10.8 ;3;13;211;0;3;0;3;1;2;2;1;0
11160; 43.4 ; 173.7 ; 8.7 ;4;32;53;2;2;1;3;1;3;0;4;0
11161; 38.8 ; 194.1 ; 13.0 ;5;72;9;0;5;1;4;3;2;2;3;0
11162; 49.6 ; 198.6 ; 5.2 ;4;73;20;4;0;1;3;4;0;0;4;0
11163; 66.1 ; 132.1 ; 9.7 ;2;50;79;0;2;0;2;1;1;0;0;2
11164; 52.6 ; 420.8 ; 26.5 ;8;35;0;0;8;0;8;3;5;3;2;3
11165; 40.9 ; 204.3 ; 16.6 ;5;64;0;0;5;0;5;5;0;2;1;2
11166; 27.7 ; 110.8 ; 9.8 ;4;18;19;0;4;3;1;3;1;3;1;0
11167; 32.4 ; 64.8 ; 1.8 ;2;57;233;0;2;2;0;2;0;0;2;0
11168; 48.2 ; 192.6 ; 1.7 ;4;65;152;0;4;1;3;4;0;0;4;0
11169; 37.9 ; 151.5 ; 27.7 ;4;32;89;0;4;1;3;4;0;1;2;1
11170; 57.2 ; 285.9 ; 20.3 ;5;50;41;0;5;1;4;0;5;0;0;5
11171; 48.5 ; 97.0 ; 1.6 ;2;24;99;0;2;0;2;2;0;0;2;0
11172; 61.8 ; 123.7 ; 7.5 ;2;81;100;0;2;0;2;1;1;0;0;2
11173; 26.6 ; 79.7 ; 12.0 ;3;77;26;1;2;2;1;1;2;2;1;0
11174; 34.1 ; 102.4 ; 16.8 ;3;9;127;0;3;1;2;1;2;1;2;0
11175; 30.1 ; 60.2 ; 4.9 ;2;4;236;0;2;1;1;0;2;1;1;0
11176; 21.0 ; 189.3 ; -   ;9;7;53;0;9;0;9;8;1;9;0;0
11177; 22.6 ; 45.2 ; 11.4 ;2;11;112;2;0;1;1;1;1;1;1;0
11178; 23.0 ; 92.0 ; 5.9 ;4;18;38;0;4;2;2;2;2;4;0;0
11179; 50.2 ; 200.6 ; 41.8 ;4;117;70;0;4;2;2;1;3;1;2;1
11180; 46.8 ; 93.5 ; -   ;2;319;116;0;2;1;1;2;0;0;2;0
11181; 75.6 ; 151.2 ; 20.9 ;2;12;163;0;2;0;2;1;1;0;0;2
11182; 33.3 ; 532.7 ; 14.8 ;16;14;52;0;16;7;9;11;5;5;11;0
11183; 48.2 ; 289.4 ; 40.0 ;6;23;30;0;6;1;5;4;2;2;2;2
11184; 44.6 ; 89.1 ; 11.9 ;2;280;101;1;1;1;1;2;0;0;1;1
11185; 26.1 ; 104.4 ; 10.5 ;4;69;93;0;4;3;1;3;1;3;1;0
11186; 53.6 ; 268.2 ; 16.0 ;5;75;78;0;5;0;5;4;1;0;3;2
11187; 47.7 ; 143.1 ; 0.4 ;3;43;12;0;3;1;2;1;2;0;3;0
11188; 47.8 ; 286.8 ; 1.3 ;6;54;5;0;6;0;6;6;0;0;6;0
11189; 48.4 ; 193.6 ; 0.6 ;4;71;52;0;4;0;4;1;3;0;4;0
11190; 42.9 ; 128.6 ; 14.6 ;3;7;265;0;3;1;2;2;1;1;1;1
11191; 47.5 ; 142.4 ; -   ;3;31;47;1;2;0;3;3;0;0;3;0
11192; 45.7 ; 274.3 ; 11.7 ;6;25;47;0;6;2;4;4;2;0;4;2
11193; 54.2 ; 325.3 ; 17.0 ;6;18;31;0;6;0;6;5;1;0;4;2
11194; 48.8 ; 146.4 ; 16.7 ;3;16;63;3;0;2;1;1;2;0;2;1
11195; 27.2 ; 544.0 ; 7.8 ;20;14;65;0;20;7;13;4;16;13;7;0
11196; 46.8 ; 234.1 ; 2.7 ;5;75;21;0;5;3;2;4;1;0;5;0
11197; 75.9 ; 151.8 ; 43.6 ;2;162;142;0;2;1;1;0;2;0;0;2
11198; 74.7 ; 373.6 ; 68.5 ;5;40;162;0;5;1;4;3;2;2;0;3
11199; 49.4 ; 197.7 ; 26.8 ;4;106;90;0;4;1;3;1;3;1;2;1
11200; 66.9 ; 468.1 ; 24.5 ;7;27;93;0;7;2;5;5;2;0;0;7
11201; 77.5 ; 387.3 ; 22.8 ;5;51;10;0;5;0;5;4;1;0;0;5
11202; 47.9 ; 95.9 ; 17.6 ;2;28;95;0;2;1;1;0;2;0;1;1
11203; 16.8 ; 251.3 ; 2.4 ;15;14;38;0;15;4;11;11;4;15;0;0
11204; 57.8 ; 115.7 ; 14.5 ;2;283;2;0;2;2;0;0;2;0;0;2
11205; 53.8 ; 269.2 ; 54.1 ;5;5;242;0;5;0;5;3;2;2;1;2
11206; 42.3 ; 126.8 ; 11.4 ;3;100;0;0;3;0;3;3;0;0;3;0
11207; 23.2 ; 92.9 ; 14.4 ;4;79;69;1;3;1;3;2;2;3;1;0
11208; 29.3 ; 58.6 ; 21.4 ;2;61;36;0;2;1;1;1;1;1;1;0
11209; 82.6 ; 247.7 ; 32.2 ;3;4;20;0;3;0;3;2;1;0;0;3
11210; 18.0 ; 36.1 ; 4.6 ;2;57;33;0;2;2;0;1;1;2;0;0
11211; 26.7 ; 668.7 ; 11.2 ;25;16;10;0;25;14;11;8;17;17;8;0
11212; 15.0 ; 74.9 ; -   ;5;9;238;0;5;4;1;0;5;5;0;0
11213; 52.7 ; 105.5 ; 37.2 ;2;108;188;0;2;0;2;0;2;1;0;1
11214; 30.4 ; 60.7 ; 7.9 ;2;211;83;0;2;1;1;1;1;1;1;0
11215; 57.2 ; 171.5 ; 39.1 ;3;101;73;0;3;0;3;2;1;1;0;2
11216; 68.6 ; 137.2 ; 17.7 ;2;169;120;0;2;0;2;2;0;0;0;2
11217; 26.8 ; 80.3 ; 3.1 ;3;38;203;0;3;3;0;1;2;3;0;0
11218; 22.8 ; 114.0 ; 9.5 ;5;20;290;0;5;2;3;3;2;3;2;0
11219; 61.8 ; 247.4 ; 25.8 ;4;36;115;0;4;0;4;2;2;0;0;4
11220; 15.0 ; 30.0 ; -   ;2;5;377;0;2;2;0;2;0;2;0;0
11221; 69.2 ; 138.4 ; 11.2 ;2;8;260;0;2;1;1;2;0;0;0;2
11222; 36.0 ; 935.7 ; 12.4 ;26;5;5;0;26;6;20;23;3;9;17;0
11223; 27.6 ; 55.3 ; 3.8 ;2;72;209;0;2;1;1;0;2;1;1;0
11224; 56.9 ; 398.2 ; 24.4 ;7;16;105;0;7;1;6;3;4;0;0;7
11225; 69.3 ; 415.7 ; 20.1 ;6;52;26;0;6;1;5;4;2;0;0;6
11226; 21.0 ; 63.0 ; 3.8 ;3;11;206;0;3;1;2;3;0;3;0;0
11227; 22.3 ; 44.5 ; 4.2 ;2;26;89;0;2;0;2;1;1;2;0;0
11228; 40.6 ; 121.8 ; 7.4 ;3;76;148;0;3;0;3;1;2;0;3;0
11229; 42.9 ; 214.7 ; 10.8 ;5;76;5;0;5;0;5;2;3;0;5;0
11230; 29.2 ; 116.6 ; 13.7 ;4;108;22;0;4;2;2;1;3;3;1;0
11231; 53.7 ; 214.9 ; 36.5 ;4;53;134;0;4;2;2;1;3;1;2;1
11232; 49.9 ; 99.8 ; 7.8 ;2;17;233;0;2;1;1;1;1;0;1;1
11233; 79.6 ; 875.8 ; 24.1 ;11;24;5;0;11;0;11;8;3;0;0;11
11234; 155.4 ; 932.3 ; 161.7 ;6;32;15;3;3;3;3;5;1;2;0;4
11235; 39.3 ; 196.6 ; 29.2 ;5;73;59;0;5;1;4;1;4;2;1;2
11236; 43.1 ; 172.4 ; 29.5 ;4;52;169;0;4;1;3;1;3;1;2;1
11237; 41.7 ; 83.4 ; 7.6 ;2;38;241;0;2;0;2;2;0;0;2;0
11238; 42.6 ; 170.4 ; 8.8 ;4;55;80;0;4;2;2;1;3;0;4;0
11239; 64.5 ; 128.9 ; 32.4 ;2;2;263;0;2;1;1;1;1;0;0;2
11240; 67.9 ; 679.5 ; 38.5 ;10;14;22;0;10;3;7;5;5;3;0;7
11241; 50.7 ; 253.5 ; 5.1 ;5;49;36;0;5;0;5;1;4;0;3;2
11242; 17.3 ; 603.9 ; 7.5 ;35;5;56;0;35;21;14;10;25;35;0;0
11243; 38.4 ; 268.8 ; 12.3 ;7;41;31;5;2;1;6;2;5;2;5;0
11244; 132.1 ; 264.2 ; 18.1 ;2;37;368;0;2;0;2;1;1;0;0;2
11245; 33.1 ; 165.6 ; 5.9 ;5;5;4;0;5;3;2;0;5;2;3;0
11246; 30.7 ; 153.6 ; 9.5 ;5;86;0;0;5;0;5;1;4;2;3;0
11247; 39.0 ; 78.1 ; 3.7 ;2;52;162;0;2;1;1;1;1;0;2;0
11248; 40.1 ; 160.3 ; 10.1 ;4;96;20;1;3;0;4;2;2;0;4;0
11249; 55.6 ; 166.8 ; 25.5 ;3;164;26;2;1;0;3;0;3;0;0;3
11250; 24.7 ; 369.8 ; 7.3 ;15;13;7;0;15;10;5;10;5;10;5;0
11251; 16.8 ; 33.6 ; 2.7 ;2;89;194;0;2;0;2;0;2;2;0;0
11252; 15.0 ; 30.0 ; -   ;2;208;99;0;2;0;2;1;1;2;0;0
11253; 48.1 ; 529.6 ; 16.6 ;11;33;94;0;11;1;10;10;1;0;7;4
11254; 36.7 ; 146.9 ; 14.8 ;4;18;17;0;4;4;0;2;2;1;3;0
11255; 43.8 ; 131.5 ; 17.2 ;3;113;17;0;3;1;2;1;2;1;1;1
11256; 64.5 ; 258.1 ; 36.1 ;4;19;29;0;4;2;2;2;2;1;0;3
11257; 16.4 ; 98.5 ; 4.0 ;6;42;0;0;6;2;4;0;6;6;0;0
11258; 36.3 ; 72.5 ; 16.8 ;2;15;55;0;2;1;1;0;2;1;1;0
11259; 24.1 ; 169.0 ; 5.5 ;7;32;89;0;7;0;7;2;5;7;0;0
11260; 23.7 ; 94.7 ; 16.4 ;4;6;110;0;4;2;2;2;2;3;1;0
11261; 17.2 ; 86.2 ; 2.3 ;5;9;164;2;3;0;5;5;0;5;0;0
11262; 39.7 ; 79.5 ; 22.0 ;2;188;26;1;1;0;2;2;0;1;0;1
11263; 80.4 ; 160.9 ; 17.7 ;2;79;248;0;2;1;1;1;1;0;0;2
11264; 67.6 ; 135.2 ; 56.0 ;2;24;377;0;2;0;2;1;1;1;0;1
11265; 31.1 ; 435.8 ; 7.4 ;14;21;26;0;14;0;14;2;12;5;9;0
11266; 53.0 ; 265.2 ; 24.2 ;5;99;52;0;5;2;3;3;2;2;1;2
11267; 30.9 ; 61.8 ; -   ;2;5;16;0;2;0;2;0;2;0;2;0
11268; 37.8 ; 75.6 ; 14.5 ;2;6;78;0;2;0;2;2;0;1;1;0
11269; 64.4 ; 128.9 ; 51.3 ;2;6;26;1;1;0;2;1;1;1;0;1
11270; 25.8 ; 51.6 ; 16.2 ;2;157;137;0;2;0;2;2;0;1;1;0
11271; 56.7 ; 283.7 ; 11.7 ;5;55;53;0;5;0;5;5;0;0;0;5
11272; 38.9 ; 467.0 ; 13.0 ;12;21;20;0;12;2;10;8;4;4;8;0
11273; 47.4 ; 142.2 ; 1.2 ;3;51;41;0;3;1;2;2;1;0;3;0
11274; 17.1 ; 51.4 ; 2.3 ;3;14;341;0;3;2;1;2;1;3;0;0
11275; 24.7 ; 49.4 ; 14.6 ;2;246;36;0;2;0;2;1;1;1;1;0
11276; 51.0 ; 102.0 ; -   ;2;57;209;0;2;0;2;1;1;0;2;0
11277; 65.7 ; 131.4 ; 17.6 ;2;12;1;0;2;0;2;1;1;0;0;2
11278; 21.5 ; 43.1 ; 9.8 ;2;293;34;0;2;1;1;0;2;1;1;0
11279; 22.5 ; 247.0 ; 12.6 ;11;11;48;0;11;6;5;1;10;7;4;0
11280; 20.3 ; 141.8 ; 2.4 ;7;4;270;0;7;6;1;1;6;7;0;0
11281; 115.6 ; 346.9 ; 19.9 ;3;13;26;0;3;0;3;1;2;0;0;3
11282; 68.0 ; 951.9 ; 25.2 ;14;22;10;0;14;3;11;14;0;0;0;14
11283; 36.9 ; 553.6 ; 24.8 ;15;14;5;0;15;3;12;7;8;5;5;5
11284; 33.4 ; 1,169.5 ; 19.8 ;35;12;15;0;35;11;24;13;22;12;23;0
11285; 18.7 ; 93.4 ; 5.1 ;5;58;23;0;5;0;5;1;4;5;0;0
11286; 17.1 ; 153.8 ; 2.6 ;9;14;38;0;9;6;3;2;7;9;0;0
11287; 93.6 ; 187.2 ; 17.1 ;2;54;227;0;2;0;2;2;0;0;0;2
11288; 53.6 ; 1,125.4 ; 21.5 ;21;14;5;0;21;8;13;13;8;0;14;7
11289; 34.7 ; 173.6 ; 19.1 ;5;6;73;0;5;3;2;3;2;2;3;0
11290; 37.6 ; 263.2 ; 23.3 ;7;40;8;0;7;5;2;5;2;2;3;2
11291; 65.1 ; 651.4 ; 44.9 ;10;29;0;0;10;2;8;8;2;3;0;7
11292; 30.2 ; 90.6 ; 8.4 ;3;56;119;3;0;3;0;0;3;1;2;0
11293; 52.3 ; 522.9 ; 16.0 ;10;32;26;0;10;3;7;6;4;0;7;3
11294; 28.0 ; 251.8 ; 15.1 ;9;30;31;0;9;3;6;3;6;6;3;0
11295; 40.5 ; 1,051.7 ; 14.2 ;26;8;7;0;26;11;15;5;21;9;17;0
11296; 41.5 ; 124.4 ; 10.4 ;3;91;53;0;3;0;3;2;1;0;3;0
11297; 52.5 ; 105.0 ; 7.5 ;2;164;74;1;1;0;2;2;0;0;1;1
11298; 25.8 ; 51.6 ; 16.2 ;2;37;183;0;2;1;1;2;0;1;1;0
11299; 83.2 ; 249.7 ; 36.0 ;3;89;2;0;3;1;2;3;0;0;0;3
11300; 40.1 ; 200.4 ; 18.2 ;5;56;14;0;5;2;3;4;1;2;1;2
11301; 28.4 ; 85.3 ; 13.4 ;3;11;257;0;3;2;1;1;2;2;1;0
11302; 40.6 ; 81.2 ; 15.6 ;2;11;142;2;0;0;2;2;0;1;0;1
11303; 55.2 ; 165.6 ; 6.6 ;3;7;80;0;3;2;1;1;2;0;0;3
11304; 41.3 ; 165.2 ; 29.6 ;4;143;5;0;4;1;3;2;2;1;2;1
11305; 29.9 ; 89.7 ; 11.8 ;3;88;38;3;0;3;0;1;2;2;1;0
11306; 22.8 ; 68.4 ; 7.5 ;3;155;4;0;3;1;2;2;1;2;1;0
11307; 26.1 ; 52.3 ; -   ;2;105;147;0;2;0;2;2;0;2;0;0
11308; 30.6 ; 91.9 ; 16.8 ;3;32;113;0;3;1;2;1;2;1;2;0
11309; 30.2 ; 60.4 ; -   ;2;28;230;0;2;1;1;1;1;0;2;0
11310; 70.7 ; 212.1 ; 64.8 ;3;94;223;0;3;2;1;1;2;1;0;2
11311; 18.3 ; 55.0 ; 6.2 ;3;3;127;3;0;0;3;3;0;3;0;0
11312; 26.4 ; 79.1 ; 7.7 ;3;25;20;0;3;0;3;1;2;2;1;0
11313; 54.2 ; 108.5 ; 11.2 ;2;50;310;0;2;0;2;2;0;0;1;1
11314; 19.5 ; 117.0 ; 2.6 ;6;26;43;6;0;2;4;4;2;6;0;0
11315; 92.6 ; 185.3 ; 3.3 ;2;1;236;0;2;0;2;2;0;0;0;2
11316; 18.7 ; 131.1 ; 3.0 ;7;34;111;0;7;3;4;1;6;7;0;0
11317; 46.1 ; 138.4 ; 16.6 ;3;50;142;1;2;1;2;1;2;1;1;1
11318; 35.1 ; 70.2 ; 23.1 ;2;28;12;0;2;1;1;2;0;1;0;1
11319; 79.3 ; 158.6 ; 29.9 ;2;315;10;0;2;0;2;2;0;0;0;2
11320; 18.0 ; 269.7 ; 4.5 ;15;18;114;0;15;6;9;7;8;15;0;0
11321; 47.1 ; 94.2 ; 0.5 ;2;29;84;0;2;1;1;2;0;0;2;0
11322; 37.1 ; 408.0 ; 8.4 ;11;10;296;0;11;8;3;4;7;4;7;0
11323; 44.8 ; 89.6 ; 2.9 ;2;23;141;0;2;1;1;0;2;0;2;0
11324; 55.6 ; 166.7 ; 34.8 ;3;47;136;0;3;2;1;3;0;1;0;2
11325; 48.5 ; 630.4 ; 6.8 ;13;23;10;0;13;1;12;11;2;0;9;4
11326; 41.8 ; 125.4 ; 9.1 ;3;27;70;0;3;1;2;1;2;0;3;0
11327; 44.9 ; 224.4 ; 10.5 ;5;22;57;0;5;0;5;1;4;0;3;2
11328; 33.5 ; 134.1 ; 16.4 ;4;113;12;0;4;4;0;2;2;1;3;0
11329; 29.5 ; 117.9 ; 4.2 ;4;33;16;0;4;1;3;1;3;3;1;0
11330; 33.5 ; 301.9 ; 9.5 ;9;17;11;0;9;0;9;3;6;3;6;0
11331; 52.5 ; 105.0 ; -   ;2;46;206;0;2;1;1;0;2;0;2;0
11332; 41.6 ; 83.3 ; -   ;2;8;15;2;0;0;2;1;1;0;2;0
11333; 48.7 ; 194.9 ; 1.7 ;4;110;0;0;4;0;4;2;2;0;4;0
11334; 52.2 ; 261.0 ; 11.6 ;5;63;15;0;5;0;5;5;0;0;3;2
11335; 45.2 ; 90.4 ; 2.7 ;2;1;198;0;2;1;1;0;2;0;2;0
11336; 57.1 ; 514.1 ; 20.3 ;9;17;52;0;9;0;9;8;1;0;0;9
11337; 19.3 ; 115.6 ; 7.7 ;6;54;77;0;6;2;4;2;4;6;0;0
11338; 96.1 ; 672.9 ; 42.7 ;7;11;52;0;7;1;6;5;2;0;0;7
11339; 37.7 ; 264.2 ; 30.5 ;7;49;92;0;7;3;4;3;4;2;3;2
11340; 38.1 ; 190.7 ; 21.0 ;5;45;109;0;5;4;1;2;3;2;1;2
11341; 18.5 ; 129.3 ; 7.2 ;7;48;6;0;7;1;6;5;2;7;0;0
11342; 38.8 ; 116.5 ; 20.5 ;3;8;0;0;3;1;2;1;2;1;1;1
11343; 92.0 ; 828.0 ; 43.3 ;9;3;246;0;9;3;6;4;5;0;0;9
11344; 20.0 ; 59.9 ; 9.2 ;3;130;59;0;3;1;2;2;1;3;0;0
11345; 18.8 ; 75.1 ; 8.0 ;4;25;62;0;4;0;4;1;3;4;0;0
11346; 27.8 ; 83.3 ; 11.1 ;3;95;32;0;3;1;2;1;2;2;1;0
11347; 23.6 ; 70.9 ; 7.1 ;3;41;11;0;3;1;2;1;2;2;1;0
11348; 19.8 ; 59.4 ; 1.3 ;3;25;323;0;3;2;1;2;1;3;0;0
11349; 27.8 ; 805.1 ; 12.1 ;29;7;31;0;29;9;20;14;15;19;10;0
11350; 23.5 ; 1,598.2 ; 11.3 ;68;5;5;0;68;29;39;27;41;45;23;0
11351; 59.0 ; 413.3 ; 13.8 ;7;47;11;0;7;0;7;6;1;0;0;7
11352; 48.5 ; 145.4 ; 1.6 ;3;40;80;0;3;0;3;1;2;0;3;0
11353; 50.0 ; 200.0 ; 11.3 ;4;17;242;0;4;0;4;3;1;0;3;1
11354; 44.6 ; 222.8 ; 11.0 ;5;3;303;0;5;4;1;1;4;0;3;2
11355; 32.0 ; 351.7 ; 11.2 ;11;29;8;0;11;9;2;9;2;4;7;0
11356; 20.2 ; 40.4 ; 7.8 ;2;10;241;0;2;1;1;2;0;2;0;0
11357; 116.0 ; 232.0 ; 36.3 ;2;56;200;0;2;0;2;1;1;0;0;2
11358; 19.2 ; 38.5 ; -   ;2;3;336;0;2;1;1;2;0;2;0;0
11359; 38.3 ; 191.4 ; 15.3 ;5;34;77;0;5;4;1;2;3;2;3;0
11360; 37.2 ; 74.3 ; 23.0 ;2;109;288;0;2;1;1;1;1;1;0;1
11361; 24.8 ; 74.3 ; 3.7 ;3;72;10;1;2;1;2;0;3;3;0;0
11362; 16.4 ; 98.5 ; 4.0 ;6;5;5;0;6;1;5;1;5;6;0;0
11363; 22.7 ; 45.4 ; 11.5 ;2;10;106;0;2;0;2;1;1;1;1;0
11364; 41.4 ; 82.7 ; 16.7 ;2;64;215;0;2;0;2;2;0;1;0;1
11365; 25.1 ; 75.2 ; -   ;3;3;309;0;3;2;1;0;3;3;0;0
11366; 68.8 ; 550.1 ; 38.5 ;8;16;59;0;8;6;2;4;4;0;0;8
11367; 66.2 ; 198.7 ; 22.7 ;3;18;59;0;3;0;3;0;3;0;0;3
11368; 54.3 ; 162.9 ; 22.3 ;3;67;125;0;3;1;2;1;2;0;2;1
11369; 20.3 ; 101.4 ; 13.7 ;5;11;78;0;5;1;4;2;3;3;2;0
11370; 43.2 ; 86.4 ; 7.4 ;2;7;15;0;2;0;2;2;0;0;2;0
11371; 19.1 ; 229.3 ; 6.5 ;12;31;21;0;12;0;12;3;9;12;0;0
11372; 30.4 ; 91.1 ; 19.7 ;3;197;17;0;3;2;1;3;0;1;2;0
11373; 63.2 ; 505.8 ; 26.0 ;8;36;26;0;8;0;8;7;1;0;0;8
11374; 54.2 ; 162.5 ; 1.7 ;3;16;51;0;3;2;1;1;2;0;2;1
11375; 35.5 ; 1,136.1 ; 20.3 ;32;9;78;0;32;9;23;21;11;11;10;11
11376; 19.3 ; 38.6 ; -   ;2;44;234;0;2;2;0;0;2;2;0;0
11377; 47.6 ; 190.3 ; 1.0 ;4;53;23;4;0;3;1;2;2;0;4;0
11378; 72.5 ; 145.1 ; 23.1 ;2;50;352;0;2;0;2;1;1;0;0;2
11379; 15.0 ; 30.0 ; -   ;2;50;102;0;2;2;0;1;1;2;0;0
11380; 60.0 ; 300.0 ; 31.1 ;5;86;68;0;5;2;3;5;0;2;0;3
11381; 38.4 ; 345.4 ; 24.0 ;9;28;11;0;9;4;5;5;4;3;3;3
11382; 25.1 ; 50.1 ; -   ;2;21;246;0;2;1;1;1;1;2;0;0
11383; 22.3 ; 44.6 ; 2.7 ;2;114;176;1;1;2;0;1;1;2;0;0
11384; 43.4 ; 86.7 ; 27.4 ;2;1;167;0;2;0;2;0;2;1;0;1
11385; 50.7 ; 101.5 ; 3.2 ;2;23;222;0;2;1;1;2;0;0;2;0
11386; 42.9 ; 300.0 ; 16.9 ;7;3;280;0;7;3;4;6;1;2;3;2
11387; 47.1 ; 753.2 ; 0.5 ;16;14;5;0;16;0;16;16;0;0;16;0
11388; 41.1 ; 369.8 ; 9.1 ;9;33;11;0;9;2;7;4;5;0;9;0
11389; 51.5 ; 205.9 ; 1.0 ;4;38;136;0;4;1;3;3;1;0;4;0
11390; 61.5 ; 1,353.7 ; 15.5 ;22;17;10;0;22;9;13;19;3;0;0;22
11391; 32.2 ; 64.4 ; 6.6 ;2;5;95;0;2;0;2;0;2;1;1;0
11392; 47.5 ; 94.9 ; -   ;2;6;31;0;2;0;2;0;2;0;2;0
11393; 27.1 ; 108.3 ; 9.7 ;4;31;194;0;4;2;2;1;3;3;1;0
11394; 39.7 ; 119.2 ; 12.9 ;3;74;255;0;3;2;1;2;1;1;2;0
11395; 44.2 ; 88.4 ; 4.9 ;2;169;68;0;2;0;2;1;1;0;2;0
11396; 221.3 ; 885.2 ; 29.8 ;4;44;127;0;4;3;1;4;0;0;0;4
11397; 63.9 ; 191.7 ; 28.0 ;3;82;35;0;3;2;1;2;1;0;0;3
11398; 22.2 ; 110.8 ; 14.9 ;5;7;22;0;5;1;4;2;3;3;2;0
11399; 59.7 ; 417.9 ; 45.3 ;7;27;139;0;7;4;3;1;6;2;0;5
11400; 35.6 ; 71.1 ; 8.0 ;2;230;80;0;2;2;0;1;1;1;1;0
11401; 72.5 ; 145.0 ; 24.7 ;2;101;36;0;2;0;2;1;1;0;0;2
11402; 24.4 ; 219.4 ; 11.8 ;9;37;11;0;9;5;4;2;7;6;3;0
11403; 46.9 ; 187.7 ; 0.4 ;4;23;94;0;4;2;2;2;2;0;4;0
11404; 26.3 ; 263.2 ; 10.2 ;10;26;77;0;10;5;5;2;8;7;3;0
11405; 32.4 ; 421.6 ; 10.4 ;13;18;20;0;13;5;8;9;4;4;9;0
11406; 22.6 ; 45.2 ; 11.4 ;2;146;99;0;2;0;2;1;1;1;1;0
11407; 28.1 ; 56.3 ; 4.6 ;2;6;188;0;2;0;2;2;0;1;1;0
11408; 46.8 ; 93.5 ; -   ;2;42;180;0;2;1;1;0;2;0;2;0
11409; 45.5 ; 364.3 ; 28.4 ;8;34;11;0;8;0;8;6;2;3;2;3
11410; 17.8 ; 35.6 ; -   ;2;5;110;0;2;1;1;2;0;2;0;0
11411; 29.2 ; 116.9 ; 5.8 ;4;50;0;0;4;0;4;1;3;3;1;0
11412; 66.9 ; 267.5 ; 14.2 ;4;91;6;0;4;2;2;3;1;0;0;4
11413; 25.9 ; 129.7 ; 0.5 ;5;70;35;0;5;4;1;3;2;5;0;0
11414; 195.5 ; 2,541.4 ; 136.2 ;13;26;10;0;13;4;9;7;6;0;0;13
11415; 38.8 ; 155.2 ; 10.9 ;4;59;115;0;4;0;4;2;2;1;3;0
11416; 47.6 ; 190.3 ; 0.8 ;4;26;64;0;4;1;3;2;2;0;4;0
11417; 40.5 ; 364.6 ; 14.9 ;9;26;52;0;9;3;6;7;2;3;3;3
11418; 18.3 ; 55.0 ; 6.2 ;3;18;243;0;3;1;2;2;1;3;0;0
11419; 59.6 ; 298.1 ; 27.9 ;5;52;40;0;5;1;4;3;2;0;0;5
11420; 38.5 ; 76.9 ; 12.4 ;2;5;276;0;2;2;0;1;1;1;1;0
11421; 61.3 ; 122.5 ; 6.5 ;2;11;247;0;2;0;2;2;0;0;0;2
11422; 84.1 ; 420.3 ; 32.0 ;5;39;22;0;5;0;5;5;0;0;0;5
11423; 43.8 ; 87.7 ; 20.4 ;2;14;211;0;2;1;1;1;1;1;0;1
11424; 76.1 ; 380.5 ; 60.8 ;5;12;242;0;5;1;4;5;0;2;0;3
11425; 36.8 ; 147.2 ; 5.0 ;4;38;78;0;4;1;3;3;1;0;4;0
11426; 26.4 ; 184.7 ; 7.5 ;7;30;91;0;7;1;6;4;3;5;2;0
11427; 17.0 ; 85.0 ; 4.8 ;5;10;185;5;0;2;3;1;4;5;0;0
11428; 41.4 ; 82.7 ; 16.7 ;2;13;356;0;2;0;2;1;1;1;0;1
11429; 105.5 ; 211.1 ; 13.1 ;2;113;21;1;1;0;2;2;0;0;0;2
11430; 25.1 ; 50.1 ; -   ;2;38;247;0;2;0;2;1;1;2;0;0
11431; 45.5 ; 136.6 ; 7.2 ;3;4;179;0;3;2;1;1;2;0;3;0
11432; 33.1 ; 165.6 ; 10.1 ;5;28;274;0;5;3;2;1;4;2;3;0
11433; 16.3 ; 341.5 ; 1.7 ;21;12;6;0;21;16;5;20;1;21;0;0
11434; 73.6 ; 147.2 ; 30.5 ;2;171;68;0;2;0;2;2;0;0;0;2
11435; 52.5 ; 105.0 ; 6.5 ;2;16;20;0;2;1;1;1;1;0;1;1
11436; 50.5 ; 707.7 ; 21.3 ;14;21;5;0;14;0;14;10;4;5;4;5
11437; 17.5 ; 35.0 ; 3.8 ;2;60;68;0;2;1;1;1;1;2;0;0
11438; 15.0 ; 30.0 ; -   ;2;54;197;0;2;2;0;2;0;2;0;0
11439; 95.6 ; 191.3 ; 3.2 ;2;29;125;0;2;1;1;2;0;0;0;2
11440; 58.4 ; 175.3 ; 12.3 ;3;50;263;0;3;1;2;2;1;0;0;3
11441; 27.2 ; 897.0 ; 10.2 ;33;9;5;0;33;0;33;33;0;22;11;0
11442; 39.9 ; 199.4 ; 12.0 ;5;34;153;0;5;0;5;3;2;2;3;0
11443; 62.0 ; 186.0 ; 4.9 ;3;13;26;0;3;0;3;3;0;0;0;3
11444; 46.0 ; 183.8 ; 2.2 ;4;38;99;0;4;0;4;4;0;0;4;0
11445; 30.2 ; 60.4 ; -   ;2;327;41;0;2;1;1;2;0;0;2;0
11446; 29.6 ; 177.3 ; 2.1 ;6;33;23;0;6;1;5;0;6;4;2;0
11447; 38.3 ; 76.7 ; 19.0 ;2;248;61;0;2;1;1;0;2;1;0;1
11448; 38.1 ; 190.4 ; 14.6 ;5;49;26;0;5;1;4;1;4;2;3;0
11449; 32.7 ; 130.7 ; 17.5 ;4;28;55;2;2;3;1;1;3;1;3;0
11450; 33.0 ; 1,155.8 ; 13.8 ;35;13;6;0;35;18;17;18;17;12;23;0
11451; 52.2 ; 260.8 ; 16.8 ;5;63;82;0;5;3;2;1;4;0;3;2
11452; 49.2 ; 98.5 ; 2.6 ;2;270;26;0;2;0;2;0;2;0;2;0
11453; 72.9 ; 145.7 ; 25.1 ;2;184;218;0;2;2;0;0;2;0;0;2
11454; 49.7 ; 1,143.3 ; 34.3 ;23;11;56;0;23;9;14;12;11;8;7;8
11455; 44.8 ; 89.6 ; 2.9 ;2;12;248;0;2;2;0;2;0;0;2;0
11456; 19.0 ; 247.1 ; 5.0 ;13;13;197;0;13;5;8;8;5;13;0;0
11457; 51.1 ; 153.2 ; 3.3 ;3;16;78;0;3;0;3;1;2;0;3;0
11458; 19.7 ; 255.6 ; 10.2 ;13;7;5;0;13;0;13;11;2;13;0;0
11459; 52.4 ; 209.5 ; 5.5 ;4;77;5;0;4;0;4;4;0;0;3;1
11460; 20.0 ; 40.1 ; 7.6 ;2;183;58;0;2;0;2;1;1;2;0;0
11461; 49.0 ; 735.5 ; 15.6 ;15;21;2;0;15;2;13;10;5;0;10;5
11462; 35.1 ; 70.2 ; 8.7 ;2;17;245;0;2;2;0;0;2;1;1;0
11463; 86.7 ; 519.9 ; 25.9 ;6;14;41;0;6;1;5;4;2;0;0;6
11464; 22.5 ; 44.9 ; 11.2 ;2;55;230;0;2;1;1;1;1;1;1;0
11465; 47.0 ; 141.0 ; 0.4 ;3;57;73;0;3;0;3;3;0;0;3;0
11466; 49.4 ; 247.1 ; 1.3 ;5;15;218;0;5;2;3;1;4;0;5;0
11467; 32.9 ; 98.8 ; 14.2 ;3;28;26;0;3;0;3;3;0;1;2;0
11468; 29.9 ; 119.6 ; 31.6 ;4;30;157;0;4;0;4;1;3;3;0;1
11469; 32.7 ; 849.5 ; 5.8 ;26;9;15;0;26;0;26;26;0;9;17;0
11470; 46.6 ; 186.5 ; 1.5 ;4;104;16;1;3;3;1;1;3;0;4;0
11471; 24.0 ; 240.4 ; 7.2 ;10;47;11;0;10;6;4;7;3;7;3;0
11472; 24.4 ; 536.9 ; 19.4 ;22;11;20;0;22;9;13;15;7;15;7;0
11473; 29.1 ; 435.9 ; 14.7 ;15;28;5;0;15;3;12;15;0;10;5;0
11474; 26.5 ; 132.6 ; 17.8 ;5;20;184;0;5;0;5;3;2;3;2;0
11475; 44.3 ; 265.6 ; 9.1 ;6;41;78;0;6;1;5;5;1;0;6;0
11476; 20.0 ; 40.1 ; 7.6 ;2;23;56;1;1;2;0;2;0;2;0;0
11477; 47.5 ; 94.9 ; -   ;2;5;90;0;2;0;2;1;1;0;2;0
11478; 21.7 ; 108.6 ; 16.0 ;5;8;40;0;5;3;2;1;4;3;2;0
11479; 27.4 ; 137.2 ; 6.2 ;5;50;5;3;2;0;5;5;0;3;2;0
11480; 54.1 ; 108.3 ; 11.1 ;2;16;170;0;2;1;1;0;2;0;1;1
11481; 47.5 ; 94.9 ; -   ;2;5;52;0;2;0;2;1;1;0;2;0
11482; 50.8 ; 152.4 ; 42.8 ;3;101;62;0;3;0;3;2;1;1;1;1
11483; 25.5 ; 255.0 ; 10.9 ;10;9;115;0;10;4;6;4;6;7;3;0
11484; 59.6 ; 417.5 ; 22.6 ;7;33;110;0;7;0;7;5;2;0;0;7
11485; 52.7 ; 105.3 ; 2.5 ;2;13;98;2;0;2;0;0;2;0;1;1
11486; 271.9 ; 815.8 ; 128.6 ;3;4;333;0;3;3;0;1;2;0;0;3
11487; 16.6 ; 83.2 ; 2.4 ;5;31;97;0;5;1;4;3;2;5;0;0
11488; 59.6 ; 119.3 ; 18.2 ;2;119;26;0;2;0;2;1;1;0;0;2
11489; 99.6 ; 697.0 ; 28.6 ;7;23;26;0;7;0;7;6;1;0;0;7
11490; 71.1 ; 213.2 ; 41.0 ;3;17;56;2;1;3;0;0;3;0;0;3
11491; 63.0 ; 252.0 ; 12.2 ;4;99;0;0;4;0;4;2;2;0;0;4
11492; 21.0 ; 293.3 ; 6.8 ;14;21;44;0;14;4;10;8;6;14;0;0
11493; 23.6 ; 378.1 ; 12.6 ;16;11;16;0;16;5;11;6;10;11;5;0
11494; 22.5 ; 157.3 ; 1.7 ;7;13;84;0;7;2;5;3;4;7;0;0
11495; 38.7 ; 154.9 ; 6.6 ;4;134;57;0;4;0;4;4;0;0;4;0
11496; 30.6 ; 275.6 ; 12.0 ;9;35;22;0;9;0;9;6;3;3;6;0
11497; 21.3 ; 106.3 ; 2.8 ;5;11;146;0;5;0;5;2;3;5;0;0
11498; 30.8 ; 61.7 ; 8.6 ;2;67;230;0;2;1;1;1;1;1;1;0
11499; 33.3 ; 532.4 ; 9.0 ;16;18;0;0;16;3;13;5;11;5;11;0
11500; 22.3 ; 111.6 ; 7.4 ;5;29;32;5;0;0;5;5;0;5;0;0
11501; 31.7 ; 158.4 ; 11.3 ;5;22;218;0;5;3;2;1;4;2;3;0
11502; 15.5 ; 46.4 ; 0.9 ;3;5;19;0;3;3;0;3;0;3;0;0
11503; 48.4 ; 96.8 ; 7.2 ;2;13;89;2;0;0;2;2;0;0;1;1
11504; 33.6 ; 537.6 ; 20.9 ;16;21;0;0;16;2;14;6;10;5;11;0
11505; 25.4 ; 1,422.3 ; 15.7 ;56;7;11;0;56;28;28;19;37;37;19;0
11506; 30.9 ; 61.7 ; 23.8 ;2;191;26;1;1;1;1;1;1;1;1;0
11507; 61.2 ; 122.5 ; 54.2 ;2;49;233;0;2;1;1;0;2;1;0;1
11508; 27.4 ; 274.2 ; 6.5 ;10;22;110;0;10;1;9;3;7;7;3;0
11509; 37.7 ; 113.2 ; 14.2 ;3;32;5;1;2;0;3;2;1;1;2;0
11510; 22.8 ; 113.8 ; 8.6 ;5;54;17;0;5;2;3;2;3;3;2;0
11511; 43.5 ; 173.8 ; 22.3 ;4;92;114;0;4;3;1;3;1;1;2;1
11512; 81.2 ; 162.4 ; 50.5 ;2;7;95;0;2;1;1;1;1;0;0;2
11513; 30.9 ; 92.7 ; -   ;3;7;5;0;3;1;2;1;2;0;3;0
11514; 37.6 ; 75.2 ; 18.8 ;2;29;28;2;0;1;1;0;2;1;0;1
11515; 23.7 ; 71.2 ; 8.7 ;3;89;99;0;3;0;3;2;1;2;1;0
11516; 35.3 ; 70.6 ; 3.0 ;2;157;23;0;2;2;0;0;2;0;2;0
11517; 62.3 ; 311.4 ; 56.6 ;5;29;185;0;5;2;3;3;2;2;0;3
11518; 62.8 ; 188.4 ; 10.5 ;3;19;68;0;3;0;3;3;0;0;0;3
11519; 35.9 ; 107.8 ; 10.0 ;3;49;185;0;3;2;1;0;3;1;2;0
11520; 31.4 ; 282.9 ; 7.5 ;9;41;5;0;9;1;8;5;4;3;6;0
11521; 103.8 ; 311.3 ; 44.2 ;3;33;165;0;3;1;2;1;2;0;0;3
11522; 26.9 ; 53.7 ; 5.9 ;2;13;41;0;2;0;2;1;1;1;1;0
11523; 28.3 ; 141.5 ; 13.0 ;5;61;77;0;5;5;0;5;0;3;2;0
11524; 48.9 ; 97.8 ; 3.2 ;2;130;160;0;2;1;1;2;0;0;2;0
11525; 105.0 ; 210.1 ; -   ;2;163;136;0;2;0;2;1;1;0;0;2
11526; 39.7 ; 198.6 ; 5.1 ;5;37;95;0;5;1;4;3;2;0;5;0
11527; 33.1 ; 132.3 ; 9.3 ;4;68;75;0;4;2;2;4;0;1;3;0
11528; 47.1 ; 659.9 ; 0.4 ;14;25;68;0;14;0;14;6;8;0;14;0
11529; 34.8 ; 69.5 ; 6.8 ;2;206;74;0;2;0;2;0;2;1;1;0
11530; 21.5 ; 107.5 ; 11.9 ;5;40;29;0;5;4;1;2;3;3;2;0
11531; 51.9 ; 103.9 ; 4.9 ;2;233;236;0;2;0;2;1;1;0;1;1
11532; 59.8 ; 119.6 ; 12.6 ;2;90;41;0;2;1;1;1;1;0;0;2
11533; 18.5 ; 147.8 ; 6.5 ;8;4;136;0;8;2;6;4;4;8;0;0
11534; 23.3 ; 116.7 ; 9.5 ;5;78;104;0;5;2;3;3;2;3;2;0
11535; 22.5 ; 44.9 ; 11.2 ;2;7;122;0;2;1;1;1;1;1;1;0
11536; 52.8 ; 158.4 ; 46.3 ;3;52;5;0;3;1;2;2;1;1;1;1
11537; 47.6 ; 238.1 ; 0.3 ;5;28;6;0;5;1;4;3;2;0;5;0
11538; 63.7 ; 127.4 ; 25.3 ;2;13;257;0;2;0;2;2;0;0;0;2
11539; 49.2 ; 491.9 ; 31.9 ;10;28;145;0;10;8;2;8;2;3;4;3
11540; 24.2 ; 120.9 ; 6.7 ;5;70;57;0;5;0;5;1;4;3;2;0
11541; 60.2 ; 120.4 ; 20.2 ;2;8;188;0;2;0;2;0;2;0;0;2
11542; 52.1 ; 312.6 ; 10.1 ;6;43;18;0;6;4;2;1;5;0;4;2
11543; 77.8 ; 155.7 ; 39.3 ;2;43;110;0;2;0;2;1;1;0;0;2
11544; 41.6 ; 208.1 ; 11.9 ;5;31;26;0;5;0;5;5;0;2;3;0
11545; 52.5 ; 105.0 ; -   ;2;76;141;0;2;0;2;2;0;0;2;0
11546; 37.1 ; 371.2 ; 12.3 ;10;16;128;0;10;2;8;8;2;3;7;0
11547; 60.9 ; 304.3 ; 28.2 ;5;67;2;0;5;2;3;4;1;0;0;5
11548; 21.3 ; 170.1 ; 7.1 ;8;23;33;0;8;7;1;7;1;8;0;0
11549; 15.0 ; 30.0 ; -   ;2;25;113;1;1;2;0;0;2;2;0;0
11550; 21.5 ; 64.4 ; 3.3 ;3;13;204;1;2;0;3;2;1;3;0;0
11551; 63.0 ; 252.0 ; 10.5 ;4;48;154;0;4;3;1;1;3;0;0;4
11552; 27.4 ; 219.2 ; 8.8 ;8;11;2;0;8;3;5;0;8;5;3;0
11553; 73.5 ; 147.0 ; 35.8 ;2;77;152;2;0;1;1;2;0;0;0;2
11554; 33.4 ; 133.6 ; 5.1 ;4;31;200;0;4;0;4;1;3;1;3;0
11555; 32.3 ; 129.2 ; 14.4 ;4;82;41;0;4;0;4;3;1;1;3;0
11556; 32.8 ; 98.3 ; 17.2 ;3;88;131;0;3;0;3;2;1;1;2;0
11557; 30.1 ; 1,083.2 ; 7.5 ;36;7;4;4;32;18;18;32;4;12;24;0
11558; 57.8 ; 751.5 ; 20.8 ;13;22;24;1;12;4;9;10;3;0;0;13
11559; 38.6 ; 115.7 ; 7.2 ;3;5;42;0;3;1;2;3;0;0;3;0
11560; 26.6 ; 79.7 ; 18.6 ;3;56;28;0;3;2;1;1;2;2;1;0
11561; 53.0 ; 106.0 ; 8.3 ;2;5;30;0;2;2;0;0;2;0;1;1
11562; 49.9 ; 149.8 ; 1.7 ;3;22;47;0;3;0;3;1;2;0;3;0
11563; 66.0 ; 264.1 ; 12.5 ;4;35;5;0;4;0;4;4;0;0;0;4
11564; 43.3 ; 216.3 ; 17.1 ;5;83;5;0;5;2;3;4;1;2;1;2
11565; 43.2 ; 129.7 ; 6.7 ;3;43;129;0;3;3;0;1;2;0;3;0
11566; 37.9 ; 151.7 ; 10.4 ;4;62;5;0;4;2;2;4;0;1;3;0
11567; 41.1 ; 369.5 ; 13.8 ;9;34;0;0;9;1;8;7;2;3;6;0
11568; 27.7 ; 110.8 ; 14.1 ;4;41;170;0;4;2;2;3;1;3;1;0
11569; 22.7 ; 45.3 ; 5.1 ;2;35;66;0;2;1;1;0;2;2;0;0
11570; 85.1 ; 425.3 ; 14.6 ;5;44;0;0;5;0;5;5;0;0;0;5
11571; 52.0 ; 260.1 ; 18.9 ;5;48;7;0;5;2;3;1;4;0;3;2
11572; 31.8 ; 127.4 ; 4.1 ;4;44;62;0;4;0;4;2;2;1;3;0
11573; 45.9 ; 91.9 ; 1.2 ;2;4;365;0;2;1;1;0;2;0;2;0
11574; 43.6 ; 130.8 ; 6.4 ;3;61;40;0;3;2;1;2;1;0;3;0
11575; 15.5 ; 139.3 ; 1.7 ;9;20;10;0;9;4;5;4;5;9;0;0
11576; 127.9 ; 255.8 ; 75.3 ;2;271;152;0;2;0;2;2;0;0;0;2
11577; 32.4 ; 129.4 ; 13.4 ;4;56;134;0;4;1;3;2;2;1;3;0
11578; 45.8 ; 91.6 ; 13.8 ;2;107;204;0;2;0;2;2;0;0;1;1
11579; 18.5 ; 1,053.8 ; 5.2 ;57;5;8;0;57;34;23;7;50;57;0;0
11580; 59.3 ; 118.6 ; 18.8 ;2;81;194;0;2;0;2;2;0;0;0;2
11581; 50.2 ; 250.8 ; 2.3 ;5;20;11;0;5;1;4;1;4;0;5;0
11582; 19.4 ; 97.0 ; 6.8 ;5;20;43;0;5;3;2;1;4;5;0;0
11583; 101.4 ; 405.5 ; 31.0 ;4;48;5;0;4;1;3;1;3;0;0;4
11584; 43.8 ; 87.6 ; 10.8 ;2;12;158;0;2;0;2;1;1;0;2;0
11585; 59.0 ; 295.0 ; 19.0 ;5;51;68;0;5;0;5;5;0;0;0;5
11586; 26.7 ; 80.1 ; 3.0 ;3;14;150;0;3;2;1;1;2;3;0;0
11587; 44.2 ; 88.3 ; 20.0 ;2;3;317;0;2;1;1;0;2;1;0;1
11588; 38.9 ; 194.6 ; 36.2 ;5;9;263;0;5;1;4;3;2;2;1;2
11589; 139.3 ; 278.7 ; 141.4 ;2;5;254;0;2;1;1;1;1;1;0;1
11590; 45.3 ; 679.1 ; 12.5 ;15;16;167;0;15;2;13;12;3;0;10;5
11591; 15.0 ; 344.7 ; -   ;23;7;2;0;23;9;14;6;17;23;0;0
11592; 46.2 ; 138.7 ; 3.6 ;3;48;1;0;3;2;1;0;3;0;3;0
11593; 15.0 ; 89.9 ; -   ;6;45;22;0;6;2;4;2;4;6;0;0
11594; 47.7 ; 95.4 ; 1.4 ;2;23;168;2;0;0;2;2;0;0;2;0
11595; 38.2 ; 152.9 ; 16.6 ;4;40;52;0;4;0;4;4;0;1;3;0
11596; 57.0 ; 114.0 ; 54.7 ;2;32;347;0;2;0;2;0;2;1;0;1
11597; 15.4 ; 738.1 ; 1.6 ;48;7;2;0;48;29;19;34;14;48;0;0
11598; 40.5 ; 121.4 ; 7.1 ;3;5;1;0;3;1;2;2;1;0;3;0
11599; 17.3 ; 34.7 ; 3.5 ;2;32;116;0;2;0;2;2;0;2;0;0
11600; 18.5 ; 203.1 ; 1.2 ;11;24;73;0;11;3;8;9;2;11;0;0
11601; 46.8 ; 140.3 ; -   ;3;11;255;0;3;1;2;2;1;0;3;0
11602; 27.9 ; 334.6 ; 11.8 ;12;25;14;0;12;9;3;6;6;8;4;0
11603; 20.9 ; 83.7 ; 5.3 ;4;104;5;0;4;2;2;2;2;4;0;0
11604; 52.8 ; 105.5 ; 46.9 ;2;24;16;0;2;0;2;0;2;1;0;1
11605; 28.9 ; 86.8 ; 17.2 ;3;58;110;0;3;2;1;1;2;2;1;0
11606; 59.6 ; 119.3 ; 19.3 ;2;78;101;0;2;1;1;2;0;0;0;2
11607; 34.2 ; 171.1 ; 8.9 ;5;23;57;0;5;3;2;3;2;2;3;0
11608; 22.0 ; 198.4 ; 5.2 ;9;35;0;0;9;5;4;1;8;9;0;0
11609; 33.1 ; 595.3 ; 22.5 ;18;17;14;0;18;10;8;6;12;6;6;6
11610; 47.9 ; 239.4 ; 1.1 ;5;47;63;0;5;2;3;3;2;0;5;0
11611; 15.0 ; 30.0 ; -   ;2;27;30;0;2;1;1;1;1;2;0;0
11612; 24.7 ; 74.1 ; 6.6 ;3;49;8;0;3;2;1;0;3;2;1;0
11613; 37.5 ; 74.9 ; 11.2 ;2;274;40;0;2;1;1;0;2;1;1;0
11614; 47.2 ; 471.8 ; 0.7 ;10;36;2;0;10;1;9;9;1;0;10;0
11615; 45.7 ; 137.2 ; 28.2 ;3;130;46;0;3;1;2;3;0;1;1;1
11616; 27.9 ; 139.7 ; 2.5 ;5;35;0;0;5;1;4;5;0;3;2;0
11617; 50.0 ; 400.0 ; 8.0 ;8;32;179;0;8;1;7;6;2;0;5;3
11618; 15.0 ; 30.0 ; -   ;2;32;2;0;2;2;0;2;0;2;0;0
11619; 127.5 ; 509.9 ; 106.2 ;4;55;31;0;4;0;4;2;2;1;0;3
11620; 58.8 ; 294.1 ; 21.2 ;5;42;117;0;5;3;2;3;2;0;0;5
11621; 22.9 ; 45.8 ; 4.9 ;2;130;110;0;2;1;1;0;2;2;0;0
11622; 32.5 ; 454.8 ; 11.8 ;14;23;1;0;14;8;6;5;9;5;9;0
11623; 16.3 ; 162.9 ; 2.4 ;10;20;231;0;10;2;8;5;5;10;0;0
11624; 41.9 ; 586.8 ; 13.5 ;14;15;40;0;14;1;13;13;1;5;4;5
11625; 60.5 ; 121.0 ; 18.5 ;2;205;11;0;2;0;2;2;0;0;0;2
11626; 34.2 ; 307.5 ; 7.2 ;9;30;31;0;9;1;8;4;5;3;6;0
11627; 45.7 ; 274.5 ; 5.6 ;6;41;5;0;6;1;5;4;2;0;6;0
11628; 33.5 ; 301.6 ; 16.2 ;9;22;52;0;9;2;7;6;3;3;6;0
11629; 58.3 ; 174.8 ; 21.5 ;3;16;143;0;3;1;2;2;1;0;0;3
11630; 25.9 ; 51.9 ; 12.9 ;2;1;122;0;2;1;1;1;1;1;1;0
11631; 17.8 ; 746.1 ; 6.2 ;42;4;1;0;42;24;18;25;17;42;0;0
11632; 21.1 ; 42.2 ; -   ;2;2;44;0;2;2;0;0;2;2;0;0
11633; 45.0 ; 135.1 ; 8.0 ;3;110;41;0;3;0;3;1;2;0;3;0
11634; 26.8 ; 53.7 ; 11.4 ;2;59;218;1;1;1;1;2;0;1;1;0
11635; 31.1 ; 218.0 ; 10.6 ;7;17;89;1;6;0;7;5;2;2;5;0
11636; 49.5 ; 99.0 ; 9.9 ;2;2;305;0;2;1;1;1;1;0;1;1
11637; 59.8 ; 299.0 ; 21.5 ;5;22;120;0;5;2;3;5;0;0;0;5
11638; 25.4 ; 126.9 ; 9.3 ;5;31;143;0;5;0;5;2;3;3;2;0
11639; 19.3 ; 57.9 ; 0.7 ;3;13;215;0;3;1;2;2;1;3;0;0
11640; 37.1 ; 333.7 ; 8.8 ;9;38;116;0;9;3;6;1;8;3;6;0
11641; 29.2 ; 87.5 ; 17.6 ;3;25;47;0;3;0;3;2;1;2;1;0
11642; 49.6 ; 198.3 ; 1.4 ;4;53;49;0;4;4;0;2;2;0;4;0
11643; 50.6 ; 354.5 ; 22.9 ;7;37;59;0;7;4;3;1;6;2;3;2
11644; 51.6 ; 309.4 ; 19.5 ;6;45;54;0;6;2;4;2;4;0;4;2
11645; 30.4 ; 91.3 ; 0.4 ;3;82;20;0;3;2;1;0;3;1;2;0
11646; 69.6 ; 139.1 ; 20.1 ;2;18;346;0;2;0;2;2;0;0;0;2
11647; 30.9 ; 92.6 ; 15.0 ;3;147;57;0;3;2;1;3;0;1;2;0
11648; 20.0 ; 40.1 ; -   ;2;12;344;0;2;2;0;0;2;2;0;0
11649; 47.5 ; 284.8 ; 0.6 ;6;63;10;0;6;0;6;6;0;0;6;0
11650; 25.2 ; 75.7 ; 10.9 ;3;94;70;0;3;1;2;1;2;2;1;0
11651; 16.5 ; 181.7 ; 3.2 ;11;28;11;0;11;5;6;4;7;11;0;0
11652; 18.4 ; 165.7 ; 5.7 ;9;14;19;0;9;3;6;3;6;9;0;0
11653; 41.7 ; 125.1 ; 5.2 ;3;25;321;0;3;2;1;1;2;0;3;0
11654; 51.9 ; 259.3 ; 18.8 ;5;48;35;0;5;1;4;2;3;0;3;2
11655; 38.2 ; 76.4 ; 19.6 ;2;12;17;0;2;0;2;0;2;1;0;1
11656; 46.5 ; 92.9 ; 0.4 ;2;1;278;0;2;0;2;0;2;0;2;0
11657; 62.5 ; 250.0 ; 18.1 ;4;86;42;0;4;1;3;4;0;0;0;4
11658; 15.0 ; 45.0 ; -   ;3;25;191;0;3;3;0;1;2;3;0;0
11659; 37.5 ; 262.7 ; 11.6 ;7;59;15;0;7;2;5;2;5;2;5;0
11660; 47.5 ; 237.6 ; 1.1 ;5;15;320;0;5;0;5;1;4;0;5;0
11661; 20.0 ; 40.1 ; 7.6 ;2;50;247;0;2;0;2;0;2;2;0;0
11662; 24.5 ; 564.4 ; 14.9 ;23;14;6;0;23;12;11;8;15;15;8;0
11663; 28.7 ; 115.0 ; 2.6 ;4;24;77;1;3;3;1;1;3;3;1;0
11664; 39.8 ; 516.8 ; 13.4 ;13;23;11;0;13;6;7;4;9;4;9;0
11665; 24.3 ; 218.3 ; 10.4 ;9;29;52;0;9;1;8;6;3;6;3;0
11666; 53.8 ; 699.5 ; 12.9 ;13;20;2;12;1;9;4;3;10;0;9;4
11667; 18.7 ; 131.1 ; 7.3 ;7;5;3;0;7;3;4;5;2;7;0;0
11668; 51.6 ; 103.2 ; 21.6 ;2;14;272;0;2;1;1;0;2;0;1;1
11669; 21.3 ; 553.6 ; 10.4 ;26;12;5;0;26;0;26;23;3;17;9;0
11670; 26.6 ; 79.7 ; 6.7 ;3;38;23;0;3;3;0;3;0;2;1;0
11671; 24.5 ; 391.3 ; 21.3 ;16;22;75;0;16;6;10;14;2;11;5;0
11672; 102.0 ; 204.0 ; 77.7 ;2;100;11;0;2;0;2;1;1;1;0;1
11673; 16.8 ; 167.6 ; 2.4 ;10;23;92;0;10;5;5;6;4;10;0;0
11674; 49.3 ; 197.1 ; 33.3 ;4;74;188;0;4;0;4;2;2;1;2;1
11675; 54.3 ; 108.6 ; 26.5 ;2;21;47;0;2;0;2;0;2;1;0;1
11676; 38.7 ; 541.7 ; 19.5 ;14;20;40;0;14;3;11;12;2;5;4;5
11677; 29.6 ; 147.9 ; 16.4 ;5;34;5;0;5;0;5;3;2;3;2;0
11678; 16.7 ; 83.3 ; 4.4 ;5;20;8;0;5;5;0;0;5;5;0;0
11679; 48.8 ; 146.4 ; 22.4 ;3;23;5;0;3;2;1;1;2;1;1;1
11680; 25.1 ; 50.1 ; -   ;2;13;105;0;2;0;2;0;2;2;0;0
11681; 49.3 ; 394.7 ; 8.0 ;8;22;173;0;8;1;7;4;4;0;5;3
11682; 16.3 ; 65.3 ; 2.9 ;4;3;401;0;4;3;1;1;3;4;0;0
11683; 39.4 ; 276.0 ; 20.0 ;7;35;1;0;7;1;6;4;3;2;3;2
11684; 16.2 ; 64.9 ; 2.6 ;4;6;332;0;4;2;2;4;0;4;0;0
11685; 38.6 ; 154.6 ; 9.9 ;4;75;22;0;4;0;4;3;1;1;3;0
11686; 57.3 ; 344.0 ; 11.9 ;6;36;5;0;6;3;3;1;5;0;0;6
11687; 32.4 ; 453.4 ; 14.5 ;14;21;8;0;14;6;8;10;4;5;9;0
11688; 25.1 ; 50.1 ; -   ;2;12;56;0;2;2;0;2;0;2;0;0
11689; 54.8 ; 273.9 ; 26.8 ;5;32;12;0;5;4;1;4;1;2;1;2
11690; 27.4 ; 54.8 ; 3.5 ;2;5;293;0;2;0;2;2;0;1;1;0
11691; 52.7 ; 158.0 ; 50.6 ;3;46;2;0;3;1;2;2;1;1;1;1
11692; 70.1 ; 490.5 ; 44.7 ;7;18;29;0;7;3;4;0;7;2;0;5
11693; 17.5 ; 52.5 ; 4.6 ;3;2;56;0;3;2;1;2;1;3;0;0
11694; 37.1 ; 111.4 ; 12.7 ;3;7;99;0;3;1;2;2;1;1;2;0
11695; 63.9 ; 191.6 ; 14.1 ;3;16;130;0;3;1;2;0;3;0;0;3
11696; 90.2 ; 180.5 ; 64.0 ;2;31;1;0;2;0;2;1;1;1;0;1
11697; 23.6 ; 165.2 ; 13.0 ;7;29;160;0;7;0;7;5;2;5;2;0
11698; 50.2 ; 301.4 ; 18.7 ;6;31;68;0;6;0;6;2;4;0;4;2
11699; 20.5 ; 40.9 ; 1.5 ;2;123;162;0;2;1;1;0;2;2;0;0
11700; 59.2 ; 118.4 ; 3.4 ;2;21;239;0;2;1;1;0;2;0;0;2
11701; 51.4 ; 410.9 ; 22.6 ;8;25;39;0;8;2;6;2;6;3;2;3
11702; 17.7 ; 88.5 ; 1.6 ;5;8;161;0;5;4;1;5;0;5;0;0
11703; 25.1 ; 50.1 ; -   ;2;59;50;0;2;1;1;0;2;2;0;0
11704; 33.3 ; 99.9 ; 26.8 ;3;74;40;0;3;1;2;2;1;1;1;1
11705; 30.9 ; 154.4 ; 18.4 ;5;39;116;0;5;2;3;3;2;2;3;0
11706; 36.3 ; 108.8 ; 11.3 ;3;50;236;0;3;1;2;3;0;1;2;0
11707; 59.1 ; 177.4 ; 13.8 ;3;126;141;0;3;0;3;2;1;0;0;3
11708; 58.5 ; 1,286.6 ; 8.7 ;22;10;8;1;21;15;7;4;18;0;0;22
11709; 36.8 ; 73.6 ; 9.9 ;2;149;154;1;1;1;1;0;2;1;1;0
11710; 48.4 ; 339.1 ; 13.9 ;7;26;4;0;7;5;2;1;6;0;5;2
11711; 53.4 ; 320.1 ; 9.6 ;6;33;23;6;0;2;4;2;4;0;4;2
11712; 40.7 ; 203.4 ; 16.4 ;5;42;10;0;5;0;5;2;3;2;1;2
11713; 66.4 ; 199.3 ; 28.5 ;3;56;16;0;3;0;3;2;1;0;0;3
11714; 30.3 ; 60.5 ; 9.5 ;2;96;136;0;2;1;1;1;1;1;1;0
11715; 53.9 ; 107.8 ; 43.1 ;2;44;93;2;0;1;1;2;0;1;0;1
11716; 35.3 ; 176.5 ; 3.0 ;5;63;41;0;5;2;3;5;0;0;5;0
11717; 28.5 ; 427.5 ; 16.0 ;15;16;40;2;13;2;13;6;9;10;5;0
11718; 19.4 ; 38.9 ; -   ;2;106;22;1;1;0;2;2;0;2;0;0
11719; 68.6 ; 137.3 ; 65.3 ;2;5;220;0;2;1;1;1;1;1;0;1
11720; 15.0 ; 74.9 ; -   ;5;27;69;0;5;1;4;1;4;5;0;0
11721; 44.6 ; 133.8 ; 3.4 ;3;177;121;0;3;1;2;1;2;0;3;0
11722; 18.6 ; 37.2 ; -   ;2;37;71;0;2;2;0;2;0;2;0;0
11723; 42.0 ; 252.1 ; 8.6 ;6;24;147;0;6;0;6;1;5;0;6;0
11724; 115.5 ; 346.4 ; 43.0 ;3;47;116;0;3;0;3;1;2;0;0;3
11725; 21.1 ; 84.4 ; -   ;4;23;95;0;4;0;4;4;0;4;0;0
11726; 29.5 ; 147.7 ; 15.0 ;5;26;32;0;5;2;3;5;0;3;2;0
11727; 21.3 ; 64.0 ; 3.1 ;3;34;23;3;0;2;1;1;2;3;0;0
11728; 31.8 ; 127.4 ; 8.6 ;4;33;131;0;4;0;4;2;2;1;3;0
11729; 33.1 ; 331.3 ; 14.6 ;10;18;5;0;10;3;7;1;9;3;7;0
11730; 42.6 ; 554.3 ; 33.6 ;13;35;3;1;12;3;10;7;6;4;5;4
11731; 77.6 ; 543.0 ; 23.2 ;7;36;64;1;6;0;7;3;4;0;0;7
11732; 113.5 ; 340.4 ; 118.9 ;3;59;229;0;3;2;1;1;2;1;0;2
11733; 56.9 ; 227.6 ; 34.2 ;4;58;163;0;4;3;1;2;2;1;0;3
11734; 25.1 ; 50.1 ; -   ;2;12;248;0;2;2;0;0;2;2;0;0
11735; 48.1 ; 96.2 ; 10.8 ;2;6;115;0;2;0;2;1;1;0;1;1
11736; 50.0 ; 100.0 ; 3.8 ;2;259;55;1;1;2;0;2;0;0;2;0
11737; 249.5 ; 499.0 ; 91.3 ;2;1;255;0;2;1;1;0;2;0;0;2
11738; 51.7 ; 155.2 ; 7.8 ;3;28;20;0;3;0;3;3;0;0;2;1
11739; 17.8 ; 142.6 ; 1.4 ;8;24;56;0;8;6;2;5;3;8;0;0
11740; 35.9 ; 71.8 ; 16.2 ;2;171;121;0;2;0;2;2;0;1;1;0
11741; 75.4 ; 377.0 ; 33.0 ;5;62;6;0;5;1;4;5;0;0;0;5
11742; 124.3 ; 248.7 ; 23.7 ;2;77;262;0;2;0;2;2;0;0;0;2
11743; 29.5 ; 589.2 ; 12.9 ;20;8;69;0;20;12;8;14;6;13;7;0
11744; 30.0 ; 59.9 ; -   ;2;31;155;0;2;2;0;0;2;2;0;0
11745; 24.0 ; 336.3 ; 9.8 ;14;19;46;0;14;3;11;8;6;9;5;0
11746; 55.3 ; 165.9 ; 10.4 ;3;55;17;0;3;1;2;1;2;0;0;3
11747; 72.5 ; 145.1 ; 11.2 ;2;24;1;0;2;0;2;1;1;0;0;2
11748; 17.9 ; 591.3 ; 5.5 ;33;7;0;0;33;10;23;12;21;33;0;0
11749; 17.2 ; 68.9 ; 2.7 ;4;20;239;0;4;2;2;1;3;4;0;0
11750; 23.9 ; 119.3 ; 4.8 ;5;17;188;0;5;4;1;0;5;5;0;0
11751; 21.5 ; 1,032.2 ; 14.4 ;48;6;17;0;48;31;17;15;33;32;16;0
11752; 48.8 ; 97.6 ; 2.0 ;2;81;68;0;2;0;2;2;0;0;2;0
11753; 47.1 ; 94.2 ; 0.5 ;2;19;99;2;0;0;2;2;0;0;2;0
11754; 18.3 ; 55.0 ; 6.2 ;3;4;118;0;3;2;1;2;1;3;0;0
11755; 36.5 ; 620.6 ; 32.0 ;17;17;1;0;17;4;13;9;8;6;5;6
11756; 43.0 ; 128.9 ; 23.1 ;3;56;10;3;0;0;3;2;1;1;1;1
11757; 52.2 ; 261.0 ; 6.3 ;5;38;142;0;5;0;5;1;4;0;3;2
11758; 46.8 ; 93.5 ; -   ;2;56;184;0;2;0;2;2;0;0;2;0
11759; 31.8 ; 63.7 ; 25.2 ;2;195;102;0;2;2;0;1;1;1;0;1
11760; 26.0 ; 52.0 ; 9.4 ;2;28;249;0;2;1;1;0;2;1;1;0
11761; 27.3 ; 54.6 ; 3.3 ;2;167;99;0;2;1;1;1;1;1;1;0
11762; 34.9 ; 104.8 ; 4.7 ;3;84;204;0;3;2;1;0;3;0;3;0
11763; 43.1 ; 215.3 ; 20.6 ;5;22;28;4;1;4;1;1;4;2;1;2
11764; 27.1 ; 54.1 ; 18.1 ;2;17;253;0;2;0;2;0;2;1;1;0
11765; 44.4 ; 133.3 ; 13.4 ;3;23;102;1;2;1;2;1;2;0;2;1
11766; 22.6 ; 248.7 ; 9.9 ;11;12;72;0;11;9;2;9;2;7;4;0
11767; 23.5 ; 94.1 ; 15.3 ;4;18;65;4;0;1;3;0;4;3;1;0
11768; 41.0 ; 81.9 ; 16.1 ;2;16;30;0;2;2;0;0;2;1;0;1
11769; 15.0 ; 209.8 ; -   ;14;12;11;0;14;10;4;1;13;14;0;0
11770; 15.0 ; 30.0 ; -   ;2;88;92;0;2;2;0;2;0;2;0;0
11771; 33.9 ; 67.9 ; 19.2 ;2;105;23;2;0;1;1;0;2;1;1;0
11772; 83.2 ; 415.8 ; 32.5 ;5;80;32;0;5;1;4;5;0;0;0;5
11773; 48.4 ; 1,645.6 ; 20.9 ;34;9;4;0;34;10;24;14;20;11;12;11
11774; 38.1 ; 190.7 ; 14.4 ;5;55;147;0;5;0;5;1;4;2;3;0
11775; 24.3 ; 97.3 ; 9.8 ;4;44;92;0;4;4;0;4;0;3;1;0
11776; 36.1 ; 180.7 ; 17.0 ;5;55;11;0;5;1;4;4;1;2;3;0
11777; 53.9 ; 161.6 ; 4.0 ;3;56;89;0;3;0;3;2;1;0;2;1
11778; 50.2 ; 351.6 ; 16.5 ;7;34;99;0;7;2;5;5;2;0;5;2
11779; 28.8 ; 201.9 ; 9.8 ;7;28;141;0;7;0;7;5;2;5;2;0
11780; 20.0 ; 40.1 ; 7.6 ;2;2;322;0;2;2;0;2;0;2;0;0
11781; 52.5 ; 105.0 ; -   ;2;139;272;0;2;0;2;2;0;0;2;0
11782; 52.5 ; 210.1 ; -   ;4;16;167;0;4;2;2;2;2;0;4;0
11783; 16.3 ; 195.7 ; 3.1 ;12;17;183;1;11;4;8;5;7;12;0;0
11784; 33.8 ; 67.5 ; 28.1 ;2;50;173;1;1;0;2;0;2;1;0;1
11785; 32.5 ; 357.3 ; 16.5 ;11;22;32;0;11;5;6;1;10;4;7;0
11786; 21.1 ; 42.2 ; -   ;2;10;19;0;2;2;0;2;0;2;0;0
11787; 49.2 ; 197.0 ; 2.6 ;4;89;42;0;4;2;2;1;3;0;4;0
11788; 49.9 ; 797.6 ; 15.2 ;16;23;14;0;16;3;13;12;4;0;11;5
11789; 38.7 ; 541.2 ; 4.7 ;14;22;5;0;14;4;10;6;8;0;14;0
11790; 31.6 ; 410.6 ; 14.0 ;13;26;63;0;13;2;11;12;1;4;9;0
11791; 46.7 ; 93.4 ; 15.2 ;2;63;15;0;2;0;2;2;0;0;1;1
11792; 23.3 ; 69.8 ; 11.8 ;3;2;263;0;3;2;1;1;2;2;1;0
11793; 50.0 ; 150.1 ; 4.7 ;3;11;43;1;2;1;2;2;1;0;3;0
11794; 34.7 ; 173.7 ; 11.8 ;5;30;40;0;5;4;1;2;3;2;3;0
11795; 44.1 ; 353.0 ; 3.9 ;8;39;20;5;3;0;8;5;3;0;8;0
11796; 33.5 ; 134.2 ; 11.4 ;4;59;89;0;4;2;2;2;2;1;3;0
11797; 57.3 ; 401.4 ; 16.1 ;7;33;21;0;7;0;7;7;0;0;0;7
11798; 44.4 ; 88.8 ; 1.2 ;2;9;89;2;0;1;1;0;2;0;2;0
11799; 51.6 ; 258.1 ; 44.9 ;5;53;66;0;5;4;1;3;2;2;1;2
11800; 32.7 ; 98.1 ; 5.3 ;3;1;194;0;3;1;2;1;2;1;2;0
11801; 25.1 ; 50.1 ; -   ;2;106;219;0;2;2;0;0;2;2;0;0
11802; 37.9 ; 303.1 ; 4.1 ;8;38;22;1;7;4;4;2;6;0;8;0
11803; 42.8 ; 214.2 ; 6.0 ;5;82;13;1;4;4;1;2;3;0;5;0
11804; 26.4 ; 52.9 ; 2.1 ;2;145;108;0;2;2;0;0;2;2;0;0
11805; 21.6 ; 346.3 ; 10.7 ;16;23;34;0;16;6;10;15;1;11;5;0
11806; 22.4 ; 314.3 ; 4.7 ;14;20;15;0;14;3;11;8;6;14;0;0
11807; 105.3 ; 210.6 ; 0.4 ;2;104;83;0;2;2;0;1;1;0;0;2
11808; 34.3 ; 68.6 ; 13.9 ;2;29;23;0;2;1;1;1;1;1;1;0
11809; 30.7 ; 61.5 ; 24.0 ;2;231;11;0;2;0;2;1;1;1;1;0
11810; 39.7 ; 79.5 ; 4.7 ;2;147;145;0;2;1;1;1;1;0;2;0
11811; 36.9 ; 147.5 ; 10.4 ;4;22;225;0;4;1;3;3;1;1;3;0
11812; 44.4 ; 88.8 ; 44.0 ;2;10;241;0;2;1;1;2;0;1;0;1
11813; 56.2 ; 337.3 ; 24.0 ;6;50;22;0;6;1;5;1;5;0;0;6
11814; 46.9 ; 468.8 ; 0.3 ;10;25;52;0;10;0;10;10;0;0;10;0
11815; 63.7 ; 127.4 ; 25.3 ;2;24;210;0;2;0;2;1;1;0;0;2
11816; 75.1 ; 150.2 ; 11.4 ;2;10;343;0;2;1;1;1;1;0;0;2
11817; 123.0 ; 245.9 ; 112.0 ;2;13;5;2;0;0;2;2;0;1;0;1
11818; 53.1 ; 159.3 ; 23.3 ;3;75;126;0;3;0;3;2;1;1;1;1
11819; 37.2 ; 223.2 ; 1.7 ;6;43;78;0;6;1;5;6;0;0;6;0
11820; 28.5 ; 57.0 ; 14.8 ;2;69;180;0;2;2;0;1;1;1;1;0
11821; 26.2 ; 78.7 ; 20.6 ;3;49;4;3;0;2;1;3;0;2;1;0
11822; 47.1 ; 754.0 ; 23.8 ;16;17;32;0;16;6;10;4;12;5;6;5
11823; 46.4 ; 92.7 ; 5.1 ;2;101;15;0;2;0;2;1;1;0;2;0
11824; 35.7 ; 107.1 ; 18.3 ;3;122;42;0;3;0;3;2;1;1;2;0
11825; 23.4 ; 93.8 ; 3.4 ;4;44;73;0;4;0;4;4;0;4;0;0
11826; 78.9 ; 709.9 ; 48.5 ;9;35;5;0;9;1;8;3;6;0;0;9
11827; 53.4 ; 160.3 ; 1.7 ;3;14;248;0;3;2;1;1;2;0;2;1
11828; 20.1 ; 60.2 ; 9.3 ;3;64;160;0;3;2;1;1;2;3;0;0
11829; 26.5 ; 423.9 ; 9.7 ;16;19;37;0;16;3;13;6;10;11;5;0
11830; 16.2 ; 566.1 ; 3.1 ;35;11;0;0;35;10;25;15;20;35;0;0
11831; 33.9 ; 542.4 ; 9.2 ;16;20;9;0;16;10;6;12;4;5;11;0
11832; 83.1 ; 166.1 ; 11.5 ;2;50;199;0;2;0;2;1;1;0;0;2
11833; 49.2 ; 98.3 ; 3.6 ;2;11;147;0;2;0;2;2;0;0;2;0
11834; 69.5 ; 347.7 ; 34.1 ;5;57;217;0;5;3;2;3;2;0;0;5
11835; 39.4 ; 276.1 ; 25.2 ;7;14;299;0;7;1;6;7;0;2;3;2
11836; 45.2 ; 90.3 ; 3.5 ;2;308;78;0;2;0;2;2;0;0;2;0
11837; 21.9 ; 109.6 ; 5.5 ;5;29;242;0;5;1;4;3;2;5;0;0
11838; 52.9 ; 105.8 ; 0.5 ;2;183;63;0;2;0;2;2;0;0;2;0
11839; 25.8 ; 103.3 ; 9.7 ;4;36;178;0;4;0;4;3;1;3;1;0
11840; 35.2 ; 984.8 ; 6.0 ;28;13;10;0;28;0;28;19;9;9;19;0
11841; 30.2 ; 60.4 ; -   ;2;75;226;0;2;0;2;0;2;0;2;0
11842; 78.8 ; 630.0 ; 44.4 ;8;38;2;0;8;1;7;4;4;0;0;8
11843; 49.7 ; 248.3 ; 11.9 ;5;69;20;0;5;1;4;5;0;0;3;2
11844; 21.2 ; 106.0 ; 6.5 ;5;26;51;0;5;4;1;2;3;5;0;0
11845; 41.3 ; 206.3 ; 10.0 ;5;34;20;1;4;1;4;3;2;0;5;0
11846; 35.4 ; 1,027.2 ; 10.8 ;29;11;1;0;29;4;25;15;14;10;19;0
11847; 38.0 ; 1,290.4 ; 10.3 ;34;9;0;0;34;13;21;31;3;11;23;0
11848; 39.7 ; 79.5 ; 11.8 ;2;22;157;0;2;1;1;1;1;1;1;0
11849; 41.7 ; 83.4 ; 7.6 ;2;46;212;0;2;2;0;0;2;0;2;0
11850; 42.3 ; 1,142.7 ; 19.3 ;27;13;1;0;27;15;12;12;15;9;9;9
11851; 58.9 ; 706.5 ; 8.3 ;12;27;0;0;12;2;10;9;3;0;0;12
11852; 21.9 ; 87.6 ; 6.0 ;4;44;209;0;4;0;4;2;2;4;0;0
11853; 30.2 ; 60.4 ; -   ;2;168;169;0;2;0;2;0;2;0;2;0
11854; 19.4 ; 329.2 ; 10.8 ;17;14;2;0;17;13;4;2;15;11;6;0
11855; 39.0 ; 117.0 ; 31.1 ;3;74;127;0;3;1;2;3;0;1;1;1
11856; 27.9 ; 139.7 ; 10.0 ;5;3;211;0;5;0;5;1;4;3;2;0
11857; 42.3 ; 126.9 ; 18.4 ;3;9;163;0;3;0;3;1;2;1;1;1
11858; 59.4 ; 475.0 ; 18.6 ;8;37;70;0;8;4;4;2;6;0;0;8
11859; 33.2 ; 165.8 ; 15.5 ;5;42;48;0;5;1;4;3;2;2;3;0
11860; 56.4 ; 1,014.4 ; 31.1 ;18;16;73;0;18;3;15;15;3;6;0;12
11861; 15.2 ; 45.5 ; 0.4 ;3;8;302;0;3;1;2;1;2;3;0;0
11862; 33.8 ; 880.0 ; 37.7 ;26;15;1;0;26;11;15;16;10;9;8;9
11863; 30.9 ; 61.7 ; 23.8 ;2;118;161;0;2;2;0;0;2;1;1;0
11864; 17.5 ; 70.0 ; 5.3 ;4;62;92;0;4;2;2;4;0;4;0;0
11865; 96.2 ; 288.6 ; 10.0 ;3;47;42;0;3;0;3;2;1;0;0;3
11866; 46.8 ; 93.5 ; -   ;2;220;113;1;1;2;0;1;1;0;2;0
11867; 34.0 ; 238.1 ; 9.3 ;7;51;15;0;7;0;7;7;0;2;5;0
11868; 59.6 ; 536.6 ; 19.8 ;9;29;130;0;9;6;3;5;4;0;0;9
11869; 26.8 ; 348.3 ; 13.7 ;13;15;15;0;13;4;9;7;6;9;4;0
11870; 30.5 ; 61.1 ; 0.5 ;2;330;17;1;1;1;1;1;1;0;2;0
11871; 52.2 ; 208.8 ; 47.4 ;4;37;178;0;4;2;2;1;3;1;2;1
11872; 52.9 ; 264.7 ; 3.7 ;5;19;41;0;5;0;5;5;0;0;3;2
11873; 28.7 ; 373.7 ; 10.0 ;13;32;23;0;13;3;10;9;4;9;4;0
11874; 30.1 ; 240.6 ; 10.9 ;8;32;0;0;8;3;5;6;2;3;5;0
11875; 16.2 ; 226.9 ; 3.0 ;14;13;22;0;14;2;12;10;4;14;0;0
11876; 24.3 ; 72.8 ; 11.5 ;3;25;152;0;3;0;3;0;3;2;1;0
11877; 36.6 ; 146.4 ; -   ;4;10;75;0;4;1;3;4;0;0;4;0
11878; 42.4 ; 84.7 ; 1.6 ;2;7;320;0;2;0;2;0;2;0;2;0
11879; 27.6 ; 138.2 ; 5.8 ;5;31;122;0;5;1;4;3;2;3;2;0
11880; 34.0 ; 68.0 ; 9.1 ;2;13;199;2;0;0;2;0;2;1;1;0
11881; 43.8 ; 306.7 ; 10.9 ;7;24;5;0;7;1;6;7;0;0;7;0
11882; 35.9 ; 71.8 ; 16.2 ;2;3;300;0;2;1;1;1;1;1;1;0
11883; 65.6 ; 393.4 ; 24.5 ;6;75;15;0;6;1;5;1;5;0;0;6
11884; 17.3 ; 155.8 ; 4.4 ;9;28;62;0;9;1;8;6;3;9;0;0
11885; 22.0 ; 88.1 ; 3.1 ;4;41;86;1;3;2;2;1;3;4;0;0
11886; 20.7 ; 289.6 ; 7.9 ;14;17;23;0;14;9;5;12;2;14;0;0
11887; 15.0 ; 30.0 ; -   ;2;5;11;0;2;0;2;1;1;2;0;0
11888; 58.1 ; 116.1 ; 1.4 ;2;6;372;0;2;0;2;1;1;0;0;2
11889; 49.1 ; 147.3 ; 21.4 ;3;176;65;0;3;3;0;3;0;1;1;1
11890; 42.1 ; 588.9 ; 11.9 ;14;17;5;0;14;0;14;12;2;0;14;0
11891; 25.6 ; 51.3 ; 3.1 ;2;9;62;0;2;1;1;0;2;2;0;0
11892; 46.2 ; 92.4 ; 3.6 ;2;10;260;0;2;1;1;1;1;0;2;0
11893; 32.0 ; 511.2 ; 15.6 ;16;20;41;0;16;11;5;12;4;5;11;0
11894; 53.0 ; 848.4 ; 12.8 ;16;26;15;0;16;0;16;13;3;0;11;5
11895; 46.8 ; 93.5 ; -   ;2;13;236;0;2;0;2;0;2;0;2;0
11896; 23.0 ; 414.0 ; 9.6 ;18;14;152;0;18;5;13;8;10;12;6;0
11897; 38.3 ; 728.0 ; 2.4 ;19;16;0;0;19;8;11;3;16;0;19;0
11898; 39.5 ; 118.6 ; 13.3 ;3;27;224;0;3;2;1;1;2;1;2;0
11899; 30.9 ; 61.7 ; 23.8 ;2;11;264;0;2;1;1;0;2;1;1;0
11900; 33.3 ; 332.9 ; 16.8 ;10;34;100;1;9;7;3;2;8;3;7;0
11901; 21.8 ; 43.7 ; 4.9 ;2;295;10;0;2;0;2;2;0;2;0;0
11902; 70.3 ; 984.6 ; 54.3 ;14;25;5;0;14;3;11;11;3;5;0;9
11903; 36.4 ; 72.9 ; 4.3 ;2;213;47;0;2;0;2;1;1;0;2;0
11904; 29.3 ; 58.6 ; 14.4 ;2;207;84;0;2;0;2;1;1;1;1;0
11905; 36.0 ; 863.9 ; 9.3 ;24;8;172;0;24;6;18;10;14;8;16;0
11906; 87.1 ; 261.2 ; 62.8 ;3;34;116;0;3;0;3;2;1;1;0;2
11907; 43.8 ; 131.5 ; 6.7 ;3;29;83;2;1;0;3;2;1;0;3;0
11908; 69.1 ; 276.3 ; 26.2 ;4;48;96;0;4;1;3;2;2;0;0;4
11909; 28.5 ; 227.7 ; 17.8 ;8;37;12;0;8;3;5;6;2;5;3;0
11910; 28.2 ; 56.3 ; 10.6 ;2;2;74;0;2;1;1;2;0;1;1;0
11911; 48.1 ; 577.7 ; 2.9 ;12;20;10;0;12;0;12;12;0;0;12;0
11912; 63.6 ; 127.3 ; 49.0 ;2;1;0;0;2;1;1;1;1;1;0;1
11913; 40.2 ; 80.4 ; 6.0 ;2;30;149;0;2;1;1;0;2;0;2;0
11914; 60.7 ; 182.0 ; 24.8 ;3;72;7;0;3;1;2;2;1;0;0;3
11915; 31.2 ; 468.7 ; 12.9 ;15;16;14;0;15;7;8;5;10;5;10;0
11916; 46.8 ; 93.7 ; 2.8 ;2;20;10;0;2;0;2;2;0;0;2;0
11917; 59.9 ; 119.7 ; 18.5 ;2;19;94;0;2;0;2;2;0;0;0;2
11918; 41.4 ; 414.5 ; 24.1 ;10;49;2;0;10;7;3;2;8;3;4;3
11919; 17.2 ; 85.9 ; 2.5 ;5;23;122;0;5;4;1;1;4;5;0;0
11920; 53.0 ; 1,060.5 ; 19.7 ;20;21;0;0;20;5;15;16;4;0;13;7
11921; 23.0 ; 69.1 ; 6.8 ;3;74;216;0;3;2;1;3;0;3;0;0
11922; 47.0 ; 93.9 ; 3.5 ;2;87;62;2;0;2;0;2;0;0;2;0
11923; 16.5 ; 247.7 ; 5.3 ;15;20;11;0;15;3;12;4;11;15;0;0
11924; 26.6 ; 53.2 ; 2.3 ;2;194;115;0;2;0;2;2;0;2;0;0
11925; 35.9 ; 71.8 ; 16.2 ;2;23;269;0;2;0;2;2;0;1;1;0
11926; 88.6 ; 177.1 ; 61.5 ;2;5;64;2;0;0;2;2;0;1;0;1
11927; 56.0 ; 168.0 ; 0.2 ;3;56;105;0;3;0;3;3;0;0;0;3
11928; 26.5 ; 79.5 ; 10.0 ;3;23;152;0;3;1;2;3;0;2;1;0
11929; 48.9 ; 146.6 ; 31.0 ;3;11;82;0;3;2;1;0;3;1;1;1
11930; 49.5 ; 297.0 ; 3.1 ;6;72;31;0;6;0;6;6;0;0;6;0
11931; 57.0 ; 740.4 ; 21.9 ;13;33;5;0;13;0;13;11;2;0;0;13
11932; 17.6 ; 158.4 ; 5.7 ;9;17;16;0;9;4;5;4;5;9;0;0
11933; 47.5 ; 94.9 ; -   ;2;19;83;0;2;0;2;2;0;0;2;0
11934; 36.9 ; 73.8 ; 14.7 ;2;92;93;0;2;2;0;0;2;1;1;0
11935; 31.1 ; 186.8 ; 17.4 ;6;63;2;0;6;4;2;1;5;2;4;0
11936; 35.6 ; 71.1 ; 23.8 ;2;18;182;0;2;2;0;0;2;1;0;1
11937; 45.0 ; 180.0 ; 18.0 ;4;50;22;0;4;1;3;3;1;1;2;1
11938; 34.8 ; 69.5 ; 6.8 ;2;41;236;0;2;1;1;1;1;1;1;0
11939; 40.2 ; 80.4 ; 25.9 ;2;94;137;0;2;0;2;0;2;1;0;1
11940; 41.9 ; 83.7 ; 16.0 ;2;212;205;0;2;0;2;2;0;1;0;1
11941; 53.9 ; 161.7 ; 12.5 ;3;47;95;0;3;1;2;1;2;0;2;1
11942; 54.1 ; 162.4 ; 25.8 ;3;68;161;0;3;2;1;1;2;1;1;1
11943; 15.0 ; 59.9 ; -   ;4;33;99;0;4;2;2;1;3;4;0;0
11944; 104.6 ; 418.3 ; 39.4 ;4;34;40;0;4;1;3;4;0;0;0;4
11945; 43.8 ; 87.7 ; 4.4 ;2;42;74;0;2;0;2;1;1;0;2;0
11946; 29.0 ; 116.2 ; 13.4 ;4;2;38;0;4;2;2;2;2;3;1;0
11947; 18.8 ; 37.7 ; 1.2 ;2;25;141;0;2;0;2;2;0;2;0;0
11948; 62.9 ; 1,195.7 ; 15.7 ;19;14;3;0;19;17;2;12;7;0;0;19
11949; 59.6 ; 1,431.3 ; 16.6 ;24;18;10;0;24;6;18;9;15;0;0;24
11950; 52.5 ; 105.0 ; 7.5 ;2;4;36;0;2;1;1;2;0;0;1;1
11951; 52.1 ; 1,093.7 ; 14.0 ;21;17;38;0;21;8;13;11;10;0;14;7
11952; 61.4 ; 184.1 ; 33.8 ;3;50;29;0;3;2;1;1;2;1;0;2
11953; 83.8 ; 586.7 ; 43.0 ;7;25;20;1;6;0;7;7;0;0;0;7
11954; 36.4 ; 181.9 ; 8.7 ;5;72;6;0;5;2;3;2;3;2;3;0
11955; 47.4 ; 236.9 ; 12.8 ;5;67;47;0;5;0;5;4;1;0;3;2
11956; 18.8 ; 546.2 ; 6.4 ;29;14;0;0;29;8;21;22;7;29;0;0
11957; 28.0 ; 251.9 ; 9.4 ;9;23;1;0;9;1;8;4;5;6;3;0
11958; 16.8 ; 33.6 ; 2.7 ;2;1;255;0;2;1;1;2;0;2;0;0
11959; 15.0 ; 45.0 ; -   ;3;11;363;0;3;2;1;1;2;3;0;0
11960; 17.1 ; 274.2 ; 2.8 ;16;18;28;0;16;2;14;1;15;16;0;0
11961; 35.9 ; 71.8 ; 16.2 ;2;163;59;1;1;0;2;1;1;1;1;0
11962; 18.4 ; 183.9 ; 12.0 ;10;13;139;0;10;5;5;2;8;7;3;0
11963; 50.2 ; 100.4 ; 0.2 ;2;38;2;0;2;2;0;0;2;0;2;0
11964; 34.3 ; 68.6 ; 13.9 ;2;26;13;0;2;2;0;1;1;1;1;0
11965; 40.1 ; 200.3 ; 6.5 ;5;47;99;0;5;2;3;3;2;0;5;0
11966; 97.5 ; 195.0 ; 0.4 ;2;41;221;0;2;1;1;0;2;0;0;2
11967; 26.1 ; 130.4 ; 12.9 ;5;32;10;0;5;0;5;5;0;3;2;0
11968; 33.9 ; 135.8 ; 7.8 ;4;10;247;0;4;1;3;3;1;1;3;0
11969; 43.6 ; 130.8 ; 5.9 ;3;6;99;0;3;0;3;1;2;0;3;0
11970; 30.0 ; 270.0 ; 4.7 ;9;16;4;0;9;3;6;2;7;3;6;0
11971; 36.4 ; 255.1 ; 11.4 ;7;52;9;0;7;1;6;3;4;2;5;0
11972; 38.0 ; 114.0 ; 17.8 ;3;14;143;3;0;2;1;3;0;1;1;1
11973; 55.8 ; 111.5 ; 6.3 ;2;220;164;0;2;0;2;1;1;0;0;2
11974; 16.4 ; 82.1 ; 2.1 ;5;9;137;5;0;4;1;5;0;5;0;0
11975; 55.1 ; 385.9 ; 4.6 ;7;38;32;0;7;0;7;5;2;0;0;7
11976; 24.0 ; 48.0 ; 9.3 ;2;181;88;1;1;2;0;2;0;1;1;0
11977; 22.7 ; 522.2 ; 3.7 ;23;13;0;0;23;6;17;3;20;23;0;0
11978; 55.6 ; 166.8 ; 4.4 ;3;20;83;0;3;0;3;2;1;0;0;3
11979; 29.7 ; 59.4 ; 0.5 ;2;172;2;2;0;2;0;2;0;1;1;0
11980; 51.2 ; 307.5 ; 20.0 ;6;27;252;0;6;2;4;1;5;0;4;2
11981; 25.1 ; 275.7 ; -   ;11;15;32;0;11;2;9;5;6;11;0;0
11982; 15.0 ; 45.0 ; -   ;3;47;325;0;3;0;3;1;2;3;0;0
11983; 48.1 ; 481.4 ; 20.8 ;10;14;5;0;10;1;9;4;6;3;4;3
11984; 48.4 ; 96.9 ; 4.6 ;2;64;20;0;2;1;1;2;0;0;2;0
11985; 25.1 ; 75.2 ; -   ;3;34;0;0;3;1;2;3;0;3;0;0
11986; 60.6 ; 242.3 ; 23.2 ;4;19;309;0;4;0;4;4;0;0;0;4
11987; 29.0 ; 173.9 ; 14.0 ;6;54;17;0;6;4;2;4;2;4;2;0
11988; 48.9 ; 244.5 ; 15.4 ;5;45;157;0;5;2;3;4;1;0;3;2
11989; 60.6 ; 181.8 ; 40.4 ;3;122;3;3;0;3;0;1;2;1;0;2
11990; 114.9 ; 229.9 ; 107.9 ;2;38;183;0;2;0;2;2;0;1;0;1
11991; 32.3 ; 161.7 ; 20.4 ;5;50;110;0;5;0;5;0;5;2;3;0
11992; 58.4 ; 1,168.8 ; 25.7 ;20;15;11;0;20;8;12;12;8;0;0;20
11993; 68.7 ; 137.4 ; 2.9 ;2;87;5;0;2;0;2;2;0;0;0;2
11994; 30.1 ; 150.4 ; 11.9 ;5;56;35;0;5;2;3;2;3;2;3;0
11995; 22.5 ; 337.9 ; 10.7 ;15;20;11;0;15;5;10;9;6;10;5;0
11996; 88.6 ; 620.2 ; 18.9 ;7;42;20;0;7;0;7;6;1;0;0;7
11997; 78.3 ; 469.7 ; 24.6 ;6;43;41;1;5;0;6;5;1;0;0;6
11998; 55.4 ; 332.3 ; 59.8 ;6;42;32;0;6;2;4;4;2;2;0;4
11999; 19.6 ; 58.8 ; 0.1 ;3;101;134;0;3;3;0;1;2;3;0;0
12000; 87.4 ; 174.8 ; 93.4 ;2;132;195;0;2;0;2;2;0;1;0;1
12001; 35.4 ; 106.2 ; 8.3 ;3;43;311;0;3;0;3;2;1;1;2;0
12002; 51.0 ; 102.1 ; 2.2 ;2;32;234;0;2;2;0;0;2;0;2;0
12003; 46.3 ; 277.6 ; 12.8 ;6;13;5;0;6;3;3;2;4;0;4;2
12004; 26.1 ; 52.3 ; 7.6 ;2;22;134;0;2;1;1;0;2;1;1;0
12005; 17.9 ; 35.7 ; 4.3 ;2;45;168;0;2;1;1;1;1;2;0;0
12006; 57.1 ; 1,314.0 ; 39.7 ;23;13;11;0;23;6;17;10;13;8;0;15
12007; 59.4 ; 118.9 ; 21.5 ;2;8;137;0;2;1;1;2;0;0;0;2
12008; 48.6 ; 97.2 ; -   ;2;50;267;0;2;0;2;2;0;0;2;0
12009; 17.1 ; 34.2 ; 3.2 ;2;32;14;0;2;1;1;0;2;2;0;0
12010; 48.1 ; 96.1 ; 17.2 ;2;145;83;0;2;0;2;2;0;0;1;1
12011; 20.3 ; 1,803.5 ; 9.9 ;89;5;10;0;89;44;45;18;71;59;30;0
12012; 81.1 ; 243.3 ; 4.0 ;3;79;93;0;3;1;2;3;0;0;0;3
12013; 16.8 ; 50.4 ; 3.3 ;3;55;209;0;3;3;0;1;2;3;0;0
12014; 42.5 ; 212.4 ; 20.4 ;5;44;28;0;5;1;4;0;5;2;1;2
12015; 72.2 ; 288.7 ; 13.7 ;4;10;252;0;4;0;4;4;0;0;0;4
12016; 42.4 ; 169.7 ; 20.3 ;4;59;68;1;3;1;3;2;2;1;2;1
12017; 53.3 ; 159.9 ; 15.3 ;3;47;99;0;3;0;3;3;0;0;2;1
12018; 32.7 ; 163.6 ; 14.8 ;5;36;153;0;5;0;5;5;0;2;3;0
12019; 48.2 ; 240.9 ; 48.7 ;5;49;47;0;5;3;2;2;3;2;1;2
12020; 48.2 ; 192.7 ; 2.1 ;4;150;11;0;4;0;4;4;0;0;4;0
12021; 79.4 ; 396.8 ; 8.5 ;5;58;99;0;5;0;5;5;0;0;0;5
12022; 64.0 ; 319.9 ; 23.7 ;5;35;131;0;5;0;5;2;3;0;0;5
12023; 109.6 ; 438.3 ; 30.8 ;4;11;356;0;4;0;4;4;0;0;0;4
12024; 71.3 ; 213.8 ; 32.0 ;3;31;105;0;3;0;3;3;0;0;0;3
12025; 55.0 ; 110.0 ; 3.7 ;2;13;330;0;2;0;2;1;1;0;0;2
12026; 15.0 ; 45.0 ; -   ;3;17;208;0;3;2;1;1;2;3;0;0
12027; 31.8 ; 254.5 ; 9.0 ;8;10;243;0;8;3;5;5;3;3;5;0
12028; 54.3 ; 217.2 ; 28.9 ;4;31;189;0;4;0;4;3;1;1;2;1
12029; 50.1 ; 100.1 ; -   ;2;4;13;2;0;1;1;1;1;0;2;0
12030; 53.8 ; 107.7 ; 3.4 ;2;8;106;0;2;1;1;0;2;0;1;1
12031; 28.9 ; 520.2 ; 9.0 ;18;23;6;0;18;2;16;5;13;12;6;0
12032; 71.6 ; 143.1 ; 37.2 ;2;448;4;1;1;1;1;1;1;0;0;2
12033; 36.6 ; 73.2 ; -   ;2;4;226;0;2;1;1;1;1;0;2;0
12034; 24.8 ; 99.3 ; 12.7 ;4;47;77;0;4;3;1;4;0;3;1;0
12035; 45.1 ; 135.3 ; 15.0 ;3;22;252;0;3;1;2;3;0;0;2;1
12036; 54.9 ; 219.6 ; 6.5 ;4;18;166;0;4;3;1;2;2;0;3;1
12037; 19.9 ; 378.2 ; 10.4 ;19;20;14;0;19;13;6;6;13;13;6;0
12038; 43.3 ; 173.1 ; 40.7 ;4;99;15;3;1;2;2;4;0;1;2;1
12039; 61.8 ; 123.7 ; 22.6 ;2;17;116;2;0;0;2;0;2;0;0;2
12040; 41.5 ; 207.7 ; 9.1 ;5;41;136;0;5;1;4;4;1;0;5;0
12041; 22.9 ; 45.8 ; 4.9 ;2;13;265;0;2;2;0;2;0;2;0;0
12042; 43.5 ; 87.1 ; 20.0 ;2;230;50;0;2;1;1;0;2;1;0;1
12043; 15.0 ; 30.0 ; -   ;2;11;248;0;2;0;2;2;0;2;0;0
12044; 67.2 ; 134.4 ; 39.4 ;2;23;170;2;0;1;1;2;0;1;0;1
12045; 27.0 ; 134.9 ; 5.0 ;5;59;19;0;5;1;4;0;5;3;2;0
12046; 68.1 ; 340.5 ; 42.8 ;5;20;45;0;5;2;3;5;0;2;0;3
12047; 28.5 ; 142.3 ; 13.8 ;5;67;60;0;5;5;0;1;4;3;2;0
12048; 34.6 ; 138.3 ; 17.3 ;4;86;157;0;4;0;4;2;2;1;3;0
12049; 55.7 ; 278.5 ; 20.4 ;5;30;8;0;5;1;4;2;3;0;0;5
12050; 78.6 ; 235.9 ; 28.6 ;3;29;40;0;3;2;1;2;1;0;0;3
12051; 48.3 ; 241.6 ; 6.7 ;5;47;57;0;5;2;3;3;2;0;3;2
12052; 55.9 ; 447.0 ; 25.4 ;8;41;73;0;8;0;8;6;2;0;0;8
12053; 96.9 ; 484.7 ; 47.3 ;5;16;65;5;0;4;1;0;5;0;0;5
12054; 31.0 ; 123.9 ; 12.5 ;4;14;141;0;4;1;3;2;2;1;3;0
12055; 17.3 ; 34.7 ; 3.5 ;2;9;289;0;2;1;1;1;1;2;0;0
12056; 46.9 ; 234.3 ; 10.7 ;5;76;122;0;5;3;2;1;4;0;3;2
12057; 37.1 ; 111.2 ; 20.3 ;3;4;128;0;3;3;0;2;1;1;1;1
12058; 36.1 ; 180.3 ; 15.9 ;5;26;274;0;5;1;4;4;1;2;3;0
12059; 86.7 ; 260.0 ; 31.7 ;3;193;68;0;3;1;2;1;2;0;0;3
12060; 49.0 ; 930.1 ; 3.8 ;19;15;71;0;19;8;11;7;12;0;19;0
12061; 36.0 ; 251.7 ; 39.2 ;7;54;26;0;7;3;4;0;7;2;3;2
12062; 80.0 ; 160.1 ; 1.7 ;2;139;110;0;2;0;2;2;0;0;0;2
12063; 35.8 ; 178.9 ; 12.4 ;5;26;185;0;5;3;2;2;3;2;3;0
12064; 24.7 ; 665.8 ; 9.4 ;27;8;2;0;27;3;24;13;14;18;9;0
12065; 55.1 ; 165.3 ; 15.3 ;3;18;187;0;3;3;0;1;2;0;0;3
12066; 39.3 ; 196.4 ; 5.0 ;5;32;5;3;2;0;5;3;2;0;5;0
12067; 45.5 ; 227.3 ; 2.5 ;5;66;14;0;5;1;4;1;4;0;5;0
12068; 53.1 ; 265.3 ; 14.5 ;5;62;49;0;5;3;2;5;0;0;3;2
12069; 45.9 ; 91.8 ; 3.4 ;2;40;4;0;2;1;1;2;0;0;2;0
12070; 43.4 ; 130.1 ; 6.2 ;3;85;105;0;3;1;2;1;2;0;3;0
12071; 49.8 ; 597.1 ; 15.7 ;12;14;5;0;12;3;9;7;5;0;8;4
12072; 50.5 ; 101.0 ; 2.7 ;2;210;40;0;2;1;1;1;1;0;2;0
12073; 42.0 ; 84.0 ; 17.7 ;2;12;185;0;2;0;2;0;2;1;0;1
12074; 20.0 ; 40.1 ; 7.6 ;2;63;52;0;2;0;2;2;0;2;0;0
12075; 25.8 ; 51.6 ; 16.2 ;2;220;80;0;2;0;2;2;0;1;1;0
12076; 57.5 ; 230.0 ; 12.6 ;4;66;57;0;4;1;3;2;2;0;0;4
12077; 16.5 ; 33.0 ; 2.3 ;2;147;5;0;2;1;1;0;2;2;0;0
12078; 19.3 ; 308.2 ; 10.7 ;16;17;5;0;16;8;8;13;3;16;0;0
12079; 26.5 ; 318.1 ; 11.6 ;12;25;14;0;12;4;8;9;3;8;4;0
12080; 26.0 ; 104.0 ; 1.8 ;4;30;23;0;4;4;0;2;2;4;0;0
12081; 63.7 ; 636.8 ; 33.5 ;10;30;29;0;10;2;8;4;6;0;0;10
12082; 21.1 ; 105.3 ; 8.8 ;5;14;230;0;5;3;2;3;2;5;0;0
12083; 15.0 ; 30.0 ; -   ;2;52;235;0;2;1;1;2;0;2;0;0
12084; 38.4 ; 76.8 ; 13.6 ;2;169;56;0;2;2;0;0;2;1;1;0
12085; 34.6 ; 69.3 ; 20.3 ;2;299;23;0;2;1;1;1;1;1;1;0
12086; 31.2 ; 187.3 ; 9.7 ;6;35;0;0;6;1;5;3;3;2;4;0
12087; 51.1 ; 153.3 ; 13.7 ;3;63;167;0;3;0;3;2;1;0;2;1
12088; 29.5 ; 236.0 ; 15.5 ;8;30;95;0;8;1;7;6;2;5;3;0
12089; 76.1 ; 152.1 ; 37.5 ;2;18;152;0;2;0;2;2;0;0;0;2
12090; 34.8 ; 139.0 ; 9.9 ;4;52;101;0;4;0;4;3;1;1;3;0
12091; 98.5 ; 492.4 ; 41.7 ;5;38;99;0;5;0;5;5;0;0;0;5
12092; 20.3 ; 60.8 ; 9.7 ;3;9;11;0;3;0;3;0;3;3;0;0
12093; 36.3 ; 72.5 ; 16.8 ;2;43;29;0;2;2;0;0;2;1;1;0
12094; 48.0 ; 1,440.2 ; 18.2 ;30;13;0;0;30;0;30;29;1;10;10;10
12095; 38.6 ; 540.7 ; 4.5 ;14;22;6;0;14;3;11;13;1;0;14;0
12096; 21.8 ; 65.5 ; 7.4 ;3;14;211;0;3;1;2;1;2;3;0;0
12097; 31.3 ; 93.9 ; 17.9 ;3;32;232;0;3;1;2;2;1;1;2;0
12098; 30.9 ; 61.7 ; 23.8 ;2;7;194;2;0;0;2;2;0;1;1;0
12099; 42.9 ; 85.7 ; 32.1 ;2;80;116;0;2;0;2;1;1;1;0;1
12100; 42.4 ; 127.1 ; 19.3 ;3;84;68;0;3;1;2;1;2;1;1;1
12101; 51.3 ; 461.5 ; 11.5 ;9;28;30;0;9;2;7;8;1;0;6;3
12102; 39.1 ; 1,369.1 ; 18.7 ;35;9;10;0;35;15;20;8;27;12;11;12
12103; 32.7 ; 98.0 ; 23.8 ;3;2;258;0;3;1;2;3;0;1;1;1
12104; 49.9 ; 99.8 ; 3.6 ;2;118;0;0;2;0;2;2;0;0;2;0
12105; 30.1 ; 150.4 ; 15.3 ;5;14;327;0;5;2;3;3;2;2;3;0
12106; 36.6 ; 73.2 ; -   ;2;168;223;0;2;1;1;0;2;0;2;0
12107; 58.6 ; 527.5 ; 9.1 ;9;35;115;0;9;4;5;8;1;0;0;9
12108; 31.3 ; 93.9 ; 16.9 ;3;13;178;0;3;0;3;2;1;1;2;0
12109; 21.4 ; 64.1 ; 9.9 ;3;13;27;0;3;1;2;2;1;2;1;0
12110; 58.2 ; 291.0 ; 16.7 ;5;26;78;5;0;4;1;5;0;0;0;5
12111; 20.0 ; 40.1 ; 7.6 ;2;24;371;0;2;2;0;0;2;2;0;0
12112; 55.5 ; 1,276.6 ; 19.7 ;23;14;16;0;23;4;19;21;2;0;0;23
12113; 47.1 ; 94.2 ; 0.5 ;2;113;53;0;2;0;2;1;1;0;2;0
12114; 41.4 ; 165.5 ; 0.4 ;4;8;10;0;4;0;4;3;1;0;4;0
12115; 62.6 ; 1,440.4 ; 17.5 ;23;12;0;0;23;0;23;23;0;0;0;23
12116; 41.7 ; 125.1 ; 15.6 ;3;84;1;1;2;1;2;1;2;1;1;1
12117; 38.1 ; 343.0 ; 7.7 ;9;34;14;0;9;1;8;7;2;0;9;0
12118; 27.6 ; 276.3 ; 14.0 ;10;24;17;0;10;2;8;6;4;7;3;0
12119; 18.0 ; 54.0 ; -   ;3;34;40;3;0;2;1;3;0;3;0;0
12120; 27.0 ; 80.9 ; 11.2 ;3;6;5;0;3;0;3;2;1;2;1;0
12121; 18.5 ; 258.6 ; 6.8 ;14;16;62;0;14;4;10;3;11;14;0;0
12122; 29.2 ; 117.0 ; 8.4 ;4;11;161;0;4;2;2;2;2;3;1;0
12123; 16.9 ; 50.6 ; 1.7 ;3;29;130;0;3;1;2;1;2;3;0;0
12124; 47.7 ; 95.4 ; 1.4 ;2;138;173;0;2;0;2;2;0;0;2;0
12125; 16.7 ; 350.9 ; 3.9 ;21;20;12;0;21;13;8;3;18;21;0;0
12126; 15.0 ; 30.0 ; -   ;2;1;146;0;2;1;1;0;2;2;0;0
12127; 46.8 ; 93.5 ; -   ;2;38;153;0;2;0;2;0;2;0;2;0
12128; 39.4 ; 78.8 ; 13.8 ;2;43;218;0;2;2;0;1;1;1;1;0
12129; 41.6 ; 208.1 ; 12.6 ;5;38;52;5;0;2;3;5;0;2;3;0
12130; 54.8 ; 164.3 ; 35.7 ;3;27;19;3;0;1;2;0;3;1;1;1
12131; 40.1 ; 321.0 ; 21.4 ;8;32;5;0;8;3;5;3;5;3;2;3
12132; 74.3 ; 222.9 ; 40.6 ;3;14;142;2;1;2;1;2;1;0;0;3
12133; 102.1 ; 204.3 ; 82.9 ;2;177;116;0;2;0;2;0;2;1;0;1
12134; 28.1 ; 364.8 ; 15.5 ;13;24;18;0;13;6;7;3;10;9;4;0
12135; 45.5 ; 409.4 ; 17.0 ;9;35;11;0;9;1;8;9;0;3;3;3
12136; 25.6 ; 76.7 ; 11.4 ;3;5;258;0;3;1;2;3;0;2;1;0
12137; 23.6 ; 94.5 ; 6.4 ;4;22;295;0;4;2;2;3;1;3;1;0
12138; 75.4 ; 3,243.4 ; 44.8 ;43;10;5;0;43;3;40;30;13;0;0;43
12139; 30.4 ; 60.9 ; 8.0 ;2;121;14;0;2;1;1;1;1;1;1;0
12140; 54.1 ; 270.6 ; 18.6 ;5;38;14;0;5;1;4;1;4;0;3;2
12141; 89.7 ; 179.4 ; 61.5 ;2;6;140;0;2;1;1;2;0;1;0;1
12142; 18.5 ; 74.0 ; 3.5 ;4;17;94;0;4;0;4;1;3;4;0;0
12143; 42.8 ; 85.5 ; 6.0 ;2;98;236;0;2;1;1;0;2;0;2;0
12144; 44.7 ; 89.5 ; -   ;2;14;188;0;2;0;2;2;0;0;2;0
12145; 42.3 ; 888.0 ; 20.2 ;21;14;38;0;21;5;16;5;16;7;7;7
12146; 20.4 ; 285.2 ; 12.0 ;14;12;20;0;14;8;6;8;6;9;5;0
12147; 32.2 ; 451.5 ; 12.8 ;14;16;62;0;14;11;3;9;5;5;9;0
12148; 40.2 ; 201.1 ; 14.5 ;5;61;16;0;5;1;4;3;2;2;3;0
12149; 46.8 ; 140.5 ; 9.4 ;3;146;54;0;3;3;0;1;2;0;2;1
12150; 29.8 ; 59.5 ; 7.0 ;2;9;190;0;2;1;1;0;2;1;1;0
12151; 93.3 ; 186.6 ; 22.4 ;2;80;33;0;2;1;1;2;0;0;0;2
12152; 25.1 ; 50.1 ; -   ;2;87;152;0;2;0;2;0;2;2;0;0
12153; 32.2 ; 64.4 ; 10.7 ;2;32;184;0;2;0;2;1;1;1;1;0
12154; 57.0 ; 512.8 ; 28.8 ;9;28;10;0;9;3;6;6;3;3;0;6
12155; 75.2 ; 150.5 ; 41.0 ;2;50;20;0;2;0;2;2;0;0;0;2
12156; 43.6 ; 217.9 ; 24.9 ;5;68;66;0;5;2;3;3;2;2;1;2
12157; 47.0 ; 798.7 ; 5.2 ;17;23;5;0;17;0;17;17;0;0;17;0
12158; 39.8 ; 596.8 ; 13.3 ;15;21;24;0;15;4;11;5;10;5;10;0
12159; 26.2 ; 104.7 ; 9.2 ;4;59;120;0;4;2;2;2;2;3;1;0
12160; 49.5 ; 346.5 ; 14.8 ;7;45;136;0;7;2;5;5;2;0;5;2
12161; 35.9 ; 71.8 ; 16.2 ;2;55;215;0;2;1;1;1;1;1;1;0
12162; 17.4 ; 87.2 ; 3.5 ;5;23;1;0;5;0;5;4;1;5;0;0
12163; 48.8 ; 439.2 ; 11.3 ;9;36;9;0;9;3;6;5;4;0;6;3
12164; 44.0 ; 88.1 ; 17.0 ;2;214;116;0;2;0;2;1;1;1;0;1
12165; 27.3 ; 136.3 ; 16.5 ;5;26;107;0;5;2;3;1;4;3;2;0
12166; 20.4 ; 102.1 ; 9.7 ;5;61;53;0;5;0;5;2;3;3;2;0
12167; 41.4 ; 82.8 ; 8.0 ;2;14;98;0;2;1;1;1;1;0;2;0
12168; 18.6 ; 37.2 ; 1.2 ;2;81;210;0;2;0;2;2;0;2;0;0
12169; 110.2 ; 220.4 ; 89.1 ;2;11;389;0;2;0;2;1;1;1;0;1
12170; 55.5 ; 166.4 ; 8.4 ;3;15;137;0;3;1;2;2;1;0;0;3
12171; 29.1 ; 87.3 ; 15.0 ;3;10;1;0;3;1;2;0;3;2;1;0
12172; 47.4 ; 94.7 ; 0.9 ;2;37;242;0;2;0;2;1;1;0;2;0
12173; 36.6 ; 731.0 ; 12.2 ;20;14;20;0;20;1;19;8;12;7;13;0
12174; 44.8 ; 89.6 ; 2.9 ;2;23;206;0;2;0;2;0;2;0;2;0
12175; 26.6 ; 106.4 ; 3.2 ;4;88;75;0;4;3;1;1;3;4;0;0
12176; 82.5 ; 164.9 ; 22.4 ;2;297;15;0;2;0;2;1;1;0;0;2
12177; 24.6 ; 172.5 ; 6.5 ;7;37;52;0;7;0;7;5;2;5;2;0
12178; 26.1 ; 78.3 ; 9.8 ;3;2;104;0;3;2;1;1;2;2;1;0
12179; 25.6 ; 408.8 ; 7.4 ;16;19;5;0;16;3;13;4;12;11;5;0
12180; 41.9 ; 83.8 ; 1.4 ;2;24;98;2;0;2;0;2;0;0;2;0
12181; 45.9 ; 229.4 ; 39.6 ;5;61;36;0;5;1;4;3;2;2;1;2
12182; 72.1 ; 144.1 ; 37.9 ;2;125;197;0;2;2;0;2;0;0;0;2
12183; 39.0 ; 116.9 ; 18.7 ;3;148;35;2;1;3;0;1;2;1;1;1
12184; 56.2 ; 280.9 ; 4.9 ;5;60;26;0;5;0;5;3;2;0;0;5
12185; 46.8 ; 187.4 ; 2.6 ;4;37;95;0;4;1;3;2;2;0;4;0
12186; 41.4 ; 82.7 ; 16.7 ;2;25;188;0;2;0;2;2;0;1;0;1
12187; 38.7 ; 348.6 ; 12.4 ;9;19;19;0;9;3;6;4;5;3;6;0
12188; 87.5 ; 437.7 ; 44.7 ;5;7;4;0;5;5;0;1;4;0;0;5
12189; 32.5 ; 162.6 ; 12.3 ;5;10;65;1;4;1;4;3;2;2;3;0
12190; 15.0 ; 59.9 ; -   ;4;65;2;0;4;2;2;2;2;4;0;0
12191; 37.6 ; 150.3 ; 11.0 ;4;77;6;0;4;0;4;2;2;1;3;0
12192; 34.9 ; 69.8 ; 17.7 ;2;87;205;0;2;0;2;1;1;1;1;0
12193; 32.0 ; 224.1 ; 19.2 ;7;35;5;3;4;2;5;5;2;2;5;0
12194; 22.7 ; 545.1 ; 9.0 ;24;9;44;0;24;8;16;18;6;16;8;0
12195; 48.0 ; 239.8 ; 13.2 ;5;43;10;0;5;0;5;5;0;0;3;2
12196; 47.4 ; 236.9 ; 7.2 ;5;50;14;1;4;1;4;3;2;0;5;0
12197; 43.2 ; 561.5 ; 10.2 ;13;32;8;2;11;7;6;7;6;0;13;0
12198; 25.3 ; 101.1 ; 19.3 ;4;56;196;0;4;1;3;3;1;3;1;0
12199; 46.8 ; 93.5 ; -   ;2;76;104;0;2;0;2;0;2;0;2;0
12200; 53.2 ; 159.5 ; 8.2 ;3;63;136;1;2;0;3;2;1;0;2;1
12201; 20.1 ; 503.2 ; 7.2 ;25;12;2;0;25;15;10;14;11;25;0;0
12202; 39.3 ; 117.9 ; 22.8 ;3;105;88;0;3;1;2;2;1;1;1;1
12203; 29.8 ; 327.4 ; 19.7 ;11;27;25;0;11;6;5;4;7;7;4;0
12204; 40.8 ; 897.8 ; 11.7 ;22;13;0;0;22;4;18;6;16;7;15;0
12205; 59.1 ; 177.3 ; 19.1 ;3;41;173;0;3;0;3;2;1;0;0;3
12206; 37.2 ; 446.4 ; 8.0 ;12;25;23;0;12;7;5;5;7;4;8;0
12207; 27.4 ; 109.4 ; 7.6 ;4;105;11;0;4;3;1;2;2;3;1;0
12208; 50.7 ; 406.0 ; 24.7 ;8;35;8;0;8;2;6;4;4;3;2;3
12209; 56.8 ; 737.8 ; 21.3 ;13;14;0;0;13;8;5;3;10;0;0;13
12210; 29.6 ; 296.4 ; 12.8 ;10;28;99;0;10;7;3;7;3;7;3;0
12211; 39.0 ; 428.8 ; 34.6 ;11;22;10;0;11;4;7;9;2;4;3;4
12212; 50.2 ; 401.3 ; 7.0 ;8;25;100;0;8;3;5;8;0;0;5;3
12213; 52.1 ; 260.7 ; 7.9 ;5;12;4;0;5;2;3;1;4;0;3;2
12214; 31.6 ; 220.9 ; 14.0 ;7;60;22;0;7;0;7;5;2;2;5;0
12215; 19.0 ; 57.1 ; 6.2 ;3;5;5;0;3;1;2;3;0;3;0;0
12216; 16.6 ; 33.2 ; 2.4 ;2;11;5;0;2;1;1;0;2;2;0;0
12217; 15.0 ; 30.0 ; -   ;2;141;2;0;2;1;1;0;2;2;0;0
12218; 36.6 ; 109.8 ; -   ;3;48;11;0;3;1;2;1;2;0;3;0
12219; 60.9 ; 487.0 ; 19.6 ;8;27;21;0;8;0;8;7;1;0;0;8
12220; 26.6 ; 53.2 ; 12.8 ;2;55;32;0;2;0;2;1;1;1;1;0
12221; 38.3 ; 153.1 ; 14.8 ;4;38;8;0;4;4;0;2;2;1;3;0
12222; 35.4 ; 176.8 ; 10.4 ;5;19;58;0;5;2;3;0;5;2;3;0
12223; 33.5 ; 167.7 ; 11.1 ;5;7;124;0;5;3;2;5;0;2;3;0
12224; 25.9 ; 336.1 ; 8.2 ;13;12;122;0;13;8;5;5;8;9;4;0
12225; 20.9 ; 313.4 ; 5.7 ;15;15;3;0;15;8;7;3;12;15;0;0
12226; 25.9 ; 129.5 ; 6.5 ;5;32;152;0;5;2;3;3;2;3;2;0
12227; 36.3 ; 181.5 ; 21.6 ;5;62;22;0;5;0;5;3;2;2;1;2
12228; 72.4 ; 217.3 ; 34.5 ;3;5;252;0;3;2;1;1;2;0;0;3
12229; 22.1 ; 110.6 ; 9.6 ;5;21;93;0;5;4;1;0;5;3;2;0
12230; 34.2 ; 170.8 ; 10.0 ;5;19;90;1;4;4;1;1;4;2;3;0
12231; 26.2 ; 236.2 ; 16.3 ;9;23;5;0;9;4;5;5;4;6;3;0
12232; 45.2 ; 90.3 ; 3.5 ;2;231;69;0;2;0;2;0;2;0;2;0
12233; 38.9 ; 194.6 ; 17.5 ;5;85;2;0;5;4;1;1;4;2;1;2
12234; 15.0 ; 89.9 ; -   ;6;32;10;0;6;2;4;1;5;6;0;0
12235; 55.7 ; 1,225.4 ; 10.4 ;22;18;22;0;22;6;16;22;0;0;0;22
12236; 47.0 ; 281.7 ; 0.4 ;6;26;62;0;6;0;6;5;1;0;6;0
12237; 53.9 ; 161.8 ; 11.8 ;3;85;20;0;3;1;2;2;1;0;2;1
12238; 19.9 ; 119.6 ; 7.9 ;6;50;17;0;6;3;3;5;1;6;0;0
12239; 53.9 ; 269.5 ; 7.4 ;5;41;26;0;5;1;4;2;3;0;3;2
12240; 25.8 ; 77.4 ; 3.0 ;3;14;105;0;3;1;2;3;0;3;0;0
12241; 17.1 ; 136.4 ; 1.6 ;8;41;2;4;4;5;3;2;6;8;0;0
12242; 53.2 ; 106.5 ; -   ;2;24;80;0;2;0;2;0;2;0;2;0
12243; 37.8 ; 302.4 ; 3.8 ;8;14;0;1;7;1;7;7;1;0;8;0
12244; 21.7 ; 65.1 ; 6.2 ;3;20;257;0;3;1;2;1;2;3;0;0
12245; 31.5 ; 441.4 ; 6.0 ;14;21;8;0;14;8;6;7;7;5;9;0
12246; 23.3 ; 186.6 ; 7.7 ;8;34;31;0;8;0;8;6;2;5;3;0
12247; 48.7 ; 146.0 ; 11.6 ;3;49;113;0;3;1;2;2;1;0;2;1
12248; 45.9 ; 1,606.2 ; 16.0 ;35;7;1;0;35;13;22;21;14;12;11;12
12249; 20.5 ; 143.4 ; 11.5 ;7;19;2;0;7;4;3;3;4;5;2;0
12250; 50.0 ; 250.0 ; 6.8 ;5;58;71;0;5;2;3;1;4;0;3;2
12251; 33.5 ; 267.8 ; 14.1 ;8;23;101;0;8;3;5;3;5;3;5;0
12252; 62.6 ; 187.7 ; 28.4 ;3;28;83;3;0;0;3;3;0;0;0;3
12253; 55.6 ; 278.2 ; 14.9 ;5;38;38;0;5;1;4;1;4;0;0;5
12254; 36.2 ; 180.9 ; 8.8 ;5;41;94;0;5;0;5;4;1;2;3;0
12255; 63.5 ; 190.6 ; 30.3 ;3;41;225;0;3;0;3;1;2;0;0;3
12256; 24.1 ; 72.2 ; 17.2 ;3;43;189;0;3;0;3;0;3;2;1;0
12257; 40.8 ; 326.5 ; 25.9 ;8;31;52;0;8;1;7;4;4;3;2;3
12258; 93.4 ; 747.5 ; 55.4 ;8;42;0;0;8;0;8;6;2;0;0;8
12259; 25.8 ; 51.6 ; 16.2 ;2;4;255;0;2;2;0;0;2;1;1;0
12260; 28.6 ; 3,720.5 ; 14.8 ;130;3;17;0;130;83;47;107;23;87;43;0
12261; 65.4 ; 1,439.2 ; 30.4 ;22;18;11;0;22;10;12;6;16;0;0;22
12262; 46.7 ; 93.4 ; 8.7 ;2;144;141;0;2;0;2;2;0;0;1;1
12263; 22.6 ; 45.2 ; 11.4 ;2;12;178;0;2;0;2;1;1;1;1;0
12264; 37.0 ; 110.9 ; 12.9 ;3;155;5;0;3;1;2;1;2;1;2;0
12265; 36.4 ; 510.3 ; 21.3 ;14;20;71;0;14;7;7;2;12;5;4;5
12266; 50.3 ; 100.6 ; 4.3 ;2;107;10;1;1;0;2;2;0;0;2;0
12267; 49.6 ; 99.1 ; -   ;2;118;125;2;0;2;0;2;0;0;2;0
12268; 35.4 ; 106.2 ; 9.0 ;3;9;222;0;3;2;1;3;0;1;2;0
12269; 45.9 ; 1,468.3 ; 18.7 ;32;10;14;0;32;10;22;11;21;11;10;11
12270; 29.9 ; 149.5 ; 17.8 ;5;59;131;0;5;3;2;5;0;3;2;0
12271; 34.5 ; 483.6 ; 18.1 ;14;23;83;0;14;12;2;9;5;5;9;0
12272; 46.7 ; 93.4 ; 26.6 ;2;2;134;0;2;1;1;1;1;1;0;1
12273; 53.3 ; 106.5 ; 7.0 ;2;2;307;0;2;2;0;0;2;0;1;1
12274; 76.3 ; 305.4 ; 29.5 ;4;68;87;1;3;3;1;3;1;0;0;4
12275; 49.6 ; 99.1 ; -   ;2;101;104;1;1;0;2;2;0;0;2;0
12276; 27.9 ; 55.9 ; 12.9 ;2;62;192;0;2;2;0;0;2;1;1;0
12277; 30.6 ; 91.9 ; 16.8 ;3;58;153;1;2;2;1;3;0;1;2;0
12278; 20.6 ; 247.0 ; 9.1 ;12;17;16;2;10;3;9;11;1;12;0;0
12279; 24.2 ; 72.6 ; 0.1 ;3;65;23;0;3;1;2;2;1;3;0;0
12280; 20.5 ; 511.3 ; 7.9 ;25;12;2;0;25;5;20;11;14;25;0;0
12281; 30.9 ; 92.7 ; 23.1 ;3;57;20;0;3;1;2;2;1;1;2;0
12282; 19.7 ; 39.5 ; -   ;2;5;270;0;2;1;1;0;2;2;0;0
12283; 77.9 ; 1,791.6 ; 44.2 ;23;18;4;0;23;12;11;8;15;0;0;23
12284; 52.2 ; 156.7 ; 7.1 ;3;85;69;1;2;0;3;1;2;0;2;1
12285; 33.4 ; 200.5 ; 17.0 ;6;25;10;0;6;0;6;4;2;2;4;0
12286; 54.9 ; 109.8 ; 54.4 ;2;5;34;0;2;2;0;2;0;1;0;1
12287; 33.7 ; 168.6 ; 19.0 ;5;54;96;0;5;3;2;1;4;2;3;0
12288; 23.0 ; 206.8 ; 9.3 ;9;36;26;0;9;5;4;5;4;6;3;0
12289; 16.4 ; 49.3 ; 2.6 ;3;16;242;0;3;2;1;3;0;3;0;0
12290; 52.1 ; 156.2 ; 21.4 ;3;34;89;0;3;0;3;2;1;0;2;1
12291; 15.0 ; 74.9 ; -   ;5;14;151;0;5;2;3;0;5;5;0;0
12292; 76.0 ; 684.0 ; 54.4 ;9;37;24;0;9;6;3;4;5;3;0;6
12293; 52.3 ; 156.9 ; 30.9 ;3;104;21;0;3;0;3;1;2;1;1;1
12294; 46.4 ; 92.9 ; 22.8 ;2;36;162;0;2;1;1;0;2;1;0;1
12295; 48.1 ; 144.4 ; 0.6 ;3;23;9;0;3;1;2;1;2;0;3;0
12296; 64.9 ; 129.8 ; 27.6 ;2;5;391;0;2;2;0;0;2;0;0;2
12297; 57.3 ; 114.6 ; 9.4 ;2;78;281;0;2;1;1;1;1;0;0;2
12298; 58.2 ; 116.4 ; 2.1 ;2;41;35;0;2;1;1;1;1;0;0;2
12299; 46.8 ; 140.3 ; -   ;3;7;250;0;3;1;2;2;1;0;3;0
12300; 26.4 ; 317.3 ; 11.2 ;12;23;11;0;12;9;3;11;1;8;4;0
12301; 33.5 ; 468.6 ; 24.7 ;14;14;123;0;14;8;6;8;6;5;4;5
12302; 49.6 ; 99.3 ; 4.3 ;2;36;205;0;2;1;1;1;1;0;2;0
12303; 46.8 ; 93.5 ; -   ;2;5;185;1;1;0;2;0;2;0;2;0
12304; 27.2 ; 54.3 ; 11.2 ;2;278;35;0;2;1;1;1;1;1;1;0
12305; 51.4 ; 154.3 ; 62.8 ;3;40;242;0;3;2;1;3;0;1;1;1
12306; 28.9 ; 86.7 ; 7.0 ;3;102;98;0;3;1;2;2;1;2;1;0
12307; 30.9 ; 61.7 ; 23.8 ;2;68;221;0;2;0;2;0;2;1;1;0
12308; 18.3 ; 55.0 ; 6.2 ;3;50;17;1;2;3;0;1;2;3;0;0
12309; 56.7 ; 170.2 ; 9.2 ;3;77;109;0;3;2;1;1;2;0;0;3
12310; 47.7 ; 95.5 ; 1.5 ;2;4;200;0;2;0;2;1;1;0;2;0
12311; 158.2 ; 1,424.2 ; 76.6 ;9;22;73;0;9;4;5;8;1;0;0;9
12312; 53.5 ; 107.0 ; 5.9 ;2;24;204;0;2;0;2;1;1;0;1;1
12313; 15.0 ; 30.0 ; -   ;2;126;14;0;2;2;0;2;0;2;0;0
12314; 39.4 ; 78.9 ; 13.9 ;2;13;257;0;2;0;2;2;0;1;1;0
12315; 26.6 ; 79.7 ; 13.7 ;3;47;188;0;3;3;0;3;0;2;1;0
12316; 42.7 ; 85.4 ; 12.4 ;2;2;198;0;2;1;1;1;1;0;1;1
12317; 44.0 ; 220.2 ; 11.5 ;5;50;92;0;5;5;0;0;5;0;3;2
12318; 28.8 ; 403.2 ; 16.4 ;14;13;11;0;14;5;9;9;5;9;5;0
12319; 29.8 ; 119.3 ; 7.9 ;4;104;74;0;4;1;3;4;0;3;1;0
12320; 72.0 ; 360.1 ; 37.9 ;5;50;48;0;5;0;5;0;5;0;0;5
12321; 17.5 ; 35.0 ; 3.8 ;2;13;1;0;2;0;2;0;2;2;0;0
12322; 20.0 ; 40.1 ; 7.6 ;2;20;195;0;2;1;1;2;0;2;0;0
12323; 52.7 ; 158.1 ; 42.5 ;3;16;4;3;0;2;1;1;2;1;1;1
12324; 31.0 ; 92.9 ; 14.8 ;3;1;297;0;3;2;1;1;2;1;2;0
12325; 26.1 ; 156.8 ; 12.8 ;6;11;14;0;6;3;3;0;6;4;2;0
12326; 27.6 ; 55.2 ; 13.5 ;2;275;80;0;2;0;2;1;1;1;1;0
12327; 62.6 ; 312.9 ; 19.0 ;5;34;89;0;5;1;4;5;0;0;0;5
12328; 30.8 ; 184.9 ; 13.6 ;6;53;11;0;6;1;5;2;4;2;4;0
12329; 56.2 ; 617.9 ; 12.7 ;11;27;38;0;11;0;11;9;2;0;0;11
12330; 56.7 ; 1,248.0 ; 27.1 ;22;11;0;0;22;0;22;7;15;7;0;15
12331; 48.8 ; 97.7 ; 0.2 ;2;59;71;0;2;1;1;0;2;0;2;0
12332; 66.5 ; 199.6 ; 26.6 ;3;43;5;0;3;0;3;1;2;0;0;3
12333; 62.3 ; 311.6 ; 23.0 ;5;16;118;0;5;4;1;1;4;0;0;5
12334; 37.5 ; 112.6 ; 9.3 ;3;16;7;0;3;2;1;0;3;1;2;0
12335; 41.1 ; 205.3 ; 39.6 ;5;5;2;5;0;2;3;1;4;2;1;2
12336; 21.9 ; 131.3 ; 8.5 ;6;31;0;0;6;1;5;5;1;4;2;0
12337; 42.4 ; 169.4 ; 26.2 ;4;103;15;0;4;0;4;2;2;1;2;1
12338; 20.3 ; 40.6 ; 7.9 ;2;15;241;0;2;1;1;1;1;2;0;0
12339; 20.4 ; 102.2 ; 5.8 ;5;2;139;5;0;4;1;5;0;5;0;0
12340; 51.8 ; 569.4 ; 19.4 ;11;27;0;0;11;4;7;7;4;0;7;4
12341; 37.1 ; 333.8 ; 13.0 ;9;5;293;0;9;4;5;5;4;3;6;0
12342; 31.0 ; 93.0 ; 10.9 ;3;12;297;0;3;2;1;2;1;1;2;0
12343; 25.1 ; 50.1 ; -   ;2;32;210;0;2;0;2;2;0;2;0;0
12344; 60.0 ; 180.0 ; 21.6 ;3;113;99;0;3;0;3;2;1;0;0;3
12345; 56.3 ; 112.5 ; 28.6 ;2;73;225;0;2;1;1;1;1;1;0;1
12346; 27.6 ; 55.3 ; 3.8 ;2;238;101;0;2;0;2;2;0;1;1;0
12347; 21.7 ; 65.1 ; 6.2 ;3;41;282;0;3;1;2;2;1;3;0;0
12348; 32.5 ; 1,006.8 ; 17.1 ;31;9;62;0;31;14;17;6;25;10;21;0
12349; 28.5 ; 56.9 ; 5.1 ;2;285;25;1;1;1;1;0;2;1;1;0
12350; 33.3 ; 166.6 ; 7.9 ;5;41;52;0;5;3;2;5;0;2;3;0
12351; 81.6 ; 244.8 ; 19.9 ;3;167;14;0;3;1;2;1;2;0;0;3
12352; 75.3 ; 376.7 ; 37.5 ;5;70;95;0;5;0;5;4;1;0;0;5
12353; 47.0 ; 141.0 ; 0.4 ;3;138;47;0;3;2;1;1;2;0;3;0
12354; 54.9 ; 164.6 ; 6.8 ;3;50;15;3;0;0;3;3;0;0;2;1
12355; 34.8 ; 382.5 ; 12.9 ;11;10;17;0;11;5;6;5;6;4;7;0
12356; 41.5 ; 124.5 ; 25.5 ;3;54;0;0;3;1;2;2;1;1;1;1
12357; 57.2 ; 400.3 ; 29.2 ;7;25;75;0;7;5;2;4;3;2;0;5
12358; 17.0 ; 51.1 ; 3.7 ;3;83;127;0;3;2;1;2;1;3;0;0
12359; 23.0 ; 69.0 ; 6.5 ;3;94;158;0;3;2;1;3;0;3;0;0
12360; 18.0 ; 215.5 ; 2.5 ;12;14;231;0;12;6;6;5;7;12;0;0
12361; 37.9 ; 265.2 ; 15.3 ;7;28;121;0;7;1;6;3;4;2;5;0
12362; 48.2 ; 240.9 ; 7.3 ;5;82;10;0;5;1;4;1;4;0;3;2
12363; 47.4 ; 1,089.9 ; 10.3 ;23;13;5;0;23;4;19;19;4;0;15;8
12364; 40.5 ; 81.0 ; 16.8 ;2;156;49;0;2;1;1;1;1;1;0;1
12365; 20.6 ; 41.1 ; 6.2 ;2;1;0;0;2;0;2;1;1;2;0;0
12366; 32.3 ; 129.0 ; 15.8 ;4;90;70;0;4;3;1;2;2;1;3;0
12367; 34.4 ; 171.9 ; 23.0 ;5;60;62;0;5;1;4;3;2;2;1;2
12368; 21.6 ; 86.6 ; 6.7 ;4;37;212;0;4;2;2;2;2;4;0;0
12369; 72.3 ; 144.5 ; 31.8 ;2;41;116;0;2;0;2;2;0;0;0;2
12370; 15.0 ; 89.9 ; -   ;6;17;8;1;5;5;1;6;0;6;0;0
12371; 66.0 ; 330.2 ; 31.0 ;5;33;9;0;5;1;4;3;2;0;0;5
12372; 32.9 ; 65.8 ; 2.6 ;2;24;184;0;2;0;2;2;0;0;2;0
12373; 79.2 ; 237.6 ; 16.5 ;3;27;228;0;3;2;1;3;0;0;0;3
12374; 57.5 ; 805.3 ; 30.9 ;14;28;20;0;14;1;13;8;6;5;0;9
12375; 47.8 ; 143.4 ; 4.8 ;3;14;103;0;3;1;2;2;1;0;3;0
12376; 19.4 ; 77.6 ; 5.5 ;4;58;67;0;4;1;3;2;2;4;0;0
12377; 15.0 ; 45.0 ; -   ;3;50;17;0;3;2;1;2;1;3;0;0
12378; 21.5 ; 85.9 ; 6.1 ;4;77;131;0;4;3;1;4;0;4;0;0
12379; 44.8 ; 89.6 ; 2.9 ;2;119;169;0;2;0;2;1;1;0;2;0
12380; 36.4 ; 290.9 ; 14.4 ;8;24;133;1;7;1;7;6;2;3;5;0
12381; 73.0 ; 146.0 ; 39.3 ;2;18;171;0;2;2;0;2;0;0;0;2
12382; 15.0 ; 30.0 ; -   ;2;47;80;0;2;1;1;0;2;2;0;0
12383; 25.1 ; 150.4 ; -   ;6;42;93;0;6;2;4;4;2;6;0;0
12384; 57.1 ; 114.2 ; 33.9 ;2;1;220;0;2;0;2;1;1;1;0;1
12385; 41.2 ; 82.5 ; 16.9 ;2;3;245;0;2;1;1;2;0;1;0;1
12386; 36.8 ; 147.2 ; 32.6 ;4;27;197;0;4;3;1;2;2;1;2;1
12387; 43.5 ; 217.6 ; 15.3 ;5;88;62;0;5;1;4;5;0;2;1;2
12388; 45.9 ; 183.5 ; 10.1 ;4;38;4;0;4;2;2;1;3;0;3;1
12389; 18.3 ; 55.0 ; 6.2 ;3;20;240;0;3;1;2;1;2;3;0;0
12390; 36.4 ; 109.3 ; 10.8 ;3;14;9;0;3;2;1;1;2;1;2;0
12391; 63.1 ; 126.3 ; 49.7 ;2;157;125;0;2;0;2;1;1;1;0;1
12392; 56.1 ; 560.9 ; 32.4 ;10;30;14;0;10;8;2;6;4;3;0;7
12393; 32.9 ; 131.5 ; 5.7 ;4;6;236;0;4;0;4;2;2;1;3;0
12394; 19.5 ; 39.0 ; 6.7 ;2;81;80;0;2;2;0;0;2;2;0;0
12395; 26.1 ; 261.3 ; 9.7 ;10;31;18;0;10;4;6;7;3;7;3;0
12396; 41.7 ; 83.4 ; 16.2 ;2;117;12;0;2;1;1;1;1;1;0;1
12397; 15.0 ; 59.9 ; -   ;4;29;23;0;4;2;2;4;0;4;0;0
12398; 15.0 ; 30.0 ; -   ;2;100;66;2;0;2;0;1;1;2;0;0
12399; 35.0 ; 105.0 ; 10.6 ;3;20;193;0;3;2;1;1;2;1;2;0
12400; 17.0 ; 85.0 ; 4.8 ;5;67;51;0;5;3;2;3;2;5;0;0
12401; 17.2 ; 86.0 ; 2.6 ;5;49;92;0;5;1;4;2;3;5;0;0
12402; 25.9 ; 284.5 ; 6.9 ;11;21;39;0;11;4;7;5;6;7;4;0
12403; 36.4 ; 145.6 ; 11.0 ;4;77;95;0;4;0;4;2;2;1;3;0
12404; 35.2 ; 176.1 ; 31.3 ;5;23;126;0;5;1;4;1;4;2;1;2
12405; 70.8 ; 283.4 ; 50.5 ;4;57;42;0;4;0;4;3;1;1;0;3
12406; 38.8 ; 271.9 ; 16.2 ;7;24;121;0;7;1;6;4;3;2;3;2
12407; 46.8 ; 93.5 ; -   ;2;19;120;0;2;0;2;1;1;0;2;0
12408; 19.5 ; 78.0 ; 3.5 ;4;5;3;4;0;3;1;2;2;4;0;0
12409; 19.5 ; 58.6 ; 5.4 ;3;45;52;0;3;1;2;1;2;3;0;0
12410; 30.2 ; 241.5 ; -   ;8;23;115;0;8;3;5;4;4;0;8;0
12411; 35.5 ; 1,205.7 ; 13.1 ;34;10;0;0;34;5;29;20;14;11;23;0
12412; 35.5 ; 567.3 ; 23.8 ;16;15;116;0;16;6;10;16;0;5;6;5
12413; 15.0 ; 74.9 ; -   ;5;40;76;0;5;2;3;1;4;5;0;0
12414; 15.0 ; 45.0 ; -   ;3;29;224;0;3;3;0;1;2;3;0;0
12415; 31.5 ; 94.4 ; 17.6 ;3;55;8;0;3;1;2;1;2;1;2;0
12416; 16.8 ; 33.6 ; 2.7 ;2;2;263;0;2;1;1;2;0;2;0;0
12417; 35.4 ; 141.5 ; 14.0 ;4;22;329;0;4;1;3;4;0;1;3;0
12418; 36.0 ; 72.0 ; 16.4 ;2;34;153;0;2;1;1;0;2;1;1;0
12419; 93.5 ; 187.0 ; 70.0 ;2;137;164;0;2;0;2;1;1;1;0;1
12420; 84.3 ; 337.3 ; 16.2 ;4;88;26;0;4;1;3;4;0;0;0;4
12421; 30.0 ; 89.9 ; 15.9 ;3;14;242;0;3;1;2;1;2;2;1;0
12422; 28.9 ; 144.4 ; 6.2 ;5;51;216;0;5;3;2;0;5;3;2;0
12423; 25.9 ; 389.0 ; 14.3 ;15;20;92;1;14;8;7;9;6;10;5;0
12424; 55.8 ; 111.6 ; 7.5 ;2;22;94;0;2;1;1;2;0;0;0;2
12425; 20.7 ; 41.5 ; -   ;2;85;238;0;2;2;0;2;0;2;0;0
12426; 38.8 ; 193.8 ; 10.8 ;5;60;26;0;5;0;5;3;2;2;3;0
12427; 62.2 ; 621.5 ; 16.8 ;10;10;257;0;10;0;10;8;2;0;0;10
12428; 25.9 ; 129.5 ; 9.0 ;5;32;17;0;5;2;3;1;4;3;2;0
12429; 32.1 ; 289.3 ; 11.8 ;9;11;10;0;9;1;8;6;3;3;6;0
12430; 42.8 ; 85.6 ; 35.0 ;2;25;252;0;2;0;2;1;1;1;0;1
12431; 46.8 ; 140.3 ; -   ;3;46;139;3;0;1;2;3;0;0;3;0
12432; 29.8 ; 149.1 ; 13.0 ;5;34;49;0;5;3;2;1;4;3;2;0
12433; 38.8 ; 77.7 ; 12.9 ;2;25;74;0;2;0;2;1;1;1;1;0
12434; 61.8 ; 123.7 ; 8.6 ;2;82;95;2;0;0;2;2;0;0;0;2
12435; 57.3 ; 172.0 ; 20.1 ;3;63;36;0;3;0;3;3;0;0;0;3
12436; 37.7 ; 75.4 ; 5.0 ;2;135;105;2;0;1;1;1;1;0;2;0
12437; 25.7 ; 51.4 ; 6.9 ;2;50;116;0;2;0;2;1;1;1;1;0
12438; 24.4 ; 171.0 ; 11.6 ;7;50;37;0;7;0;7;5;2;5;2;0
12439; 49.6 ; 198.4 ; 9.4 ;4;50;15;3;1;3;1;2;2;0;3;1
12440; 39.4 ; 196.9 ; 21.0 ;5;20;1;0;5;1;4;3;2;2;1;2
12441; 77.8 ; 155.6 ; 14.0 ;2;33;131;2;0;1;1;2;0;0;0;2
12442; 33.2 ; 66.4 ; 8.1 ;2;24;122;0;2;2;0;0;2;1;1;0
12443; 47.8 ; 191.0 ; 1.3 ;4;56;15;0;4;2;2;1;3;0;4;0
12444; 15.0 ; 74.9 ; -   ;5;40;26;0;5;3;2;4;1;5;0;0
12445; 54.5 ; 163.4 ; 6.7 ;3;81;22;0;3;0;3;3;0;0;2;1
12446; 63.0 ; 567.4 ; 23.5 ;9;32;22;0;9;3;6;9;0;0;0;9
12447; 69.6 ; 139.2 ; 12.1 ;2;59;67;2;0;1;1;0;2;0;0;2
12448; 54.2 ; 108.5 ; 11.2 ;2;139;147;0;2;0;2;0;2;0;1;1
12449; 33.2 ; 132.8 ; 14.0 ;4;113;7;0;4;1;3;4;0;1;3;0
12450; 46.9 ; 187.5 ; 18.4 ;4;98;17;0;4;2;2;3;1;1;2;1
12451; 26.9 ; 430.6 ; 6.9 ;16;19;14;0;16;4;12;12;4;11;5;0
12452; 43.7 ; 87.3 ; 7.6 ;2;3;271;0;2;1;1;0;2;0;2;0
12453; 47.8 ; 95.7 ; 0.5 ;2;101;15;2;0;0;2;2;0;0;2;0
12454; 65.4 ; 392.5 ; 24.0 ;6;36;18;0;6;0;6;6;0;0;0;6
12455; 36.9 ; 73.8 ; 10.0 ;2;5;68;0;2;0;2;2;0;1;1;0
12456; 54.0 ; 107.9 ; 13.7 ;2;16;250;0;2;2;0;0;2;0;1;1
12457; 63.2 ; 757.9 ; 18.9 ;12;15;118;0;12;3;9;10;2;0;0;12
12458; 51.5 ; 308.9 ; 16.8 ;6;20;29;1;5;4;2;0;6;0;4;2
12459; 35.6 ; 71.1 ; 8.0 ;2;267;46;0;2;1;1;1;1;1;1;0
12460; 37.8 ; 151.3 ; 7.0 ;4;52;83;0;4;0;4;4;0;0;4;0
12461; 20.2 ; 222.7 ; 9.5 ;11;29;10;0;11;1;10;7;4;11;0;0
12462; 65.4 ; 326.8 ; 30.7 ;5;46;48;0;5;1;4;4;1;0;0;5
12463; 56.6 ; 113.2 ; 60.2 ;2;19;68;0;2;0;2;0;2;1;0;1
12464; 40.8 ; 122.3 ; 3.8 ;3;34;175;0;3;1;2;3;0;0;3;0
12465; 28.4 ; 199.1 ; 18.6 ;7;56;5;0;7;0;7;7;0;5;2;0
12466; 46.6 ; 279.7 ; 23.2 ;6;38;79;0;6;1;5;3;3;2;2;2
12467; 17.0 ; 85.0 ; 4.8 ;5;11;71;0;5;4;1;4;1;5;0;0
12468; 37.5 ; 337.4 ; 12.9 ;9;26;5;0;9;0;9;7;2;3;6;0
12469; 47.9 ; 1,531.4 ; 29.5 ;32;8;0;0;32;15;17;22;10;11;10;11
12470; 47.9 ; 191.8 ; 17.6 ;4;55;173;0;4;1;3;2;2;0;3;1
12471; 38.7 ; 116.2 ; 17.8 ;3;38;1;0;3;0;3;0;3;1;1;1
12472; 39.8 ; 199.2 ; 3.8 ;5;33;40;0;5;3;2;4;1;0;5;0
12473; 53.6 ; 107.2 ; 0.5 ;2;37;5;0;2;0;2;2;0;0;2;0
12474; 49.9 ; 1,048.0 ; 28.0 ;21;7;146;0;21;2;19;17;4;7;7;7
12475; 57.2 ; 171.6 ; 17.8 ;3;34;52;3;0;1;2;3;0;0;0;3
12476; 72.8 ; 145.5 ; 1.4 ;2;68;162;0;2;0;2;2;0;0;0;2
12477; 22.8 ; 91.3 ; 2.8 ;4;47;11;0;4;2;2;2;2;4;0;0
12478; 34.2 ; 137.0 ; 4.5 ;4;31;57;0;4;1;3;1;3;1;3;0
12479; 27.6 ; 55.1 ; 0.8 ;2;14;147;0;2;1;1;2;0;2;0;0
12480; 26.7 ; 133.6 ; 11.7 ;5;23;74;0;5;1;4;4;1;3;2;0
12481; 42.7 ; 384.0 ; 3.8 ;9;25;7;0;9;1;8;5;4;0;9;0
12482; 46.4 ; 649.3 ; 17.9 ;14;21;6;0;14;6;8;11;3;5;4;5
12483; 46.8 ; 140.3 ; -   ;3;14;127;0;3;0;3;3;0;0;3;0
12484; 17.4 ; 208.5 ; 3.3 ;12;39;5;0;12;5;7;9;3;12;0;0
12485; 44.3 ; 1,241.6 ; 43.3 ;28;11;5;0;28;13;15;12;16;9;10;9
12486; 35.5 ; 71.0 ; 15.6 ;2;7;131;0;2;0;2;2;0;1;1;0
12487; 41.2 ; 123.5 ; 10.3 ;3;34;137;0;3;1;2;3;0;0;3;0
12488; 20.0 ; 40.1 ; 7.6 ;2;163;55;0;2;2;0;1;1;2;0;0
12489; 39.1 ; 78.2 ; 16.5 ;2;110;11;0;2;1;1;2;0;1;0;1
12490; 50.7 ; 101.4 ; 20.8 ;2;50;110;0;2;0;2;2;0;1;0;1
12491; 59.4 ; 118.7 ; 3.9 ;2;131;167;0;2;2;0;0;2;0;0;2
12492; 18.0 ; 288.7 ; 3.8 ;16;4;319;0;16;8;8;14;2;16;0;0
12493; 47.7 ; 285.9 ; 13.5 ;6;68;41;1;5;2;4;2;4;0;4;2
12494; 70.5 ; 141.0 ; 34.5 ;2;22;92;0;2;1;1;1;1;0;0;2
12495; 36.8 ; 478.6 ; 9.8 ;13;23;0;0;13;3;10;9;4;4;9;0
12496; 29.0 ; 87.1 ; 4.0 ;3;9;251;0;3;3;0;1;2;2;1;0
12497; 26.2 ; 105.0 ; 11.3 ;4;38;110;0;4;1;3;2;2;3;1;0
12498; 64.2 ; 641.8 ; 29.3 ;10;23;89;0;10;5;5;8;2;0;0;10
12499; 28.1 ; 140.5 ; 16.5 ;5;61;133;0;5;3;2;0;5;3;2;0
12500; 35.6 ; 71.2 ; 16.7 ;2;3;103;0;2;1;1;0;2;1;1;0
12501; 55.4 ; 276.8 ; 30.1 ;5;25;47;0;5;1;4;3;2;2;0;3
12502; 35.9 ; 71.8 ; 16.2 ;2;55;161;0;2;2;0;1;1;1;1;0
12503; 46.5 ; 186.0 ; 5.4 ;4;82;173;0;4;0;4;4;0;0;4;0
12504; 16.2 ; 48.6 ; 2.2 ;3;29;221;0;3;1;2;1;2;3;0;0
12505; 38.4 ; 115.3 ; 22.7 ;3;24;237;0;3;0;3;2;1;1;1;1
12506; 42.1 ; 126.2 ; 5.4 ;3;113;5;0;3;0;3;3;0;0;3;0
12507; 38.4 ; 1,574.9 ; 21.6 ;41;8;0;0;41;11;30;21;20;14;13;14
12508; 29.5 ; 176.7 ; 2.1 ;6;43;62;0;6;0;6;4;2;4;2;0
12509; 20.3 ; 141.8 ; 3.2 ;7;16;179;0;7;0;7;4;3;7;0;0
12510; 27.3 ; 109.0 ; 13.8 ;4;23;293;0;4;2;2;1;3;3;1;0
12511; 37.1 ; 222.6 ; 15.7 ;6;22;116;0;6;3;3;4;2;2;4;0
12512; 56.6 ; 339.8 ; 34.7 ;6;53;5;0;6;0;6;6;0;2;0;4
12513; 50.0 ; 150.1 ; 2.6 ;3;5;258;0;3;1;2;3;0;0;3;0
12514; 63.2 ; 189.7 ; 31.3 ;3;69;152;0;3;1;2;3;0;0;0;3
12515; 28.9 ; 144.3 ; 9.4 ;5;26;33;0;5;3;2;4;1;3;2;0
12516; 30.2 ; 150.9 ; -   ;5;36;147;0;5;0;5;4;1;0;5;0
12517; 24.4 ; 292.5 ; 12.3 ;12;5;52;0;12;6;6;10;2;8;4;0
12518; 53.9 ; 1,455.5 ; 33.1 ;27;9;0;0;27;4;23;15;12;9;9;9
12519; 34.4 ; 206.4 ; 13.0 ;6;37;56;0;6;3;3;3;3;2;4;0
12520; 31.4 ; 188.2 ; 14.8 ;6;24;158;0;6;2;4;4;2;2;4;0
12521; 73.8 ; 147.7 ; 45.2 ;2;269;8;1;1;2;0;1;1;1;0;1
12522; 19.7 ; 39.5 ; -   ;2;5;279;0;2;0;2;1;1;2;0;0
12523; 76.6 ; 382.8 ; 21.1 ;5;47;100;0;5;1;4;4;1;0;0;5
12524; 40.4 ; 121.2 ; 36.4 ;3;90;95;0;3;0;3;3;0;1;1;1
12525; 40.2 ; 120.7 ; 23.7 ;3;16;367;0;3;0;3;3;0;1;1;1
12526; 53.0 ; 212.1 ; 13.3 ;4;16;209;0;4;1;3;2;2;0;3;1
12527; 30.6 ; 91.9 ; 16.8 ;3;25;247;0;3;1;2;2;1;1;2;0
12528; 29.8 ; 89.4 ; 18.7 ;3;156;83;0;3;1;2;3;0;2;1;0
12529; 26.4 ; 263.5 ; 12.7 ;10;15;168;0;10;4;6;4;6;7;3;0
12530; 51.4 ; 102.9 ; 7.0 ;2;14;155;0;2;1;1;2;0;0;1;1
12531; 38.5 ; 76.9 ; 12.4 ;2;209;29;1;1;2;0;1;1;1;1;0
12532; 43.6 ; 130.7 ; 14.6 ;3;68;2;0;3;2;1;1;2;1;1;1
12533; 61.3 ; 183.9 ; 34.8 ;3;43;203;0;3;2;1;1;2;1;0;2
12534; 30.0 ; 59.9 ; -   ;2;5;421;0;2;0;2;2;0;2;0;0
12535; 21.3 ; 255.5 ; 9.9 ;12;26;14;0;12;4;8;11;1;8;4;0
12536; 56.9 ; 512.4 ; 17.1 ;9;24;14;0;9;3;6;5;4;0;0;9
12537; 35.4 ; 176.8 ; 22.7 ;5;23;189;0;5;2;3;2;3;2;1;2
12538; 20.5 ; 225.0 ; 5.8 ;11;18;2;0;11;7;4;7;4;11;0;0
12539; 39.9 ; 79.7 ; 14.5 ;2;73;171;0;2;2;0;1;1;1;1;0
12540; 36.8 ; 220.7 ; 22.6 ;6;33;48;0;6;3;3;3;3;2;2;2
12541; 24.7 ; 148.5 ; 12.5 ;6;27;84;0;6;3;3;3;3;4;2;0
12542; 46.0 ; 91.9 ; -   ;2;35;63;0;2;1;1;2;0;0;2;0
12543; 45.3 ; 135.8 ; 37.5 ;3;36;212;0;3;1;2;0;3;1;1;1
12544; 30.2 ; 271.5 ; 7.7 ;9;20;31;0;9;0;9;9;0;3;6;0
12545; 31.2 ; 93.7 ; 3.1 ;3;13;242;0;3;1;2;1;2;1;2;0
12546; 61.4 ; 122.9 ; 7.6 ;2;164;78;0;2;0;2;2;0;0;0;2
12547; 38.3 ; 76.7 ; 2.6 ;2;44;314;0;2;0;2;2;0;0;2;0
12548; 42.5 ; 127.5 ; 11.3 ;3;11;174;0;3;0;3;1;2;0;3;0
12549; 22.2 ; 311.1 ; 10.1 ;14;15;22;0;14;2;12;8;6;9;5;0
12550; 25.1 ; 50.1 ; -   ;2;33;43;0;2;1;1;0;2;2;0;0
12551; 25.0 ; 150.0 ; 7.0 ;6;6;233;0;6;5;1;1;5;4;2;0
12552; 28.0 ; 112.1 ; 6.7 ;4;1;227;0;4;1;3;4;0;3;1;0
12553; 36.7 ; 366.9 ; 22.1 ;10;30;20;0;10;3;7;2;8;3;4;3
12554; 40.6 ; 405.6 ; 12.7 ;10;30;52;0;10;2;8;9;1;3;7;0
12555; 38.5 ; 924.9 ; 15.9 ;24;12;5;0;24;0;24;23;1;8;16;0
12556; 17.1 ; 102.8 ; 6.0 ;6;15;325;0;6;1;5;4;2;6;0;0
12557; 18.8 ; 75.1 ; 5.1 ;4;10;406;0;4;3;1;1;3;4;0;0
12558; 48.2 ; 96.3 ; 2.1 ;2;4;260;0;2;1;1;0;2;0;2;0
12559; 15.9 ; 63.5 ; 1.9 ;4;31;265;0;4;2;2;1;3;4;0;0
12560; 20.0 ; 99.9 ; 8.2 ;5;26;71;0;5;3;2;2;3;5;0;0
12561; 28.9 ; 404.2 ; 14.1 ;14;19;29;0;14;5;9;4;10;9;5;0
12562; 80.8 ; 161.5 ; 48.0 ;2;132;83;2;0;0;2;2;0;0;0;2
12563; 47.1 ; 94.2 ; 0.5 ;2;240;93;0;2;1;1;1;1;0;2;0
12564; 25.6 ; 127.8 ; 1.3 ;5;54;173;0;5;0;5;1;4;5;0;0
12565; 57.0 ; 228.0 ; 5.7 ;4;71;6;4;0;2;2;4;0;0;0;4
12566; 43.7 ; 87.4 ; 29.1 ;2;410;25;1;1;1;1;2;0;1;0;1
12567; 47.1 ; 94.2 ; 0.5 ;2;37;80;0;2;2;0;1;1;0;2;0
12568; 44.7 ; 223.6 ; 8.2 ;5;6;0;5;0;1;4;5;0;0;5;0
12569; 49.8 ; 99.6 ; 4.6 ;2;16;266;0;2;2;0;1;1;0;2;0
12570; 42.6 ; 85.2 ; 9.0 ;2;180;125;0;2;1;1;0;2;0;2;0
12571; 17.1 ; 205.1 ; 1.7 ;12;8;178;0;12;2;10;8;4;12;0;0
12572; 32.6 ; 97.9 ; 17.1 ;3;4;248;0;3;1;2;1;2;1;2;0
12573; 142.9 ; 428.8 ; 61.1 ;3;223;11;0;3;0;3;2;1;0;0;3
12574; 35.9 ; 71.8 ; 16.2 ;2;5;227;0;2;0;2;1;1;1;1;0
12575; 57.9 ; 115.8 ; 8.0 ;2;7;236;0;2;0;2;1;1;0;0;2
12576; 30.8 ; 92.4 ; 11.7 ;3;46;170;0;3;1;2;2;1;1;2;0
12577; 35.9 ; 71.8 ; 16.2 ;2;61;332;0;2;0;2;1;1;1;1;0
12578; 48.5 ; 97.0 ; 1.6 ;2;25;99;1;1;0;2;2;0;0;2;0
12579; 18.0 ; 180.3 ; 7.0 ;10;20;195;0;10;4;6;5;5;10;0;0
12580; 59.0 ; 236.0 ; 13.4 ;4;46;113;0;4;2;2;2;2;0;0;4
12581; 63.5 ; 254.1 ; 15.1 ;4;42;146;0;4;0;4;4;0;0;0;4
12582; 54.5 ; 544.6 ; 10.8 ;10;32;78;0;10;2;8;3;7;0;7;3
12583; 29.7 ; 148.3 ; 2.4 ;5;30;20;5;0;4;1;3;2;3;2;0
12584; 18.8 ; 169.1 ; 5.0 ;9;10;71;0;9;4;5;8;1;9;0;0
12585; 33.0 ; 99.0 ; 2.6 ;3;3;271;0;3;2;1;1;2;0;3;0
12586; 59.8 ; 358.6 ; 23.5 ;6;50;29;0;6;4;2;3;3;0;0;6
12587; 23.7 ; 118.7 ; 15.5 ;5;61;5;0;5;1;4;3;2;3;2;0
12588; 23.3 ; 630.2 ; 12.9 ;27;13;1;0;27;16;11;21;6;18;9;0
12589; 56.6 ; 169.9 ; 9.2 ;3;5;271;0;3;2;1;3;0;0;0;3
12590; 75.9 ; 151.8 ; 41.2 ;2;12;206;0;2;1;1;0;2;0;0;2
12591; 57.3 ; 114.5 ; 15.8 ;2;217;131;0;2;1;1;0;2;0;0;2
12592; 51.9 ; 207.7 ; 9.9 ;4;8;78;0;4;1;3;1;3;0;3;1
12593; 68.4 ; 1,026.2 ; 23.6 ;15;14;79;0;15;11;4;3;12;0;0;15
12594; 54.1 ; 108.3 ; 11.1 ;2;117;265;0;2;1;1;0;2;0;1;1
12595; 54.1 ; 162.4 ; 6.9 ;3;119;11;0;3;0;3;1;2;0;2;1
12596; 22.6 ; 45.2 ; 11.4 ;2;220;86;0;2;2;0;2;0;1;1;0
12597; 32.1 ; 64.3 ; 11.2 ;2;22;252;0;2;1;1;1;1;1;1;0
12598; 21.8 ; 699.0 ; 10.5 ;32;14;0;0;32;10;22;24;8;21;11;0
12599; 47.3 ; 283.5 ; 1.1 ;6;32;47;0;6;1;5;5;1;0;6;0
12600; 58.4 ; 1,167.2 ; 18.4 ;20;19;58;0;20;5;15;17;3;0;0;20
12601; 101.3 ; 506.4 ; 13.1 ;5;39;116;0;5;0;5;5;0;0;0;5
12602; 35.6 ; 249.5 ; 12.2 ;7;39;4;0;7;7;0;5;2;2;5;0
12603; 23.3 ; 70.0 ; 8.1 ;3;20;116;0;3;1;2;0;3;2;1;0
12604; 19.3 ; 443.2 ; 4.9 ;23;8;31;0;23;13;10;14;9;23;0;0
12605; 22.6 ; 90.3 ; 9.3 ;4;86;54;0;4;3;1;4;0;3;1;0
12606; 30.2 ; 60.4 ; -   ;2;32;145;0;2;2;0;0;2;0;2;0
12607; 20.4 ; 101.9 ; 5.0 ;5;27;111;0;5;1;4;5;0;5;0;0
12608; 15.0 ; 30.0 ; -   ;2;5;111;0;2;0;2;2;0;2;0;0
12609; 19.3 ; 77.2 ; 4.4 ;4;14;230;0;4;0;4;4;0;4;0;0
12610; 45.7 ; 137.2 ; 14.9 ;3;17;197;0;3;2;1;3;0;0;2;1
12611; 43.9 ; 219.5 ; 18.5 ;5;60;17;0;5;3;2;2;3;2;1;2
12612; 17.3 ; 34.7 ; 3.5 ;2;40;236;0;2;0;2;0;2;2;0;0
12613; 46.8 ; 93.5 ; -   ;2;8;190;0;2;1;1;1;1;0;2;0
12614; 35.4 ; 283.4 ; 13.9 ;8;10;9;0;8;5;3;1;7;3;5;0
12615; 18.0 ; 54.1 ; 3.2 ;3;38;21;3;0;0;3;1;2;3;0;0
12616; 15.0 ; 45.0 ; -   ;3;11;13;0;3;2;1;3;0;3;0;0
12617; 25.2 ; 50.4 ; 15.3 ;2;45;146;0;2;1;1;0;2;1;1;0
12618; 41.7 ; 83.4 ; 7.6 ;2;29;181;0;2;1;1;2;0;0;2;0
12619; 45.0 ; 135.1 ; 18.5 ;3;124;57;0;3;1;2;2;1;1;1;1
12620; 18.2 ; 873.5 ; 3.8 ;48;7;1;0;48;20;28;14;34;48;0;0
12621; 18.3 ; 182.7 ; 1.9 ;10;32;68;0;10;6;4;6;4;10;0;0
12622; 22.8 ; 1,502.9 ; 11.5 ;66;4;5;0;66;30;36;22;44;44;22;0
12623; 77.6 ; 155.2 ; 93.8 ;2;14;227;0;2;1;1;2;0;1;0;1
12624; 29.0 ; 58.0 ; 1.8 ;2;5;85;2;0;0;2;2;0;1;1;0
12625; 27.7 ; 83.0 ; 0.1 ;3;18;147;0;3;0;3;3;0;3;0;0
12626; 40.8 ; 285.7 ; 34.1 ;7;41;40;0;7;3;4;2;5;2;3;2
12627; 68.7 ; 137.4 ; 9.3 ;2;57;233;0;2;2;0;0;2;0;0;2
12628; 39.8 ; 79.5 ; 14.3 ;2;100;64;0;2;0;2;0;2;1;1;0
12629; 33.4 ; 934.2 ; 16.0 ;28;5;21;0;28;12;16;14;14;9;19;0
12630; 15.0 ; 30.0 ; -   ;2;131;161;0;2;2;0;0;2;2;0;0
12631; 48.5 ; 436.3 ; 8.1 ;9;31;10;0;9;0;9;6;3;0;6;3
12632; 26.5 ; 212.3 ; 2.4 ;8;20;9;1;7;1;7;5;3;8;0;0
12633; 43.1 ; 129.3 ; 17.5 ;3;22;99;0;3;0;3;3;0;1;1;1
12634; 27.0 ; 54.0 ; 13.5 ;2;99;100;0;2;0;2;1;1;1;1;0
12635; 19.0 ; 57.1 ; 4.0 ;3;93;61;0;3;1;2;2;1;3;0;0
12636; 19.6 ; 273.7 ; 7.3 ;14;22;39;0;14;7;7;14;0;14;0;0
12637; 30.4 ; 60.8 ; 8.0 ;2;68;352;0;2;0;2;1;1;1;1;0
12638; 34.5 ; 69.0 ; 22.2 ;2;61;79;1;1;0;2;2;0;1;0;1
12639; 38.5 ; 76.9 ; 12.4 ;2;25;100;0;2;0;2;1;1;1;1;0
12640; 54.3 ; 379.9 ; 29.1 ;7;39;80;0;7;4;3;4;3;2;3;2
12641; 56.2 ; 112.4 ; 11.2 ;2;15;15;0;2;1;1;2;0;0;0;2
12642; 20.8 ; 104.0 ; 8.0 ;5;4;107;0;5;3;2;3;2;5;0;0
12643; 45.6 ; 182.5 ; 19.7 ;4;109;1;0;4;0;4;2;2;1;2;1
12644; 58.3 ; 641.7 ; 19.2 ;11;24;15;0;11;2;9;10;1;0;0;11
12645; 29.8 ; 149.0 ; 16.0 ;5;45;93;0;5;2;3;2;3;3;2;0
12646; 40.5 ; 80.9 ; 1.7 ;2;234;80;0;2;1;1;2;0;0;2;0
12647; 37.9 ; 379.2 ; 17.7 ;10;42;5;0;10;2;8;3;7;3;4;3
12648; 30.2 ; 60.4 ; -   ;2;6;141;0;2;0;2;0;2;0;2;0
12649; 45.4 ; 363.1 ; 19.1 ;8;32;2;1;7;4;4;6;2;3;2;3
12650; 52.6 ; 210.3 ; 31.6 ;4;83;68;0;4;2;2;1;3;1;2;1
12651; 31.1 ; 808.0 ; 12.1 ;26;14;23;0;26;16;10;16;10;9;17;0
12652; 26.9 ; 107.6 ; 16.4 ;4;4;56;4;0;2;2;1;3;3;1;0
12653; 30.1 ; 90.4 ; 15.6 ;3;61;114;0;3;1;2;1;2;1;2;0
12654; 56.1 ; 336.4 ; 25.5 ;6;62;26;0;6;2;4;6;0;0;0;6
12655; 45.6 ; 91.3 ; 13.5 ;2;308;99;0;2;0;2;2;0;0;1;1
12656; 18.9 ; 37.9 ; 0.5 ;2;32;110;0;2;0;2;2;0;2;0;0
12657; 31.4 ; 596.7 ; 11.5 ;19;16;0;0;19;2;17;14;5;6;13;0
12658; 68.7 ; 343.4 ; 26.3 ;5;43;33;0;5;2;3;5;0;0;0;5
12659; 43.0 ; 172.2 ; 9.2 ;4;4;137;0;4;1;3;1;3;0;4;0
12660; 72.1 ; 649.0 ; 32.3 ;9;35;0;0;9;4;5;6;3;0;0;9
12661; 37.8 ; 75.6 ; 14.5 ;2;47;68;0;2;1;1;2;0;1;1;0
12662; 18.0 ; 90.1 ; -   ;5;9;141;0;5;0;5;5;0;5;0;0
12663; 61.4 ; 122.9 ; 4.9 ;2;47;1;2;0;1;1;2;0;0;0;2
12664; 46.8 ; 93.5 ; -   ;2;43;230;0;2;0;2;1;1;0;2;0
12665; 18.2 ; 145.5 ; 5.9 ;8;40;8;0;8;2;6;8;0;8;0;0
12666; 34.9 ; 69.9 ; 7.1 ;2;16;154;0;2;1;1;2;0;1;1;0
12667; 51.2 ; 409.2 ; 38.2 ;8;12;14;0;8;4;4;3;5;3;2;3
12668; 19.7 ; 39.5 ; -   ;2;215;130;0;2;1;1;0;2;2;0;0
12669; 31.5 ; 126.1 ; 11.5 ;4;32;53;0;4;0;4;3;1;1;3;0
12670; 60.0 ; 1,080.0 ; 18.0 ;18;15;3;0;18;6;12;11;7;0;0;18
12671; 85.8 ; 171.6 ; 48.9 ;2;101;15;0;2;0;2;2;0;0;0;2
12672; 30.9 ; 61.7 ; 23.8 ;2;1;281;0;2;2;0;1;1;1;1;0
12673; 37.9 ; 265.2 ; 17.4 ;7;41;69;1;6;3;4;2;5;2;3;2
12674; 21.5 ; 193.4 ; 12.7 ;9;4;232;0;9;2;7;2;7;6;3;0
12675; 90.1 ; 180.2 ; 17.8 ;2;329;20;0;2;0;2;2;0;0;0;2
12676; 19.5 ; 78.1 ; 4.4 ;4;19;228;0;4;2;2;1;3;4;0;0
12677; 39.8 ; 1,394.1 ; 18.3 ;35;9;0;0;35;11;24;19;16;12;11;12
12678; 56.7 ; 113.4 ; 13.8 ;2;228;47;0;2;0;2;2;0;0;0;2
12679; 66.9 ; 133.8 ; 45.4 ;2;117;154;0;2;1;1;1;1;1;0;1
12680; 19.7 ; 39.3 ; 1.6 ;2;28;230;0;2;1;1;2;0;2;0;0
12681; 31.2 ; 62.5 ; 24.3 ;2;14;98;0;2;1;1;2;0;1;0;1
12682; 48.4 ; 677.7 ; 14.3 ;14;28;0;0;14;6;8;3;11;0;9;5
12683; 45.5 ; 227.6 ; 16.2 ;5;51;47;0;5;1;4;3;2;2;1;2
12684; 24.4 ; 146.2 ; 4.8 ;6;48;33;2;4;6;0;6;0;6;0;0
12685; 61.2 ; 244.9 ; 21.6 ;4;61;43;4;0;2;2;4;0;0;0;4
12686; 25.8 ; 51.6 ; 16.2 ;2;17;146;0;2;1;1;1;1;1;1;0
12687; 58.6 ; 351.8 ; 43.7 ;6;16;20;0;6;1;5;5;1;2;0;4
12688; 33.0 ; 165.2 ; 15.8 ;5;61;160;0;5;2;3;0;5;2;3;0
12689; 53.8 ; 107.7 ; 7.7 ;2;7;40;0;2;1;1;2;0;0;1;1
12690; 38.1 ; 228.9 ; 11.4 ;6;33;5;0;6;1;5;3;3;2;4;0
12691; 29.5 ; 88.4 ; 4.9 ;3;5;296;0;3;2;1;1;2;2;1;0
12692; 34.7 ; 139.0 ; 27.4 ;4;13;110;0;4;0;4;2;2;1;2;1
12693; 20.0 ; 40.1 ; 7.6 ;2;19;83;2;0;0;2;1;1;2;0;0
12694; 63.4 ; 126.8 ; 50.7 ;2;14;258;0;2;1;1;2;0;1;0;1
12695; 23.7 ; 331.3 ; 13.9 ;14;16;80;0;14;10;4;5;9;9;5;0
12696; 22.2 ; 110.9 ; 7.1 ;5;51;65;0;5;3;2;3;2;5;0;0
12697; 38.9 ; 116.6 ; 13.0 ;3;53;142;0;3;0;3;1;2;1;2;0
12698; 24.5 ; 97.9 ; 6.0 ;4;34;65;0;4;1;3;2;2;3;1;0
12699; 23.9 ; 358.4 ; 12.4 ;15;10;5;0;15;7;8;9;6;10;5;0
12700; 35.9 ; 71.8 ; 16.2 ;2;43;232;0;2;0;2;0;2;1;1;0
12701; 34.4 ; 68.9 ; -   ;2;188;111;0;2;0;2;2;0;0;2;0
12702; 56.6 ; 791.9 ; 14.4 ;14;15;21;0;14;8;6;12;2;0;0;14
12703; 59.2 ; 296.0 ; 22.5 ;5;55;119;0;5;1;4;4;1;0;0;5
12704; 34.6 ; 69.2 ; 21.1 ;2;8;252;0;2;1;1;1;1;1;0;1
12705; 30.3 ; 121.3 ; 4.8 ;4;41;100;0;4;0;4;3;1;1;3;0
12706; 18.7 ; 131.1 ; 7.3 ;7;22;156;0;7;4;3;3;4;7;0;0
12707; 27.8 ; 111.1 ; 21.4 ;4;81;1;0;4;2;2;3;1;3;1;0
12708; 30.1 ; 150.4 ; 8.0 ;5;54;89;0;5;1;4;3;2;2;3;0
12709; 47.8 ; 95.7 ; 0.5 ;2;58;20;0;2;0;2;0;2;0;2;0
12710; 38.6 ; 193.0 ; 10.3 ;5;52;106;0;5;2;3;1;4;2;3;0
12711; 36.6 ; 73.2 ; -   ;2;14;110;0;2;0;2;2;0;0;2;0
12712; 51.8 ; 155.4 ; 37.2 ;3;40;70;0;3;2;1;2;1;1;1;1
12713; 33.7 ; 67.4 ; 28.0 ;2;50;30;0;2;1;1;2;0;1;0;1
12714; 40.4 ; 80.8 ; 32.6 ;2;203;99;0;2;0;2;0;2;1;0;1
12715; 41.1 ; 411.0 ; 8.6 ;10;26;75;0;10;7;3;10;0;0;10;0
12716; 51.5 ; 463.2 ; 4.2 ;9;49;11;0;9;0;9;3;6;0;6;3
12717; 44.7 ; 268.1 ; 18.5 ;6;15;35;2;4;3;3;4;2;2;2;2
12718; 30.6 ; 275.7 ; 24.8 ;9;27;6;0;9;4;5;5;4;3;3;3
12719; 56.0 ; 223.8 ; 20.1 ;4;100;120;0;4;1;3;3;1;0;0;4
12720; 36.1 ; 433.2 ; 18.0 ;12;28;27;0;12;7;5;8;4;4;8;0
12721; 52.7 ; 105.5 ; 6.0 ;2;56;231;0;2;0;2;2;0;0;1;1
12722; 27.9 ; 55.8 ; -   ;2;25;196;0;2;2;0;1;1;2;0;0
12723; 78.8 ; 315.3 ; 78.5 ;4;43;154;0;4;1;3;1;3;1;0;3
12724; 15.0 ; 30.0 ; -   ;2;18;212;0;2;1;1;1;1;2;0;0
12725; 18.3 ; 55.0 ; 6.2 ;3;68;158;0;3;1;2;2;1;3;0;0
12726; 30.2 ; 90.6 ; -   ;3;23;216;0;3;1;2;2;1;0;3;0
12727; 78.0 ; 390.2 ; 44.2 ;5;5;142;0;5;2;3;0;5;0;0;5
12728; 23.1 ; 69.4 ; 6.2 ;3;9;10;3;0;2;1;1;2;3;0;0
12729; 49.5 ; 395.9 ; 24.2 ;8;37;24;0;8;2;6;5;3;3;2;3
12730; 43.1 ; 86.2 ; 27.0 ;2;18;179;0;2;0;2;2;0;1;0;1
12731; 24.5 ; 613.5 ; 14.3 ;25;14;2;0;25;10;15;7;18;17;8;0
12732; 35.3 ; 176.3 ; 16.7 ;5;19;161;1;4;4;1;3;2;2;3;0
12733; 36.0 ; 72.0 ; 24.4 ;2;140;228;0;2;1;1;2;0;1;0;1
12734; 50.9 ; 101.8 ; 6.2 ;2;131;36;0;2;1;1;2;0;0;1;1
12735; 105.6 ; 527.9 ; 59.9 ;5;8;181;5;0;4;1;4;1;0;0;5
12736; 39.8 ; 119.3 ; 13.5 ;3;144;31;0;3;0;3;1;2;1;2;0
12737; 99.0 ; 990.0 ; 36.2 ;10;22;5;0;10;0;10;10;0;0;0;10
12738; 63.6 ; 318.2 ; 21.0 ;5;45;146;0;5;2;3;3;2;0;0;5
12739; 15.0 ; 45.0 ; -   ;3;12;265;0;3;2;1;1;2;3;0;0
12740; 33.9 ; 101.8 ; 34.7 ;3;59;257;0;3;0;3;1;2;1;1;1
12741; 25.8 ; 77.4 ; 19.9 ;3;86;20;0;3;2;1;1;2;2;1;0
12742; 53.7 ; 644.5 ; 24.5 ;12;27;5;0;12;2;10;7;5;4;4;4
12743; 24.3 ; 145.9 ; 8.4 ;6;12;42;0;6;1;5;2;4;4;2;0
12744; 27.6 ; 55.3 ; 3.8 ;2;60;147;2;0;1;1;1;1;1;1;0
12745; 70.9 ; 354.3 ; 35.1 ;5;13;162;5;0;3;2;3;2;0;0;5
12746; 28.4 ; 85.1 ; 13.7 ;3;31;326;0;3;0;3;2;1;2;1;0
12747; 54.1 ; 162.3 ; 14.2 ;3;25;90;0;3;1;2;3;0;0;2;1
12748; 31.8 ; 63.7 ; 2.8 ;2;11;14;0;2;2;0;2;0;1;1;0
12749; 40.9 ; 81.8 ; -   ;2;44;231;0;2;0;2;2;0;0;2;0
12750; 52.3 ; 313.7 ; 1.7 ;6;47;39;0;6;1;5;1;5;0;6;0
12751; 19.9 ; 99.4 ; 6.7 ;5;23;272;0;5;4;1;2;3;5;0;0
12752; 26.4 ; 79.2 ; 17.2 ;3;50;127;0;3;0;3;2;1;2;1;0
12753; 36.1 ; 72.1 ; 16.0 ;2;307;22;0;2;0;2;0;2;1;1;0
12754; 29.3 ; 117.3 ; 10.6 ;4;77;37;0;4;1;3;1;3;3;1;0
12755; 33.6 ; 638.2 ; 18.2 ;19;13;27;0;19;0;19;13;6;6;13;0
12756; 41.5 ; 207.4 ; 7.2 ;5;55;27;0;5;3;2;4;1;0;5;0
12757; 30.9 ; 123.5 ; 10.1 ;4;32;185;3;1;3;1;2;2;1;3;0
12758; 48.0 ; 2,160.0 ; 21.3 ;45;6;131;0;45;17;28;9;36;15;15;15
12759; 35.2 ; 175.9 ; 19.4 ;5;64;152;0;5;2;3;2;3;2;3;0
12760; 27.4 ; 137.1 ; 14.0 ;5;17;288;0;5;3;2;3;2;3;2;0
12761; 72.5 ; 507.2 ; 24.7 ;7;5;5;0;7;1;6;7;0;0;0;7
12762; 26.4 ; 448.4 ; 16.6 ;17;21;16;0;17;3;14;4;13;11;6;0
12763; 67.5 ; 337.7 ; 48.4 ;5;23;2;0;5;4;1;5;0;2;0;3
12764; 31.6 ; 63.2 ; 24.9 ;2;30;22;0;2;0;2;2;0;1;0;1
12765; 20.7 ; 41.5 ; 3.2 ;2;31;65;2;0;1;1;2;0;2;0;0
12766; 30.3 ; 303.2 ; 11.5 ;10;22;59;0;10;4;6;8;2;3;7;0
12767; 36.0 ; 108.0 ; 2.9 ;3;25;311;0;3;0;3;1;2;0;3;0
12768; 23.1 ; 69.4 ; 14.9 ;3;20;59;0;3;2;1;1;2;2;1;0
12769; 37.5 ; 150.0 ; 20.1 ;4;31;106;0;4;2;2;0;4;1;2;1
12770; 29.7 ; 207.8 ; 17.4 ;7;47;89;0;7;0;7;2;5;5;2;0
12771; 15.0 ; 30.0 ; -   ;2;37;102;0;2;2;0;2;0;2;0;0
12772; 45.9 ; 91.8 ; 3.4 ;2;57;15;0;2;0;2;2;0;0;2;0
12773; 25.4 ; 50.9 ; 0.5 ;2;23;143;0;2;1;1;1;1;2;0;0
12774; 36.6 ; 182.9 ; 20.6 ;5;40;252;0;5;3;2;5;0;2;1;2
12775; 25.1 ; 50.1 ; -   ;2;5;106;0;2;0;2;0;2;2;0;0
12776; 54.5 ; 272.7 ; 30.7 ;5;64;54;0;5;3;2;5;0;2;1;2
12777; 50.6 ; 101.2 ; 1.5 ;2;56;224;0;2;2;0;2;0;0;2;0
12778; 31.5 ; 913.3 ; 29.1 ;29;12;0;0;29;8;21;15;14;10;9;10
12779; 44.2 ; 132.5 ; 2.4 ;3;5;137;0;3;2;1;1;2;0;3;0
12780; 57.3 ; 401.3 ; 45.9 ;7;18;110;0;7;5;2;0;7;2;0;5
12781; 71.9 ; 431.6 ; 68.6 ;6;53;110;0;6;2;4;3;3;2;0;4
12782; 21.5 ; 107.4 ; 15.4 ;5;40;53;0;5;0;5;4;1;3;2;0
12783; 46.8 ; 140.3 ; -   ;3;27;233;0;3;2;1;1;2;0;3;0
12784; 30.1 ; 90.4 ; 8.8 ;3;3;179;0;3;1;2;3;0;1;2;0
12785; 17.0 ; 323.0 ; 5.5 ;19;16;26;0;19;1;18;15;4;19;0;0
12786; 26.9 ; 349.1 ; 20.0 ;13;14;160;0;13;5;8;4;9;9;4;0
12787; 61.5 ; 123.0 ; -   ;2;40;108;0;2;1;1;2;0;0;0;2
12788; 53.6 ; 107.2 ; 18.7 ;2;95;116;0;2;0;2;2;0;0;1;1
12789; 48.9 ; 440.4 ; 2.5 ;9;27;58;0;9;3;6;5;4;0;9;0
12790; 46.0 ; 598.6 ; 26.6 ;13;21;5;0;13;4;9;7;6;4;5;4
12791; 40.6 ; 893.5 ; 23.1 ;22;10;132;0;22;11;11;6;16;7;8;7
12792; 15.0 ; 45.0 ; -   ;3;56;47;0;3;0;3;0;3;3;0;0
12793; 43.3 ; 173.3 ; 27.2 ;4;60;107;0;4;2;2;1;3;1;2;1
12794; 25.2 ; 227.1 ; 3.1 ;9;31;32;0;9;4;5;6;3;9;0;0
12795; 17.5 ; 333.0 ; 8.7 ;19;8;17;0;19;11;8;8;11;19;0;0
12796; 64.7 ; 1,165.2 ; 26.7 ;18;6;3;0;18;7;11;4;14;0;0;18
12797; 46.8 ; 93.5 ; -   ;2;80;202;0;2;2;0;0;2;0;2;0
12798; 50.0 ; 100.0 ; 4.9 ;2;225;85;0;2;0;2;2;0;0;2;0
12799; 27.6 ; 55.2 ; 13.5 ;2;232;51;1;1;2;0;2;0;1;1;0
12800; 27.7 ; 138.5 ; 12.6 ;5;45;14;0;5;5;0;1;4;3;2;0
12801; 44.8 ; 89.6 ; 2.9 ;2;14;266;0;2;1;1;0;2;0;2;0
12802; 51.0 ; 306.2 ; 24.5 ;6;3;232;0;6;3;3;5;1;2;2;2
12803; 21.8 ; 43.7 ; 4.9 ;2;259;167;1;1;0;2;2;0;2;0;0
12804; 26.4 ; 79.2 ; 17.2 ;3;109;166;0;3;2;1;1;2;2;1;0
12805; 33.8 ; 67.5 ; 19.5 ;2;69;83;0;2;0;2;2;0;1;1;0
12806; 90.3 ; 361.0 ; 55.6 ;4;41;167;0;4;0;4;4;0;0;0;4
12807; 48.6 ; 291.4 ; 1.8 ;6;41;34;0;6;3;3;2;4;0;6;0
12808; 60.0 ; 119.9 ; 19.8 ;2;198;99;0;2;1;1;1;1;0;0;2
12809; 37.3 ; 261.1 ; 19.6 ;7;46;16;0;7;1;6;4;3;2;3;2
12810; 60.4 ; 120.7 ; 10.7 ;2;60;92;0;2;1;1;1;1;0;0;2
12811; 38.1 ; 952.6 ; 12.4 ;25;14;38;0;25;10;15;11;14;8;17;0
12812; 57.6 ; 288.0 ; 11.9 ;5;20;89;0;5;1;4;2;3;0;0;5
12813; 21.6 ; 324.0 ; 9.9 ;15;29;21;0;15;7;8;12;3;10;5;0
12814; 39.1 ; 547.4 ; 12.6 ;14;27;17;0;14;7;7;12;2;5;9;0
12815; 42.7 ; 298.7 ; 18.3 ;7;40;110;0;7;4;3;5;2;2;3;2
12816; 54.5 ; 109.0 ; 10.5 ;2;326;70;1;1;1;1;0;2;0;1;1
12817; 52.1 ; 104.2 ; 0.6 ;2;150;89;0;2;0;2;1;1;0;2;0
12818; 40.0 ; 120.1 ; 25.1 ;3;67;75;3;0;2;1;2;1;1;1;1
12819; 50.1 ; 100.3 ; 2.2 ;2;43;26;0;2;0;2;1;1;0;2;0
12820; 33.4 ; 266.9 ; 8.8 ;8;14;81;2;6;7;1;3;5;3;5;0
12821; 85.5 ; 171.1 ; 20.5 ;2;20;257;0;2;0;2;0;2;0;0;2
12822; 47.3 ; 94.6 ; 0.3 ;2;217;47;0;2;1;1;0;2;0;2;0
12823; 20.5 ; 1,150.5 ; 11.8 ;56;5;1;0;56;25;31;27;29;37;19;0
12824; 22.6 ; 45.2 ; 11.4 ;2;67;58;0;2;1;1;1;1;1;1;0
12825; 25.1 ; 50.1 ; -   ;2;16;119;0;2;2;0;0;2;2;0;0
12826; 23.7 ; 71.2 ; 7.5 ;3;72;152;0;3;0;3;1;2;2;1;0
12827; 35.9 ; 71.8 ; 16.2 ;2;6;252;0;2;0;2;0;2;1;1;0
12828; 67.1 ; 201.4 ; 27.2 ;3;9;11;0;3;1;2;1;2;0;0;3
12829; 46.2 ; 370.0 ; 15.3 ;8;30;58;0;8;5;3;3;5;0;5;3
12830; 36.3 ; 290.4 ; 12.8 ;8;43;9;0;8;1;7;5;3;3;5;0
12831; 20.7 ; 249.0 ; 9.0 ;12;15;64;0;12;2;10;8;4;12;0;0
12832; 32.6 ; 97.8 ; 26.7 ;3;104;26;0;3;0;3;3;0;1;1;1
12833; 40.4 ; 202.1 ; 14.4 ;5;57;191;0;5;3;2;3;2;2;3;0
12834; 43.5 ; 174.2 ; 8.7 ;4;29;279;0;4;1;3;3;1;0;4;0
12835; 55.2 ; 772.9 ; 29.8 ;14;18;15;0;14;0;14;2;12;5;0;9
12836; 110.8 ; 332.4 ; 53.8 ;3;4;164;0;3;3;0;1;2;0;0;3
12837; 38.6 ; 115.7 ; 11.6 ;3;15;341;0;3;0;3;1;2;1;2;0
12838; 52.2 ; 626.7 ; 22.9 ;12;28;142;0;12;4;8;8;4;4;4;4
12839; 29.3 ; 1,141.0 ; 16.6 ;39;7;18;0;39;3;36;8;31;26;13;0
12840; 47.6 ; 237.8 ; 10.2 ;5;61;2;0;5;1;4;2;3;0;3;2
12841; 52.5 ; 105.0 ; -   ;2;141;248;0;2;2;0;0;2;0;2;0
12842; 33.9 ; 135.5 ; 13.9 ;4;74;120;0;4;0;4;3;1;1;3;0
12843; 60.3 ; 422.1 ; 20.8 ;7;29;47;0;7;3;4;6;1;0;0;7
12844; 59.0 ; 235.9 ; 24.4 ;4;56;5;1;3;1;3;3;1;0;0;4
12845; 36.6 ; 73.2 ; -   ;2;277;47;1;1;0;2;1;1;0;2;0
12846; 17.0 ; 187.1 ; 4.6 ;11;20;194;0;11;1;10;6;5;11;0;0
12847; 39.9 ; 79.9 ; 13.1 ;2;277;110;0;2;0;2;0;2;1;1;0
12848; 76.1 ; 1,141.9 ; 57.7 ;15;23;5;0;15;2;13;9;6;5;0;10
12849; 15.0 ; 45.0 ; -   ;3;22;231;0;3;0;3;1;2;3;0;0
12850; 20.9 ; 167.1 ; 8.6 ;8;42;2;0;8;6;2;5;3;8;0;0
12851; 35.4 ; 70.7 ; 2.7 ;2;284;160;0;2;2;0;1;1;0;2;0
12852; 57.4 ; 114.8 ; 46.8 ;2;140;128;0;2;2;0;1;1;1;0;1
12853; 37.9 ; 189.5 ; 13.1 ;5;73;19;1;4;1;4;4;1;2;3;0
12854; 73.0 ; 364.9 ; 40.1 ;5;23;246;0;5;0;5;4;1;0;0;5
12855; 15.0 ; 59.9 ; -   ;4;12;238;0;4;3;1;4;0;4;0;0
12856; 17.5 ; 87.6 ; 4.5 ;5;34;230;0;5;2;3;1;4;5;0;0
12857; 40.8 ; 652.1 ; 47.0 ;16;25;39;0;16;5;11;12;4;5;6;5
12858; 32.3 ; 1,163.4 ; 14.9 ;36;5;5;1;35;16;20;20;16;12;24;0
12859; 22.9 ; 91.6 ; 7.7 ;4;82;98;0;4;1;3;2;2;3;1;0
12860; 88.1 ; 352.3 ; 79.9 ;4;65;106;0;4;1;3;4;0;1;0;3
12861; 29.4 ; 88.2 ; 13.2 ;3;25;329;0;3;1;2;1;2;2;1;0
12862; 26.1 ; 52.3 ; -   ;2;88;11;2;0;1;1;2;0;2;0;0
12863; 34.2 ; 68.4 ; 4.5 ;2;5;42;0;2;0;2;2;0;1;1;0
12864; 34.9 ; 69.9 ; 0.7 ;2;12;170;0;2;2;0;0;2;0;2;0
12865; 44.3 ; 177.3 ; 10.5 ;4;14;146;1;3;0;4;1;3;0;4;0
12866; 48.8 ; 97.6 ; 16.3 ;2;19;83;0;2;0;2;1;1;0;1;1
12867; 25.1 ; 100.3 ; 6.7 ;4;56;160;0;4;3;1;4;0;3;1;0
12868; 33.9 ; 169.7 ; 16.2 ;5;81;50;1;4;1;4;4;1;2;3;0
12869; 25.6 ; 178.9 ; 13.0 ;7;47;20;0;7;0;7;3;4;5;2;0
12870; 56.5 ; 112.9 ; 3.2 ;2;23;259;0;2;1;1;1;1;0;0;2
12871; 22.6 ; 45.2 ; 11.4 ;2;76;74;2;0;0;2;2;0;1;1;0
12872; 44.8 ; 89.6 ; 2.9 ;2;32;144;0;2;2;0;2;0;0;2;0
12873; 26.4 ; 52.8 ; 14.8 ;2;61;189;0;2;0;2;2;0;1;1;0
12874; 28.2 ; 140.9 ; 10.9 ;5;42;0;0;5;1;4;3;2;3;2;0
12875; 22.9 ; 160.0 ; 8.3 ;7;30;20;0;7;0;7;1;6;5;2;0
12876; 16.0 ; 80.0 ; 2.6 ;5;48;2;5;0;2;3;5;0;5;0;0
12877; 35.5 ; 106.5 ; 33.4 ;3;72;152;0;3;1;2;2;1;1;1;1
12878; 37.0 ; 259.1 ; 15.7 ;7;21;31;0;7;1;6;5;2;2;5;0
12879; 74.4 ; 223.1 ; 29.9 ;3;18;215;0;3;0;3;1;2;0;0;3
12880; 29.6 ; 385.3 ; 10.2 ;13;23;24;0;13;7;6;6;7;9;4;0
12881; 56.5 ; 225.9 ; 0.4 ;4;65;36;0;4;0;4;4;0;0;0;4
12882; 42.7 ; 128.0 ; 15.3 ;3;112;56;0;3;2;1;1;2;1;1;1
12883; 126.6 ; 253.2 ; 36.7 ;2;7;152;0;2;0;2;1;1;0;0;2
12884; 25.1 ; 50.1 ; -   ;2;65;245;0;2;1;1;0;2;2;0;0
12885; 71.5 ; 143.1 ; 11.2 ;2;112;53;0;2;0;2;2;0;0;0;2
12886; 32.6 ; 195.5 ; 14.9 ;6;16;309;0;6;0;6;3;3;2;4;0
12887; 33.7 ; 101.2 ; 17.6 ;3;4;274;0;3;0;3;1;2;1;2;0
12888; 52.9 ; 1,375.3 ; 22.2 ;26;14;22;0;26;2;24;22;4;0;17;9
12889; 34.7 ; 277.4 ; 17.9 ;8;19;17;0;8;3;5;8;0;3;5;0
12890; 59.1 ; 295.5 ; 17.6 ;5;17;289;0;5;0;5;3;2;0;0;5
12891; 27.3 ; 163.6 ; 12.0 ;6;20;164;0;6;2;4;1;5;4;2;0
12892; 32.5 ; 97.5 ; 14.2 ;3;22;88;3;0;3;0;1;2;1;2;0
12893; 28.4 ; 170.3 ; 22.1 ;6;32;119;0;6;3;3;6;0;4;2;0
12894; 18.0 ; 90.1 ; 3.0 ;5;37;123;0;5;2;3;3;2;5;0;0
12895; 82.9 ; 331.6 ; 71.1 ;4;29;109;0;4;3;1;4;0;1;0;3
12896; 38.7 ; 116.1 ; 8.8 ;3;5;212;3;0;2;1;1;2;1;2;0
12897; 15.0 ; 30.0 ; -   ;2;9;34;0;2;1;1;1;1;2;0;0
12898; 16.8 ; 33.6 ; 2.7 ;2;127;277;0;2;1;1;1;1;2;0;0
12899; 18.9 ; 94.4 ; 2.0 ;5;42;121;0;5;1;4;1;4;5;0;0
12900; 25.1 ; 50.1 ; -   ;2;15;199;0;2;1;1;0;2;2;0;0
12901; 36.2 ; 108.5 ; 19.4 ;3;29;257;0;3;1;2;3;0;1;1;1
12902; 20.0 ; 219.7 ; 7.8 ;11;24;5;0;11;6;5;5;6;11;0;0
12903; 56.4 ; 112.9 ; 3.7 ;2;14;10;0;2;0;2;2;0;0;0;2
12904; 67.6 ; 405.6 ; 23.2 ;6;24;173;0;6;0;6;6;0;0;0;6
12905; 16.5 ; 231.5 ; 4.2 ;14;26;20;0;14;9;5;6;8;14;0;0
12906; 22.6 ; 45.2 ; 11.4 ;2;7;194;0;2;0;2;0;2;1;1;0
12907; 51.3 ; 102.5 ; 3.8 ;2;23;162;0;2;1;1;1;1;0;1;1
12908; 36.4 ; 72.9 ; 15.4 ;2;122;32;0;2;1;1;1;1;1;1;0
12909; 77.3 ; 154.5 ; 0.5 ;2;113;110;2;0;0;2;2;0;0;0;2
12910; 20.0 ; 99.8 ; 11.8 ;5;7;245;0;5;4;1;5;0;3;2;0
12911; 46.7 ; 280.2 ; 6.1 ;6;23;15;0;6;2;4;3;3;0;6;0
12912; 27.6 ; 55.1 ; 7.0 ;2;103;92;0;2;1;1;1;1;1;1;0
12913; 18.4 ; 55.2 ; 3.5 ;3;46;23;3;0;2;1;3;0;3;0;0
12914; 25.1 ; 50.1 ; -   ;2;52;293;0;2;1;1;2;0;2;0;0
12915; 37.0 ; 295.7 ; 17.5 ;8;20;23;0;8;2;6;5;3;3;5;0
12916; 49.6 ; 148.7 ; 0.9 ;3;115;83;0;3;1;2;2;1;0;3;0
12917; 18.1 ; 108.7 ; 5.8 ;6;5;21;0;6;1;5;1;5;6;0;0
12918; 21.2 ; 339.6 ; 10.4 ;16;4;47;0;16;4;12;11;5;11;5;0
12919; 46.0 ; 138.1 ; 2.0 ;3;122;21;0;3;0;3;3;0;0;3;0
12920; 26.2 ; 104.9 ; 7.9 ;4;18;248;0;4;2;2;1;3;3;1;0
12921; 34.2 ; 581.8 ; 15.3 ;17;20;20;0;17;7;10;12;5;6;11;0
12922; 47.8 ; 239.1 ; 29.2 ;5;27;125;0;5;4;1;2;3;2;1;2
12923; 16.5 ; 428.3 ; 3.2 ;26;16;20;0;26;16;10;23;3;26;0;0
12924; 46.2 ; 185.0 ; 19.5 ;4;35;136;0;4;3;1;2;2;1;2;1
12925; 35.9 ; 71.9 ; 15.2 ;2;46;218;0;2;1;1;0;2;1;1;0
12926; 24.7 ; 173.2 ; 7.7 ;7;10;14;7;0;4;3;5;2;5;2;0
12927; 35.9 ; 71.8 ; 16.2 ;2;217;113;0;2;1;1;0;2;1;1;0
12928; 40.9 ; 81.8 ; 16.0 ;2;131;162;0;2;0;2;0;2;1;0;1
12929; 64.0 ; 320.0 ; 17.7 ;5;29;141;0;5;0;5;2;3;0;0;5
12930; 59.3 ; 949.6 ; 6.8 ;16;11;10;0;16;6;10;10;6;0;0;16
12931; 33.4 ; 568.5 ; 15.6 ;17;17;83;0;17;9;8;6;11;6;11;0
12932; 21.4 ; 42.8 ; 9.6 ;2;251;5;0;2;0;2;2;0;1;1;0
12933; 36.1 ; 505.3 ; 14.4 ;14;24;43;0;14;6;8;6;8;5;9;0
12934; 38.0 ; 114.0 ; 10.8 ;3;23;245;0;3;1;2;1;2;1;2;0
12935; 25.3 ; 101.1 ; 9.4 ;4;98;16;0;4;1;3;2;2;3;1;0
12936; 61.5 ; 184.4 ; 7.0 ;3;56;42;0;3;0;3;1;2;0;0;3
12937; 65.9 ; 329.7 ; 14.0 ;5;31;15;0;5;0;5;5;0;0;0;5
12938; 30.6 ; 91.8 ; 17.2 ;3;137;53;0;3;1;2;3;0;1;2;0
12939; 53.9 ; 269.7 ; 8.1 ;5;40;47;0;5;0;5;0;5;0;3;2
12940; 44.2 ; 176.8 ; 5.4 ;4;14;251;0;4;0;4;3;1;0;4;0
12941; 41.0 ; 81.9 ; 16.1 ;2;20;83;0;2;0;2;0;2;1;0;1
12942; 15.0 ; 30.0 ; -   ;2;3;99;0;2;1;1;0;2;2;0;0
12943; 23.4 ; 631.1 ; 10.5 ;27;11;8;0;27;10;17;10;17;18;9;0
12944; 22.2 ; 133.4 ; 7.0 ;6;34;109;0;6;2;4;4;2;6;0;0
12945; 46.8 ; 93.5 ; -   ;2;6;206;0;2;0;2;2;0;0;2;0
12946; 49.2 ; 246.0 ; 10.8 ;5;6;11;0;5;2;3;1;4;0;3;2
12947; 17.3 ; 34.7 ; 3.5 ;2;2;337;0;2;1;1;1;1;2;0;0
12948; 33.4 ; 434.2 ; 22.8 ;13;19;5;0;13;2;11;10;3;4;5;4
12949; 20.0 ; 40.1 ; 7.6 ;2;5;278;0;2;0;2;1;1;2;0;0
12950; 27.6 ; 82.9 ; 14.9 ;3;67;102;0;3;2;1;1;2;2;1;0
12951; 36.4 ; 72.9 ; 15.4 ;2;42;288;0;2;1;1;2;0;1;1;0
12952; 15.0 ; 119.9 ; -   ;8;23;52;0;8;2;6;2;6;8;0;0
12953; 42.1 ; 126.3 ; 49.7 ;3;15;110;0;3;0;3;1;2;1;1;1
12954; 30.8 ; 61.7 ; 8.6 ;2;27;155;0;2;1;1;0;2;1;1;0
12955; 55.6 ; 222.5 ; 39.0 ;4;36;184;0;4;0;4;3;1;1;0;3
12956; 31.8 ; 63.7 ; 25.2 ;2;15;97;0;2;1;1;2;0;1;0;1
12957; 47.3 ; 330.9 ; 22.2 ;7;33;37;0;7;0;7;4;3;2;3;2
12958; 86.0 ; 774.1 ; 19.1 ;9;45;10;0;9;1;8;8;1;0;0;9
12959; 22.8 ; 114.0 ; 10.5 ;5;29;209;0;5;3;2;3;2;3;2;0
12960; 51.4 ; 462.2 ; 21.3 ;9;39;52;0;9;2;7;7;2;0;6;3
12961; 24.7 ; 98.9 ; 9.6 ;4;37;185;0;4;2;2;2;2;3;1;0
12962; 67.7 ; 338.3 ; 10.7 ;5;54;86;0;5;2;3;3;2;0;0;5
12963; 16.8 ; 50.4 ; 3.3 ;3;4;271;0;3;3;0;0;3;3;0;0
12964; 20.2 ; 364.4 ; 5.6 ;18;14;0;0;18;0;18;17;1;18;0;0
12965; 48.1 ; 144.2 ; 16.4 ;3;48;130;2;1;1;2;2;1;0;2;1
12966; 34.9 ; 69.7 ; 17.8 ;2;8;115;0;2;1;1;2;0;1;1;0
12967; 22.7 ; 90.8 ; 5.5 ;4;69;95;1;3;2;2;4;0;4;0;0
12968; 47.1 ; 235.5 ; 6.3 ;5;23;29;0;5;3;2;3;2;0;5;0
12969; 31.6 ; 347.4 ; 6.3 ;11;14;9;0;11;9;2;3;8;4;7;0
12970; 22.5 ; 44.9 ; 11.2 ;2;151;26;0;2;0;2;1;1;1;1;0
12971; 55.6 ; 166.8 ; 15.6 ;3;140;26;0;3;1;2;3;0;0;0;3
12972; 15.0 ; 30.0 ; -   ;2;323;57;0;2;1;1;1;1;2;0;0
12973; 28.8 ; 173.1 ; 8.0 ;6;33;65;0;6;6;0;0;6;4;2;0
12974; 50.6 ; 101.2 ; 10.5 ;2;5;42;0;2;0;2;2;0;0;1;1
12975; 27.0 ; 1,107.2 ; 9.0 ;41;10;1;0;41;29;12;40;1;27;14;0
12976; 46.5 ; 92.9 ; 4.2 ;2;38;146;0;2;0;2;2;0;0;2;0
12977; 35.6 ; 320.3 ; 12.7 ;9;32;17;0;9;1;8;1;8;3;6;0
12978; 46.8 ; 140.3 ; -   ;3;80;116;0;3;1;2;3;0;0;3;0
12979; 15.0 ; 45.0 ; -   ;3;26;60;0;3;2;1;1;2;3;0;0
12980; 24.3 ; 48.6 ; 8.5 ;2;5;271;0;2;2;0;0;2;1;1;0
12981; 71.7 ; 143.3 ; 62.5 ;2;14;62;2;0;1;1;1;1;1;0;1
12982; 18.0 ; 36.1 ; 4.6 ;2;12;246;0;2;0;2;0;2;2;0;0
12983; 50.3 ; 251.6 ; 19.8 ;5;22;6;0;5;0;5;4;1;0;3;2
12984; 28.2 ; 480.2 ; 17.0 ;17;11;231;0;17;4;13;13;4;11;6;0
12985; 55.4 ; 498.5 ; 16.0 ;9;21;92;0;9;3;6;8;1;0;0;9
12986; 50.9 ; 305.4 ; 26.8 ;6;14;101;0;6;0;6;3;3;2;2;2
12987; 50.0 ; 100.0 ; 3.8 ;2;143;62;0;2;1;1;1;1;0;2;0
12988; 19.2 ; 287.5 ; 9.4 ;15;21;11;0;15;9;6;12;3;15;0;0
12989; 60.9 ; 121.9 ; 20.2 ;2;12;35;0;2;2;0;2;0;0;0;2
12990; 65.9 ; 197.7 ; 34.5 ;3;61;103;3;0;2;1;1;2;0;0;3
12991; 49.1 ; 196.2 ; 25.5 ;4;16;97;0;4;4;0;4;0;1;2;1
12992; 52.3 ; 261.4 ; 18.0 ;5;18;20;0;5;2;3;5;0;0;3;2
12993; 17.6 ; 70.5 ; 2.1 ;4;22;17;0;4;3;1;4;0;4;0;0
12994; 34.1 ; 136.5 ; 10.3 ;4;109;42;0;4;0;4;3;1;1;3;0
12995; 51.1 ; 255.3 ; 7.0 ;5;107;2;1;4;3;2;2;3;0;3;2
12996; 49.6 ; 99.2 ; 2.1 ;2;144;20;2;0;0;2;2;0;0;2;0
12997; 53.4 ; 373.6 ; 21.9 ;7;18;63;0;7;3;4;1;6;0;5;2
12998; 15.0 ; 30.0 ; -   ;2;35;5;2;0;1;1;1;1;2;0;0
12999; 27.5 ; 109.9 ; 6.3 ;4;37;25;1;3;3;1;2;2;3;1;0
13000; 25.8 ; 51.6 ; 8.0 ;2;210;104;0;2;1;1;1;1;1;1;0
13001; 20.0 ; 59.9 ; 9.2 ;3;72;109;1;2;3;0;3;0;3;0;0
13002; 16.2 ; 242.6 ; 3.5 ;15;6;20;0;15;8;7;8;7;15;0;0
13003; 21.6 ; 64.7 ; 0.2 ;3;28;159;0;3;2;1;2;1;3;0;0
13004; 101.0 ; 404.1 ; 36.0 ;4;96;53;0;4;1;3;2;2;0;0;4
13005; 65.1 ; 130.1 ; 27.4 ;2;112;184;0;2;0;2;2;0;0;0;2
13006; 63.4 ; 380.4 ; 50.7 ;6;49;32;0;6;0;6;3;3;2;0;4
13007; 38.2 ; 152.6 ; 2.5 ;4;24;339;0;4;2;2;1;3;0;4;0
13008; 23.7 ; 118.4 ; 4.6 ;5;43;17;1;4;2;3;2;3;5;0;0
13009; 53.7 ; 1,449.8 ; 17.5 ;27;14;1;0;27;1;26;12;15;0;18;9
13010; 57.7 ; 115.4 ; 16.4 ;2;57;62;0;2;0;2;2;0;0;0;2
13011; 30.2 ; 60.4 ; -   ;2;15;40;2;0;1;1;1;1;0;2;0
13012; 53.5 ; 267.3 ; 5.6 ;5;86;5;0;5;1;4;1;4;0;3;2
13013; 26.6 ; 1,035.6 ; 12.1 ;39;11;12;0;39;21;18;17;22;26;13;0
13014; 33.4 ; 66.8 ; 4.8 ;2;74;95;1;1;0;2;2;0;1;1;0
13015; 38.1 ; 114.2 ; 21.4 ;3;77;42;0;3;1;2;1;2;1;1;1
13016; 15.0 ; 30.0 ; -   ;2;5;182;2;0;2;0;1;1;2;0;0
13017; 17.7 ; 70.7 ; 2.1 ;4;10;47;0;4;0;4;3;1;4;0;0
13018; 26.2 ; 131.1 ; 9.3 ;5;64;51;0;5;4;1;3;2;3;2;0
13019; 38.6 ; 115.8 ; 32.2 ;3;9;5;0;3;0;3;1;2;1;1;1
13020; 15.0 ; 45.0 ; -   ;3;63;62;0;3;0;3;3;0;3;0;0
13021; 38.3 ; 76.6 ; 12.7 ;2;21;248;0;2;1;1;0;2;1;1;0
13022; 34.1 ; 68.2 ; 21.9 ;2;2;277;0;2;1;1;0;2;1;0;1
13023; 36.6 ; 73.2 ; -   ;2;95;37;0;2;0;2;1;1;0;2;0
13024; 27.6 ; 55.2 ; 13.5 ;2;10;209;0;2;1;1;2;0;1;1;0
13025; 42.0 ; 252.0 ; 29.5 ;6;30;5;0;6;1;5;4;2;2;2;2
13026; 31.3 ; 125.1 ; 14.6 ;4;147;21;0;4;0;4;2;2;1;3;0
13027; 18.8 ; 56.5 ; 7.0 ;3;56;5;0;3;0;3;3;0;3;0;0
13028; 24.9 ; 49.8 ; 0.3 ;2;28;240;0;2;2;0;2;0;2;0;0
13029; 33.9 ; 101.6 ; 10.3 ;3;61;5;0;3;2;1;3;0;1;2;0
13030; 39.7 ; 317.9 ; 10.5 ;8;31;42;1;7;2;6;2;6;3;5;0
13031; 18.4 ; 36.9 ; 0.6 ;2;21;149;0;2;2;0;2;0;2;0;0
13032; 24.1 ; 120.4 ; 5.9 ;5;51;93;0;5;3;2;4;1;5;0;0
13033; 44.9 ; 404.3 ; 13.8 ;9;19;121;0;9;1;8;3;6;0;6;3
13034; 47.4 ; 142.1 ; 1.1 ;3;59;122;0;3;3;0;1;2;0;3;0
13035; 18.4 ; 258.0 ; 6.6 ;14;22;6;0;14;5;9;5;9;14;0;0
13036; 33.9 ; 203.2 ; 7.8 ;6;25;89;0;6;1;5;0;6;2;4;0
13037; 32.4 ; 162.1 ; 18.9 ;5;32;112;1;4;3;2;4;1;2;3;0
13038; 27.0 ; 135.2 ; 4.2 ;5;44;0;0;5;1;4;3;2;3;2;0
13039; 19.9 ; 139.1 ; 2.6 ;7;21;19;0;7;1;6;4;3;7;0;0
13040; 47.7 ; 238.4 ; 19.4 ;5;45;89;0;5;0;5;3;2;2;1;2
13041; 47.5 ; 237.3 ; 1.3 ;5;17;101;0;5;4;1;2;3;0;5;0
13042; 55.5 ; 388.7 ; 12.0 ;7;23;20;0;7;0;7;7;0;0;0;7
13043; 35.9 ; 71.8 ; 16.2 ;2;17;103;0;2;2;0;2;0;1;1;0
13044; 39.1 ; 117.2 ; 16.3 ;3;109;26;0;3;1;2;3;0;1;1;1
13045; 62.7 ; 439.2 ; 11.9 ;7;23;38;0;7;2;5;4;3;0;0;7
13046; 40.3 ; 684.9 ; 19.0 ;17;11;10;0;17;5;12;6;11;6;5;6
13047; 18.0 ; 108.1 ; 3.4 ;6;23;279;0;6;3;3;4;2;6;0;0
13048; 34.2 ; 171.0 ; 14.1 ;5;30;5;0;5;0;5;1;4;2;3;0
13049; 84.7 ; 169.4 ; 52.6 ;2;113;162;0;2;0;2;2;0;0;0;2
13050; 15.0 ; 30.0 ; -   ;2;1;2;0;2;2;0;0;2;2;0;0
13051; 17.5 ; 298.0 ; 8.4 ;17;15;17;0;17;11;6;8;9;17;0;0
13052; 18.6 ; 74.5 ; 5.1 ;4;20;307;0;4;2;2;1;3;4;0;0
13053; 25.9 ; 363.1 ; 8.1 ;14;19;42;0;14;2;12;4;10;9;5;0
13054; 67.6 ; 135.2 ; 22.6 ;2;11;263;0;2;0;2;1;1;0;0;2
13055; 65.6 ; 196.8 ; 15.7 ;3;22;263;0;3;0;3;2;1;0;0;3
13056; 35.2 ; 246.3 ; 14.6 ;7;21;99;0;7;3;4;1;6;2;5;0
13057; 42.3 ; 84.6 ; 2.1 ;2;2;92;0;2;1;1;1;1;0;2;0
13058; 42.9 ; 643.5 ; 16.5 ;15;28;17;0;15;1;14;11;4;5;5;5
13059; 74.4 ; 148.8 ; 73.9 ;2;6;93;0;2;1;1;1;1;1;0;1
13060; 40.0 ; 119.9 ; 6.2 ;3;39;230;0;3;1;2;3;0;0;3;0
13061; 25.1 ; 75.2 ; -   ;3;47;146;0;3;0;3;1;2;3;0;0
13062; 41.2 ; 123.5 ; 25.3 ;3;32;161;0;3;1;2;2;1;1;1;1
13063; 54.5 ; 163.5 ; 23.1 ;3;13;257;0;3;0;3;3;0;0;2;1
13064; 28.1 ; 56.3 ; 4.6 ;2;35;64;0;2;1;1;1;1;1;1;0
13065; 24.0 ; 408.6 ; 13.7 ;17;14;0;0;17;11;6;9;8;11;6;0
13066; 36.8 ; 184.2 ; 16.3 ;5;77;5;0;5;1;4;3;2;2;3;0
13067; 31.1 ; 124.3 ; 10.3 ;4;13;60;4;0;3;1;3;1;1;3;0
13068; 121.7 ; 486.8 ; 72.1 ;4;35;146;0;4;0;4;4;0;0;0;4
13069; 51.3 ; 102.6 ; 31.6 ;2;48;33;0;2;1;1;1;1;1;0;1
13070; 45.8 ; 91.6 ; 4.4 ;2;95;89;1;1;0;2;2;0;0;2;0
13071; 18.1 ; 54.2 ; 0.1 ;3;13;17;0;3;0;3;3;0;3;0;0
13072; 46.8 ; 93.5 ; -   ;2;57;146;0;2;0;2;2;0;0;2;0
13073; 46.0 ; 91.9 ; 14.0 ;2;70;120;0;2;0;2;2;0;0;1;1
13074; 51.9 ; 259.5 ; 14.7 ;5;41;94;0;5;1;4;2;3;0;3;2
13075; 46.8 ; 140.3 ; -   ;3;52;180;0;3;2;1;1;2;0;3;0
13076; 58.8 ; 470.7 ; 13.7 ;8;38;45;0;8;0;8;8;0;0;0;8
13077; 32.2 ; 64.4 ; 25.8 ;2;41;33;2;0;2;0;2;0;1;0;1
13078; 69.3 ; 138.7 ; 53.4 ;2;31;256;0;2;2;0;0;2;1;0;1
13079; 35.4 ; 106.3 ; 27.9 ;3;33;161;0;3;2;1;0;3;1;1;1
13080; 50.5 ; 151.6 ; 3.1 ;3;115;22;0;3;1;2;2;1;0;3;0
13081; 63.6 ; 127.2 ; 0.5 ;2;32;83;1;1;0;2;2;0;0;0;2
13082; 17.1 ; 153.9 ; 7.1 ;9;14;299;0;9;0;9;3;6;9;0;0
13083; 42.6 ; 85.2 ; 0.4 ;2;128;152;0;2;1;1;1;1;0;2;0
13084; 27.6 ; 55.3 ; 3.8 ;2;77;135;0;2;1;1;2;0;1;1;0
13085; 49.5 ; 643.8 ; 25.6 ;13;31;25;0;13;5;8;4;9;4;5;4
13086; 26.5 ; 106.0 ; 7.9 ;4;33;63;0;4;2;2;2;2;3;1;0
13087; 40.4 ; 161.6 ; 27.2 ;4;10;92;0;4;1;3;4;0;1;2;1
13088; 27.6 ; 55.3 ; 3.8 ;2;57;104;0;2;0;2;1;1;1;1;0
13089; 30.9 ; 61.7 ; 23.8 ;2;32;168;2;0;0;2;2;0;1;1;0
13090; 32.5 ; 97.6 ; 13.7 ;3;27;32;0;3;0;3;2;1;1;2;0
13091; 22.2 ; 66.6 ; 13.2 ;3;124;89;0;3;1;2;2;1;2;1;0
13092; 28.9 ; 144.5 ; 4.8 ;5;51;83;0;5;0;5;5;0;3;2;0
13093; 30.5 ; 152.7 ; 3.3 ;5;68;46;0;5;3;2;1;4;2;3;0
13094; 28.4 ; 85.2 ; 16.3 ;3;41;296;0;3;2;1;3;0;2;1;0
13095; 63.5 ; 253.8 ; 11.6 ;4;83;122;0;4;1;3;2;2;0;0;4
13096; 47.8 ; 143.4 ; 10.4 ;3;51;182;0;3;2;1;1;2;0;2;1
13097; 39.4 ; 157.5 ; 17.3 ;4;3;248;0;4;3;1;2;2;1;2;1
13098; 45.3 ; 543.3 ; 8.5 ;12;19;5;0;12;2;10;8;4;0;12;0
13099; 41.7 ; 250.0 ; 30.8 ;6;35;114;0;6;2;4;1;5;2;2;2
13100; 65.3 ; 195.9 ; 13.3 ;3;6;62;0;3;2;1;1;2;0;0;3
13101; 58.4 ; 175.3 ; 13.4 ;3;163;116;0;3;0;3;3;0;0;0;3
13102; 22.1 ; 154.5 ; 8.8 ;7;20;23;0;7;4;3;5;2;5;2;0
13103; 29.2 ; 87.5 ; 17.6 ;3;41;95;0;3;0;3;3;0;2;1;0
13104; 55.7 ; 333.9 ; 7.0 ;6;43;51;0;6;2;4;5;1;0;0;6
13105; 42.6 ; 212.8 ; 15.2 ;5;35;156;0;5;3;2;3;2;2;1;2
13106; 42.0 ; 336.2 ; 16.8 ;8;26;0;3;5;2;6;2;6;3;2;3
13107; 38.6 ; 1,002.5 ; 20.4 ;26;17;4;0;26;13;13;10;16;9;8;9
13108; 25.6 ; 76.7 ; 19.4 ;3;4;176;3;0;2;1;3;0;2;1;0
13109; 34.5 ; 69.0 ; 12.5 ;2;5;246;0;2;0;2;1;1;1;1;0
13110; 20.5 ; 123.2 ; 8.7 ;6;33;3;0;6;4;2;3;3;6;0;0
13111; 22.3 ; 422.8 ; 7.5 ;19;14;11;0;19;9;10;10;9;19;0;0
13112; 15.0 ; 30.0 ; -   ;2;39;269;0;2;2;0;2;0;2;0;0
13113; 25.3 ; 859.5 ; 14.0 ;34;11;27;0;34;13;21;22;12;23;11;0
13114; 28.9 ; 144.5 ; 21.8 ;5;39;102;0;5;2;3;1;4;3;2;0
13115; 16.2 ; 48.6 ; 2.2 ;3;13;120;0;3;1;2;3;0;3;0;0
13116; 61.1 ; 244.5 ; 17.8 ;4;27;236;0;4;1;3;3;1;0;0;4
13117; 43.9 ; 175.5 ; 11.2 ;4;11;356;0;4;3;1;1;3;0;3;1
13118; 43.1 ; 129.3 ; 0.4 ;3;141;52;0;3;0;3;1;2;0;3;0
13119; 54.9 ; 274.7 ; 37.1 ;5;13;214;0;5;2;3;3;2;2;1;2
13120; 49.7 ; 198.8 ; 13.5 ;4;86;47;0;4;0;4;3;1;0;3;1
13121; 65.9 ; 329.5 ; 22.7 ;5;41;141;0;5;0;5;5;0;0;0;5
13122; 36.4 ; 181.9 ; 15.8 ;5;44;31;0;5;1;4;2;3;2;3;0
13123; 39.7 ; 158.6 ; 10.8 ;4;12;269;0;4;0;4;2;2;1;3;0
13124; 26.8 ; 241.6 ; 14.3 ;9;32;59;0;9;0;9;6;3;6;3;0
13125; 17.1 ; 85.7 ; 2.6 ;5;59;2;5;0;4;1;5;0;5;0;0
13126; 48.1 ; 1,634.3 ; 29.6 ;34;8;2;0;34;17;17;5;29;11;12;11
13127; 43.6 ; 305.5 ; 12.3 ;7;30;20;0;7;0;7;6;1;0;5;2
13128; 49.2 ; 98.5 ; 3.7 ;2;289;26;1;1;0;2;1;1;0;2;0
13129; 73.6 ; 294.5 ; 21.7 ;4;101;42;0;4;2;2;4;0;0;0;4
13130; 48.8 ; 537.0 ; 26.5 ;11;39;5;0;11;2;9;4;7;4;3;4
13131; 20.0 ; 40.1 ; 7.6 ;2;33;221;0;2;1;1;1;1;2;0;0
13132; 17.4 ; 104.6 ; 3.0 ;6;30;113;0;6;6;0;0;6;6;0;0
13133; 50.0 ; 100.0 ; 3.8 ;2;120;52;0;2;0;2;2;0;0;2;0
13134; 36.8 ; 73.5 ; 17.5 ;2;167;106;0;2;0;2;0;2;1;1;0
13135; 46.1 ; 138.4 ; 16.6 ;3;146;113;2;1;2;1;3;0;1;1;1
13136; 30.2 ; 60.4 ; -   ;2;52;221;0;2;1;1;1;1;0;2;0
13137; 59.1 ; 236.4 ; 62.4 ;4;2;257;0;4;0;4;2;2;1;0;3
13138; 73.0 ; 146.1 ; 36.5 ;2;25;318;0;2;2;0;2;0;0;0;2
13139; 47.8 ; 95.7 ; 0.5 ;2;16;22;1;1;0;2;2;0;0;2;0
13140; 67.4 ; 134.8 ; 46.2 ;2;9;242;0;2;1;1;1;1;1;0;1
13141; 48.1 ; 96.1 ; 0.9 ;2;113;94;0;2;0;2;2;0;0;2;0
13142; 15.0 ; 45.0 ; -   ;3;41;101;0;3;2;1;2;1;3;0;0
13143; 20.0 ; 40.1 ; 7.6 ;2;283;31;0;2;1;1;2;0;2;0;0
13144; 38.1 ; 190.4 ; 8.8 ;5;38;154;0;5;1;4;1;4;2;3;0
13145; 49.8 ; 248.8 ; 34.3 ;5;28;80;0;5;1;4;5;0;2;1;2
13146; 67.7 ; 473.7 ; 46.2 ;7;50;99;0;7;0;7;3;4;2;0;5
13147; 114.2 ; 228.5 ; 14.0 ;2;32;173;0;2;0;2;2;0;0;0;2
13148; 18.9 ; 757.9 ; 5.8 ;40;6;3;0;40;23;17;16;24;40;0;0
13149; 47.7 ; 95.5 ; 1.5 ;2;122;180;0;2;2;0;0;2;0;2;0
13150; 119.5 ; 239.1 ; 7.6 ;2;5;347;0;2;0;2;0;2;0;0;2
13151; 20.2 ; 40.3 ; 7.8 ;2;30;189;0;2;1;1;1;1;2;0;0
13152; 52.2 ; 261.2 ; 22.6 ;5;28;146;0;5;4;1;3;2;2;1;2
13153; 43.0 ; 129.0 ; 29.4 ;3;50;255;0;3;2;1;1;2;1;1;1
13154; 87.6 ; 175.2 ; 76.4 ;2;19;234;0;2;2;0;1;1;1;0;1
13155; 36.2 ; 325.7 ; 14.8 ;9;17;17;0;9;2;7;3;6;3;6;0
13156; 118.0 ; 235.9 ; 36.6 ;2;246;100;0;2;0;2;2;0;0;0;2
13157; 19.5 ; 97.3 ; 6.6 ;5;78;93;1;4;3;2;4;1;5;0;0
13158; 38.5 ; 499.9 ; 10.8 ;13;7;205;0;13;5;8;11;2;4;9;0
13159; 21.4 ; 42.8 ; -   ;2;5;333;0;2;2;0;0;2;2;0;0
13160; 49.3 ; 246.4 ; 43.3 ;5;10;113;5;0;3;2;3;2;2;1;2
13161; 23.5 ; 235.2 ; 12.3 ;10;18;26;0;10;3;7;5;5;7;3;0
13162; 23.6 ; 212.0 ; 11.3 ;9;36;32;0;9;2;7;7;2;6;3;0
13163; 50.9 ; 1,171.8 ; 33.0 ;23;19;20;0;23;7;16;18;5;8;7;8
13164; 23.1 ; 46.2 ; 12.1 ;2;92;148;0;2;0;2;1;1;1;1;0
13165; 40.9 ; 163.6 ; 15.0 ;4;65;60;0;4;2;2;2;2;1;2;1
13166; 49.7 ; 149.0 ; 31.8 ;3;77;116;0;3;1;2;3;0;1;1;1
13167; 20.0 ; 59.9 ; 9.2 ;3;50;162;0;3;0;3;3;0;3;0;0
13168; 27.3 ; 191.4 ; 1.5 ;7;8;92;0;7;5;2;0;7;7;0;0
13169; 79.1 ; 158.2 ; 13.5 ;2;61;215;1;1;0;2;2;0;0;0;2
13170; 19.1 ; 229.1 ; 1.3 ;12;6;302;0;12;8;4;11;1;12;0;0
13171; 46.8 ; 93.5 ; -   ;2;24;241;0;2;0;2;2;0;0;2;0
13172; 45.5 ; 227.3 ; 24.2 ;5;6;89;0;5;0;5;3;2;2;1;2
13173; 53.5 ; 214.0 ; 16.6 ;4;101;63;0;4;0;4;3;1;0;3;1
13174; 55.3 ; 386.8 ; 13.6 ;7;26;79;0;7;4;3;3;4;0;0;7
13175; 30.5 ; 152.7 ; 10.7 ;5;50;187;0;5;3;2;2;3;2;3;0
13176; 32.5 ; 97.4 ; 14.1 ;3;22;278;0;3;0;3;1;2;1;2;0
13177; 46.3 ; 277.8 ; 14.4 ;6;31;121;0;6;0;6;4;2;0;4;2
13178; 38.8 ; 194.0 ; 10.3 ;5;55;74;0;5;0;5;3;2;2;3;0
13179; 31.3 ; 156.7 ; 9.7 ;5;19;53;0;5;2;3;3;2;2;3;0
13180; 51.7 ; 258.3 ; 25.7 ;5;12;10;0;5;2;3;1;4;2;1;2
13181; 46.8 ; 93.5 ; -   ;2;148;160;0;2;1;1;2;0;0;2;0
13182; 36.8 ; 73.6 ; 3.8 ;2;5;305;0;2;0;2;2;0;0;2;0
13183; 59.6 ; 119.3 ; 9.6 ;2;132;80;0;2;1;1;0;2;0;0;2
13184; 38.4 ; 115.3 ; 10.1 ;3;38;236;0;3;0;3;3;0;1;2;0
13185; 67.2 ; 201.6 ; 58.5 ;3;3;262;0;3;1;2;2;1;1;0;2
13186; 15.0 ; 30.0 ; -   ;2;6;53;0;2;0;2;0;2;2;0;0
13187; 50.2 ; 100.4 ; 4.0 ;2;29;53;0;2;1;1;2;0;0;2;0
13188; 19.4 ; 58.3 ; 5.5 ;3;131;16;0;3;1;2;2;1;3;0;0
13189; 61.4 ; 306.9 ; 22.6 ;5;42;10;5;0;1;4;5;0;0;0;5
13190; 39.2 ; 196.2 ; 11.8 ;5;46;5;1;4;2;3;2;3;2;3;0
13191; 46.5 ; 139.6 ; 15.2 ;3;122;116;0;3;0;3;1;2;0;2;1
13192; 37.9 ; 151.4 ; 10.9 ;4;93;135;0;4;1;3;0;4;1;3;0
13193; 16.9 ; 50.6 ; 1.7 ;3;2;213;0;3;2;1;1;2;3;0;0
13194; 68.4 ; 273.6 ; 2.9 ;4;71;94;0;4;1;3;1;3;0;0;4
13195; 35.8 ; 286.5 ; 13.7 ;8;26;50;0;8;2;6;6;2;3;5;0
13196; 43.7 ; 305.7 ; 13.1 ;7;38;31;0;7;0;7;5;2;0;5;2
13197; 67.0 ; 402.1 ; 18.4 ;6;69;43;0;6;0;6;6;0;0;0;6
13198; 22.3 ; 223.2 ; 5.0 ;10;36;8;0;10;5;5;1;9;10;0;0
13199; 24.6 ; 147.5 ; 7.5 ;6;40;79;0;6;2;4;2;4;4;2;0
13200; 38.6 ; 77.2 ; 28.3 ;2;31;235;0;2;2;0;1;1;1;0;1
13201; 22.8 ; 182.0 ; 12.6 ;8;50;5;0;8;4;4;3;5;5;3;0
13202; 88.6 ; 797.7 ; 36.6 ;9;34;9;0;9;2;7;7;2;0;0;9
13203; 28.2 ; 141.1 ; 16.7 ;5;18;60;5;0;1;4;3;2;3;2;0
13204; 16.9 ; 84.3 ; 3.0 ;5;14;372;0;5;1;4;3;2;5;0;0
13205; 15.0 ; 30.0 ; -   ;2;108;178;0;2;0;2;1;1;2;0;0
13206; 28.7 ; 57.5 ; 2.9 ;2;125;161;0;2;2;0;1;1;1;1;0
13207; 29.8 ; 387.5 ; 6.4 ;13;21;15;0;13;1;12;7;6;9;4;0
13208; 18.6 ; 37.2 ; -   ;2;37;242;0;2;0;2;2;0;2;0;0
13209; 47.3 ; 236.7 ; 1.2 ;5;41;95;0;5;0;5;2;3;0;5;0
13210; 50.6 ; 151.8 ; 22.3 ;3;176;74;0;3;0;3;1;2;1;1;1
13211; 50.3 ; 754.5 ; 11.5 ;15;17;23;0;15;4;11;2;13;0;10;5
13212; 44.5 ; 133.5 ; 7.2 ;3;50;22;0;3;1;2;2;1;0;3;0
13213; 30.5 ; 152.4 ; 7.9 ;5;40;49;0;5;5;0;1;4;2;3;0
13214; 70.5 ; 141.0 ; 32.8 ;2;40;263;0;2;1;1;1;1;0;0;2
13215; 40.2 ; 80.3 ; 14.9 ;2;145;99;0;2;0;2;2;0;1;0;1
13216; 32.3 ; 96.9 ; 13.3 ;3;14;244;0;3;2;1;2;1;1;2;0
13217; 40.0 ; 119.9 ; 10.1 ;3;18;215;0;3;0;3;1;2;1;2;0
13218; 23.4 ; 70.2 ; 8.2 ;3;97;23;2;1;2;1;2;1;2;1;0
13219; 52.4 ; 576.4 ; 20.2 ;11;20;99;0;11;2;9;7;4;0;7;4
13220; 48.0 ; 144.0 ; 1.1 ;3;23;146;0;3;1;2;3;0;0;3;0
13221; 36.1 ; 108.4 ; 11.5 ;3;88;100;0;3;1;2;1;2;1;2;0
13222; 33.9 ; 542.8 ; 13.3 ;16;11;37;0;16;4;12;11;5;5;11;0
13223; 55.4 ; 166.1 ; 2.1 ;3;54;15;0;3;0;3;3;0;0;0;3
13224; 16.3 ; 146.4 ; 2.4 ;9;23;163;0;9;1;8;7;2;9;0;0
13225; 27.6 ; 387.0 ; 5.9 ;14;10;148;0;14;0;14;12;2;9;5;0
13226; 53.9 ; 323.3 ; 35.7 ;6;35;36;6;0;3;3;1;5;2;2;2
13227; 37.0 ; 74.0 ; 15.7 ;2;5;48;0;2;0;2;1;1;1;1;0
13228; 47.4 ; 284.5 ; 21.6 ;6;50;29;0;6;0;6;4;2;2;2;2
13229; 18.6 ; 74.4 ; 5.0 ;4;59;73;0;4;0;4;1;3;4;0;0
13230; 35.2 ; 70.3 ; 24.8 ;2;5;42;0;2;1;1;1;1;1;0;1
13231; 15.0 ; 30.0 ; -   ;2;7;101;1;1;2;0;2;0;2;0;0
13232; 63.9 ; 383.7 ; 12.9 ;6;21;10;0;6;0;6;3;3;0;0;6
13233; 51.6 ; 103.2 ; 4.6 ;2;43;173;0;2;0;2;2;0;0;1;1
13234; 96.5 ; 386.2 ; 62.7 ;4;29;104;0;4;0;4;3;1;0;0;4
13235; 19.4 ; 38.9 ; -   ;2;1;248;0;2;2;0;2;0;2;0;0
13236; 52.5 ; 105.0 ; 31.9 ;2;78;29;0;2;1;1;0;2;1;0;1
13237; 35.5 ; 71.0 ; 8.3 ;2;189;11;0;2;0;2;2;0;1;1;0
13238; 26.8 ; 187.4 ; 10.8 ;7;44;0;0;7;1;6;5;2;5;2;0
13239; 48.9 ; 97.8 ; 3.2 ;2;52;230;0;2;1;1;1;1;0;2;0
13240; 61.7 ; 123.3 ; -   ;2;42;320;0;2;0;2;2;0;0;0;2
13241; 23.7 ; 189.7 ; 11.1 ;8;33;5;0;8;3;5;2;6;5;3;0
13242; 36.3 ; 72.5 ; 16.8 ;2;3;99;1;1;1;1;1;1;1;1;0
13243; 50.1 ; 400.6 ; 10.4 ;8;15;246;0;8;0;8;4;4;0;5;3
13244; 37.7 ; 677.9 ; 21.5 ;18;19;0;0;18;11;7;6;12;6;6;6
13245; 21.7 ; 65.1 ; 6.2 ;3;30;231;0;3;2;1;3;0;3;0;0
13246; 59.5 ; 297.6 ; 27.4 ;5;68;10;0;5;1;4;5;0;0;0;5
13247; 52.9 ; 105.8 ; 0.5 ;2;291;68;0;2;0;2;2;0;0;2;0
13248; 52.9 ; 158.8 ; 4.4 ;3;62;38;0;3;0;3;2;1;0;2;1
13249; 30.2 ; 90.6 ; -   ;3;131;126;0;3;1;2;3;0;0;3;0
13250; 47.1 ; 235.3 ; 0.8 ;5;27;155;0;5;5;0;3;2;0;5;0
13251; 44.3 ; 266.1 ; 6.6 ;6;26;262;0;6;0;6;3;3;0;6;0
13252; 71.6 ; 143.2 ; 18.8 ;2;19;167;0;2;0;2;2;0;0;0;2
13253; 17.4 ; 87.0 ; 2.4 ;5;79;39;0;5;4;1;3;2;5;0;0
13254; 23.4 ; 117.0 ; 6.5 ;5;8;161;0;5;5;0;1;4;5;0;0
13255; 40.0 ; 239.9 ; 28.4 ;6;50;0;0;6;0;6;4;2;2;2;2
13256; 36.6 ; 73.2 ; -   ;2;26;0;0;2;1;1;1;1;0;2;0
13257; 35.6 ; 106.7 ; 1.9 ;3;94;112;0;3;2;1;3;0;0;3;0
13258; 53.9 ; 107.8 ; 44.8 ;2;25;52;0;2;0;2;1;1;1;0;1
13259; 49.6 ; 99.3 ; 4.3 ;2;6;173;0;2;0;2;2;0;0;2;0
13260; 17.7 ; 53.0 ; 2.5 ;3;16;242;0;3;1;2;1;2;3;0;0
13261; 25.2 ; 151.0 ; 14.1 ;6;23;2;3;3;2;4;5;1;4;2;0
13262; 33.7 ; 1,348.8 ; 38.6 ;40;8;2;0;40;31;9;8;32;13;14;13
13263; 49.3 ; 98.7 ; -   ;2;14;40;0;2;1;1;1;1;0;2;0
13264; 57.6 ; 288.2 ; 19.7 ;5;44;2;0;5;3;2;2;3;0;0;5
13265; 22.6 ; 67.7 ; 3.4 ;3;13;0;0;3;1;2;2;1;3;0;0
13266; 47.8 ; 95.7 ; 0.5 ;2;29;23;0;2;1;1;1;1;0;2;0
13267; 26.3 ; 78.9 ; 12.1 ;3;14;251;0;3;1;2;1;2;2;1;0
13268; 58.2 ; 116.4 ; 16.1 ;2;37;16;0;2;0;2;1;1;0;0;2
13269; 45.9 ; 229.7 ; 6.6 ;5;37;7;5;0;2;3;4;1;0;5;0
13270; 28.9 ; 86.7 ; 7.0 ;3;43;99;0;3;0;3;1;2;2;1;0
13271; 86.1 ; 172.2 ; 19.3 ;2;141;160;0;2;1;1;1;1;0;0;2
13272; 47.8 ; 191.3 ; 2.3 ;4;53;116;0;4;1;3;3;1;0;4;0
13273; 20.0 ; 40.1 ; 7.6 ;2;14;197;0;2;2;0;0;2;2;0;0
13274; 68.0 ; 612.2 ; 31.7 ;9;23;89;0;9;3;6;5;4;0;0;9
13275; 51.3 ; 717.8 ; 5.3 ;14;28;69;0;14;6;8;6;8;0;9;5
13276; 22.4 ; 134.4 ; 12.4 ;6;50;23;0;6;4;2;1;5;4;2;0
13277; 33.8 ; 101.3 ; 6.6 ;3;15;136;0;3;0;3;1;2;1;2;0
13278; 35.8 ; 358.3 ; 18.4 ;10;45;26;0;10;0;10;7;3;3;7;0
13279; 18.9 ; 37.8 ; 0.9 ;2;1;278;0;2;0;2;2;0;2;0;0
13280; 41.0 ; 163.9 ; 15.4 ;4;14;155;0;4;3;1;3;1;1;2;1
13281; 25.8 ; 103.3 ; 1.6 ;4;31;11;0;4;1;3;3;1;4;0;0
13282; 37.3 ; 633.5 ; 22.4 ;17;18;5;0;17;1;16;12;5;6;5;6
13283; 83.9 ; 167.8 ; 86.6 ;2;131;60;0;2;2;0;1;1;1;0;1
13284; 67.2 ; 134.4 ; 27.7 ;2;37;152;0;2;0;2;2;0;0;0;2
13285; 28.5 ; 85.4 ; 3.1 ;3;86;104;0;3;1;2;1;2;2;1;0
13286; 18.1 ; 108.4 ; 8.6 ;6;14;2;0;6;3;3;1;5;6;0;0
13287; 89.5 ; 179.0 ; 41.6 ;2;68;152;0;2;1;1;2;0;0;0;2
13288; 53.7 ; 107.4 ; 42.9 ;2;50;20;0;2;2;0;0;2;1;0;1
13289; 29.4 ; 117.6 ; 14.5 ;4;27;86;0;4;1;3;1;3;3;1;0
13290; 15.7 ; 78.5 ; 1.7 ;5;34;14;0;5;3;2;5;0;5;0;0
13291; 31.8 ; 63.7 ; 25.2 ;2;6;229;0;2;2;0;0;2;1;0;1
13292; 32.8 ; 98.3 ; 7.0 ;3;14;93;0;3;1;2;1;2;1;2;0
13293; 133.8 ; 267.5 ; 107.9 ;2;31;52;0;2;1;1;0;2;1;0;1
13294; 38.2 ; 190.8 ; 13.0 ;5;67;98;0;5;3;2;1;4;2;3;0
13295; 36.9 ; 110.8 ; 16.3 ;3;20;244;0;3;2;1;2;1;1;2;0
13296; 62.7 ; 188.0 ; 2.4 ;3;16;251;0;3;1;2;3;0;0;0;3
13297; 66.5 ; 598.5 ; 42.6 ;9;23;31;0;9;4;5;2;7;3;0;6
13298; 41.5 ; 290.4 ; 5.9 ;7;54;5;0;7;2;5;1;6;0;7;0
13299; 25.3 ; 50.6 ; 7.3 ;2;9;269;0;2;1;1;1;1;1;1;0
13300; 15.0 ; 30.0 ; -   ;2;24;79;0;2;0;2;2;0;2;0;0
13301; 87.5 ; 175.0 ; 14.8 ;2;76;89;0;2;0;2;1;1;0;0;2
13302; 27.6 ; 386.5 ; 31.5 ;14;23;31;0;14;8;6;2;12;9;0;5
13303; 47.7 ; 95.5 ; 1.5 ;2;37;191;0;2;1;1;2;0;0;2;0
13304; 26.2 ; 78.7 ; 20.6 ;3;39;209;0;3;1;2;1;2;2;1;0
13305; 54.4 ; 217.7 ; 5.0 ;4;86;95;0;4;0;4;2;2;0;3;1
13306; 22.4 ; 224.5 ; 15.0 ;10;23;89;0;10;5;5;5;5;7;3;0
13307; 15.9 ; 79.4 ; 2.1 ;5;7;247;0;5;2;3;3;2;5;0;0
13308; 40.8 ; 203.9 ; 14.3 ;5;41;15;0;5;0;5;4;1;2;1;2
13309; 33.8 ; 67.5 ; 28.1 ;2;234;65;0;2;2;0;1;1;1;0;1
13310; 50.2 ; 100.4 ; 2.3 ;2;24;47;0;2;0;2;1;1;0;2;0
13311; 15.0 ; 209.8 ; -   ;14;8;68;0;14;8;6;5;9;14;0;0
13312; 31.1 ; 186.7 ; 13.7 ;6;18;28;0;6;4;2;5;1;2;4;0
13313; 27.2 ; 54.3 ; 11.2 ;2;2;269;0;2;1;1;2;0;1;1;0
13314; 62.6 ; 187.7 ; 18.5 ;3;40;210;0;3;0;3;2;1;0;0;3
13315; 21.4 ; 192.4 ; 6.0 ;9;27;75;0;9;7;2;4;5;9;0;0
13316; 17.7 ; 35.4 ; 4.1 ;2;251;142;0;2;0;2;0;2;2;0;0
13317; 60.9 ; 365.1 ; 7.3 ;6;58;39;0;6;1;5;4;2;0;0;6
13318; 53.1 ; 637.0 ; 39.0 ;12;11;71;0;12;6;6;3;9;4;4;4
13319; 48.3 ; 193.3 ; 21.8 ;4;19;22;0;4;1;3;3;1;1;2;1
13320; 48.4 ; 193.5 ; 19.0 ;4;67;66;0;4;2;2;4;0;1;2;1
13321; 17.1 ; 68.6 ; 2.6 ;4;103;17;0;4;2;2;2;2;4;0;0
13322; 33.4 ; 166.8 ; 34.0 ;5;14;241;0;5;1;4;1;4;2;1;2
13323; 21.1 ; 105.4 ; 3.5 ;5;14;219;0;5;4;1;0;5;5;0;0
13324; 19.6 ; 39.2 ; 0.5 ;2;41;8;0;2;1;1;2;0;2;0;0
13325; 43.8 ; 175.2 ; 22.9 ;4;40;169;0;4;0;4;4;0;1;2;1
13326; 22.2 ; 66.6 ; 13.2 ;3;68;14;0;3;2;1;2;1;2;1;0
13327; 15.0 ; 74.9 ; -   ;5;10;139;0;5;4;1;1;4;5;0;0
13328; 34.5 ; 483.3 ; 19.2 ;14;17;15;0;14;7;7;4;10;5;9;0
13329; 44.1 ; 396.9 ; 15.9 ;9;27;64;0;9;5;4;3;6;3;3;3
13330; 39.8 ; 79.6 ; 21.2 ;2;24;21;0;2;0;2;1;1;1;0;1
13331; 16.3 ; 293.1 ; 1.8 ;18;6;66;0;18;11;7;9;9;18;0;0
13332; 68.7 ; 137.4 ; 26.2 ;2;25;68;0;2;0;2;0;2;0;0;2
13333; 57.5 ; 517.4 ; 26.2 ;9;13;153;0;9;3;6;4;5;0;0;9
13334; 46.8 ; 187.0 ; -   ;4;7;260;0;4;1;3;4;0;0;4;0
13335; 73.1 ; 657.9 ; 68.1 ;9;29;23;0;9;3;6;9;0;3;0;6
13336; 35.3 ; 105.9 ; 5.1 ;3;50;180;0;3;3;0;1;2;0;3;0
13337; 24.3 ; 802.8 ; 10.5 ;33;5;146;0;33;17;16;14;19;22;11;0
13338; 101.9 ; 203.9 ; 79.7 ;2;18;263;0;2;0;2;2;0;1;0;1
13339; 35.9 ; 71.8 ; 16.2 ;2;95;47;0;2;0;2;2;0;1;1;0
13340; 23.3 ; 139.9 ; 15.8 ;6;53;5;0;6;3;3;2;4;4;2;0
13341; 26.3 ; 78.8 ; 10.4 ;3;2;239;0;3;1;2;1;2;2;1;0
13342; 54.9 ; 2,526.3 ; 20.2 ;46;10;0;0;46;0;46;44;2;0;31;15
13343; 42.6 ; 298.4 ; 7.7 ;7;30;96;0;7;3;4;1;6;0;7;0
13344; 27.6 ; 55.3 ; 3.8 ;2;16;143;0;2;1;1;1;1;1;1;0
13345; 51.3 ; 205.0 ; 41.6 ;4;82;53;0;4;1;3;2;2;1;2;1
13346; 37.3 ; 224.0 ; 8.3 ;6;47;148;0;6;0;6;5;1;2;4;0
13347; 35.4 ; 955.6 ; 11.9 ;27;14;10;0;27;0;27;19;8;9;18;0
13348; 38.3 ; 382.9 ; 24.4 ;10;22;4;0;10;4;6;4;6;3;4;3
13349; 24.6 ; 147.4 ; 16.4 ;6;19;64;0;6;0;6;5;1;4;2;0
13350; 36.9 ; 73.8 ; 17.7 ;2;68;204;0;2;0;2;0;2;1;1;0
13351; 45.0 ; 90.0 ; 3.2 ;2;182;157;0;2;1;1;2;0;0;2;0
13352; 35.9 ; 71.8 ; 15.4 ;2;6;58;0;2;0;2;1;1;1;1;0
13353; 33.4 ; 100.1 ; 8.6 ;3;25;251;0;3;2;1;3;0;1;2;0
13354; 71.0 ; 426.2 ; 22.4 ;6;45;26;0;6;0;6;5;1;0;0;6
13355; 66.2 ; 331.2 ; 39.2 ;5;27;134;0;5;3;2;4;1;2;0;3
13356; 46.4 ; 92.7 ; 0.6 ;2;19;152;0;2;0;2;2;0;0;2;0
13357; 18.3 ; 55.0 ; 6.2 ;3;4;38;0;3;2;1;3;0;3;0;0
13358; 34.1 ; 68.2 ; 19.0 ;2;13;209;0;2;0;2;1;1;1;1;0
13359; 17.3 ; 86.5 ; 4.6 ;5;16;28;0;5;1;4;2;3;5;0;0
13360; 158.9 ; 1,430.4 ; 32.8 ;9;23;185;0;9;0;9;9;0;0;0;9
13361; 48.7 ; 243.4 ; 45.2 ;5;22;131;0;5;1;4;2;3;2;1;2
13362; 30.2 ; 181.1 ; 9.9 ;6;26;206;0;6;4;2;4;2;2;4;0
13363; 46.8 ; 140.3 ; -   ;3;7;192;0;3;2;1;1;2;0;3;0
13364; 20.3 ; 60.8 ; 0.9 ;3;32;242;0;3;2;1;3;0;3;0;0
13365; 49.5 ; 148.5 ; 33.6 ;3;92;30;2;1;2;1;1;2;1;1;1
13366; 34.8 ; 139.1 ; 7.7 ;4;72;83;0;4;0;4;3;1;1;3;0
13367; 54.8 ; 219.2 ; 1.1 ;4;27;89;0;4;0;4;3;1;0;3;1
13368; 30.9 ; 61.7 ; 23.8 ;2;36;128;0;2;1;1;1;1;1;1;0
13369; 19.5 ; 97.7 ; 4.8 ;5;32;59;0;5;2;3;1;4;5;0;0
13370; 25.3 ; 228.1 ; 17.2 ;9;32;69;0;9;5;4;2;7;6;3;0
13371; 18.8 ; 357.7 ; 7.3 ;19;16;2;0;19;13;6;15;4;19;0;0
13372; 52.6 ; 631.2 ; 23.0 ;12;33;7;0;12;6;6;5;7;4;4;4
13373; 49.8 ; 99.6 ; 4.6 ;2;14;195;0;2;1;1;1;1;0;2;0
13374; 44.1 ; 132.3 ; 15.7 ;3;11;37;0;3;2;1;2;1;1;1;1
13375; 49.3 ; 98.7 ; -   ;2;20;58;2;0;0;2;2;0;0;2;0
13376; 22.1 ; 110.6 ; 4.2 ;5;18;30;0;5;4;1;5;0;5;0;0
13377; 32.1 ; 64.2 ; 10.5 ;2;200;153;0;2;0;2;1;1;1;1;0
13378; 47.7 ; 143.1 ; 1.7 ;3;29;296;0;3;2;1;2;1;0;3;0
13379; 20.7 ; 41.5 ; -   ;2;59;35;2;0;1;1;1;1;2;0;0
13380; 33.8 ; 67.5 ; 19.5 ;2;44;146;1;1;0;2;2;0;1;1;0
13381; 34.3 ; 239.8 ; 17.5 ;7;55;3;0;7;0;7;4;3;2;5;0
13382; 51.1 ; 409.1 ; 8.8 ;8;14;6;0;8;0;8;3;5;0;5;3
13383; 24.8 ; 123.8 ; 16.0 ;5;70;4;0;5;3;2;3;2;3;2;0
13384; 36.9 ; 184.5 ; 21.2 ;5;37;109;0;5;2;3;2;3;2;1;2
13385; 30.4 ; 182.6 ; 12.9 ;6;28;116;0;6;4;2;3;3;2;4;0
13386; 47.5 ; 94.9 ; -   ;2;12;37;0;2;0;2;1;1;0;2;0
13387; 44.7 ; 89.5 ; -   ;2;14;260;0;2;2;0;0;2;0;2;0
13388; 15.0 ; 30.0 ; -   ;2;19;10;0;2;0;2;2;0;2;0;0
13389; 30.8 ; 154.2 ; 7.5 ;5;15;0;5;0;0;5;4;1;2;3;0
13390; 42.4 ; 127.1 ; 10.6 ;3;52;13;0;3;1;2;3;0;0;3;0
13391; 42.4 ; 127.3 ; 12.3 ;3;120;47;1;2;0;3;3;0;0;3;0
13392; 46.8 ; 93.5 ; -   ;2;12;120;0;2;0;2;2;0;0;2;0
13393; 23.1 ; 46.1 ; -   ;2;3;257;0;2;1;1;2;0;2;0;0
13394; 29.1 ; 87.2 ; 17.7 ;3;13;36;2;1;1;2;3;0;2;1;0
13395; 44.9 ; 224.4 ; 32.5 ;5;49;99;2;3;2;3;1;4;2;1;2
13396; 55.4 ; 110.7 ; 4.3 ;2;268;58;0;2;1;1;0;2;0;0;2
13397; 33.9 ; 101.7 ; 16.2 ;3;56;12;0;3;1;2;2;1;1;2;0
13398; 15.0 ; 149.9 ; -   ;10;14;2;10;0;6;4;1;9;10;0;0
13399; 36.3 ; 72.5 ; 16.8 ;2;50;100;0;2;0;2;0;2;1;1;0
13400; 49.1 ; 147.3 ; 2.3 ;3;32;132;0;3;2;1;0;3;0;3;0
13401; 54.0 ; 486.1 ; 31.5 ;9;27;146;0;9;0;9;5;4;3;3;3
13402; 15.0 ; 45.0 ; -   ;3;20;209;0;3;0;3;2;1;3;0;0
13403; 20.6 ; 41.3 ; 1.4 ;2;1;26;0;2;0;2;0;2;2;0;0
13404; 37.7 ; 75.3 ; 8.6 ;2;3;263;0;2;1;1;0;2;1;1;0
13405; 103.7 ; 207.3 ; 76.6 ;2;169;120;0;2;0;2;2;0;1;0;1
13406; 134.0 ; 268.0 ; 75.7 ;2;5;96;2;0;2;0;1;1;0;0;2
13407; 15.8 ; 221.2 ; 0.1 ;14;5;130;0;14;10;4;5;9;14;0;0
13408; 15.7 ; 78.5 ; 1.7 ;5;20;212;0;5;2;3;2;3;5;0;0
13409; 95.5 ; 286.5 ; 13.8 ;3;67;26;2;1;0;3;2;1;0;0;3
13410; 18.5 ; 129.4 ; 3.0 ;7;32;10;0;7;4;3;3;4;7;0;0
13411; 53.9 ; 107.8 ; 9.7 ;2;14;68;0;2;1;1;1;1;0;1;1
13412; 16.7 ; 266.7 ; 4.1 ;16;14;3;0;16;7;9;10;6;16;0;0
13413; 50.2 ; 250.8 ; 12.4 ;5;11;149;5;0;3;2;3;2;0;3;2
13414; 33.9 ; 101.8 ; 15.3 ;3;96;89;0;3;1;2;1;2;1;2;0
13415; 33.6 ; 471.0 ; 15.1 ;14;21;30;0;14;11;3;7;7;5;9;0
13416; 19.7 ; 78.9 ; 4.6 ;4;11;220;0;4;2;2;4;0;4;0;0
13417; 38.7 ; 77.4 ; 13.1 ;2;1;46;0;2;1;1;1;1;1;1;0
13418; 25.6 ; 76.7 ; 19.4 ;3;40;195;0;3;2;1;2;1;2;1;0
13419; 32.5 ; 130.1 ; 17.0 ;4;15;143;4;0;3;1;1;3;1;3;0
13420; 83.3 ; 333.4 ; 73.2 ;4;84;136;0;4;1;3;1;3;1;0;3
13421; 47.5 ; 237.4 ; 0.7 ;5;64;5;0;5;0;5;5;0;0;5;0
13422; 76.3 ; 687.1 ; 29.6 ;9;23;57;0;9;5;4;5;4;0;0;9
13423; 28.1 ; 56.3 ; 4.6 ;2;38;20;0;2;0;2;1;1;1;1;0
13424; 28.5 ; 85.4 ; 3.1 ;3;121;122;0;3;2;1;2;1;2;1;0
13425; 18.0 ; 54.0 ; -   ;3;56;44;0;3;3;0;1;2;3;0;0
13426; 41.2 ; 82.5 ; 16.9 ;2;32;278;0;2;0;2;2;0;1;0;1
13427; 46.8 ; 655.1 ; 19.7 ;14;26;40;0;14;1;13;8;6;5;4;5
13428; 31.4 ; 125.8 ; 6.1 ;4;41;58;0;4;0;4;1;3;1;3;0
13429; 19.3 ; 38.6 ; -   ;2;5;193;0;2;2;0;2;0;2;0;0
13430; 24.8 ; 49.6 ; 10.5 ;2;13;203;0;2;1;1;2;0;1;1;0
13431; 38.5 ; 76.9 ; 12.4 ;2;78;160;0;2;1;1;2;0;1;1;0
13432; 34.9 ; 279.3 ; 22.3 ;8;41;115;0;8;4;4;8;0;3;2;3
13433; 90.5 ; 271.5 ; 35.9 ;3;13;341;0;3;1;2;1;2;0;0;3
13434; 43.2 ; 173.0 ; 17.7 ;4;54;125;0;4;0;4;2;2;1;2;1
13435; 48.4 ; 145.2 ; 3.0 ;3;101;99;0;3;0;3;3;0;0;3;0
13436; 79.7 ; 398.4 ; 32.1 ;5;53;140;0;5;2;3;2;3;0;0;5
13437; 28.3 ; 56.6 ; 7.9 ;2;10;236;0;2;1;1;1;1;1;1;0
13438; 43.6 ; 130.7 ; -   ;3;20;31;0;3;1;2;1;2;0;3;0
13439; 36.4 ; 109.2 ; 19.6 ;3;90;44;0;3;1;2;2;1;1;1;1
13440; 23.7 ; 142.3 ; 7.4 ;6;68;10;3;3;4;2;2;4;4;2;0
13441; 28.2 ; 197.1 ; 8.2 ;7;16;8;7;0;5;2;1;6;5;2;0
13442; 34.2 ; 170.9 ; 13.2 ;5;8;15;0;5;2;3;4;1;2;3;0
13443; 49.5 ; 544.5 ; 4.8 ;11;28;15;0;11;0;11;10;1;0;11;0
13444; 18.3 ; 55.0 ; 6.2 ;3;50;122;1;2;2;1;1;2;3;0;0
13445; 48.6 ; 194.3 ; 15.1 ;4;28;111;0;4;1;3;2;2;0;3;1
13446; 45.8 ; 91.6 ; 34.3 ;2;35;125;0;2;1;1;1;1;1;0;1
13447; 38.7 ; 193.3 ; 17.4 ;5;41;5;0;5;2;3;2;3;2;1;2
13448; 48.8 ; 146.4 ; 3.5 ;3;59;68;0;3;0;3;3;0;0;3;0
13449; 25.3 ; 126.7 ; 15.7 ;5;7;253;0;5;0;5;2;3;3;2;0
13450; 48.1 ; 96.1 ; 1.9 ;2;58;83;0;2;1;1;1;1;0;2;0
13451; 17.9 ; 160.8 ; 5.0 ;9;22;23;0;9;6;3;9;0;9;0;0
13452; 35.6 ; 462.6 ; 6.7 ;13;15;7;0;13;7;6;3;10;4;9;0
13453; 48.6 ; 243.1 ; 7.0 ;5;2;247;0;5;3;2;1;4;0;3;2
13454; 66.7 ; 333.5 ; 32.2 ;5;29;141;0;5;1;4;5;0;0;0;5
13455; 22.1 ; 110.4 ; 11.5 ;5;23;43;0;5;0;5;1;4;3;2;0
13456; 16.2 ; 81.0 ; 2.9 ;5;13;239;0;5;5;0;4;1;5;0;0
13457; 15.0 ; 45.0 ; -   ;3;11;260;0;3;2;1;1;2;3;0;0
13458; 32.2 ; 257.9 ; 12.1 ;8;15;2;0;8;3;5;1;7;3;5;0
13459; 30.1 ; 150.7 ; 18.3 ;5;32;36;0;5;1;4;1;4;2;3;0
13460; 15.0 ; 479.5 ; -   ;32;12;36;2;30;0;32;9;23;32;0;0
13461; 33.2 ; 265.2 ; 49.7 ;8;19;5;0;8;1;7;5;3;3;2;3
13462; 83.6 ; 167.1 ; -   ;2;14;140;0;2;1;1;2;0;0;0;2
13463; 47.7 ; 143.2 ; 8.9 ;3;5;247;0;3;0;3;2;1;0;2;1
13464; 24.6 ; 98.5 ; 16.2 ;4;9;27;0;4;3;1;3;1;3;1;0
13465; 49.6 ; 99.3 ; 4.3 ;2;17;273;0;2;0;2;1;1;0;2;0
13466; 18.3 ; 55.0 ; 6.2 ;3;22;230;0;3;1;2;1;2;3;0;0
13467; 48.1 ; 240.7 ; 2.9 ;5;21;85;0;5;1;4;5;0;0;5;0
13468; 112.9 ; 338.6 ; 32.8 ;3;17;68;0;3;1;2;3;0;0;0;3
13469; 70.1 ; 490.5 ; 35.3 ;7;20;20;0;7;0;7;7;0;0;0;7
13470; 38.9 ; 77.7 ; 14.7 ;2;49;321;0;2;0;2;0;2;1;1;0
13471; 64.0 ; 127.9 ; 25.8 ;2;179;125;0;2;1;1;2;0;0;0;2
13472; 23.7 ; 71.2 ; 8.7 ;3;45;195;0;3;2;1;1;2;2;1;0
13473; 46.8 ; 93.6 ; 47.6 ;2;20;261;0;2;1;1;1;1;1;0;1
13474; 18.6 ; 74.3 ; -   ;4;102;37;0;4;1;3;2;2;4;0;0
13475; 24.9 ; 124.3 ; 7.1 ;5;41;38;0;5;1;4;0;5;3;2;0
13476; 46.9 ; 234.3 ; 0.3 ;5;71;68;0;5;1;4;4;1;0;5;0
13477; 17.9 ; 304.8 ; 8.2 ;17;13;29;0;17;7;10;10;7;17;0;0
13478; 47.7 ; 143.1 ; 0.4 ;3;4;24;0;3;1;2;1;2;0;3;0
13479; 36.4 ; 109.1 ; 11.9 ;3;68;20;0;3;0;3;1;2;1;2;0
13480; 38.3 ; 115.0 ; 10.4 ;3;26;104;0;3;1;2;1;2;1;2;0
13481; 24.8 ; 74.3 ; 5.7 ;3;63;146;0;3;0;3;0;3;2;1;0
13482; 42.9 ; 85.7 ; -   ;2;1;254;0;2;2;0;1;1;0;2;0
13483; 40.5 ; 81.0 ; 38.2 ;2;31;188;0;2;0;2;2;0;1;0;1
13484; 50.5 ; 202.1 ; 8.3 ;4;21;52;0;4;0;4;3;1;0;3;1
13485; 22.5 ; 67.6 ; 4.2 ;3;5;241;0;3;1;2;1;2;3;0;0
13486; 25.1 ; 50.1 ; -   ;2;24;105;0;2;0;2;1;1;2;0;0
13487; 51.1 ; 255.7 ; 25.0 ;5;19;78;0;5;0;5;3;2;2;1;2
13488; 24.8 ; 446.5 ; 17.2 ;18;18;56;0;18;6;12;11;7;12;6;0
13489; 30.4 ; 91.3 ; 0.4 ;3;115;6;0;3;0;3;2;1;1;2;0
13490; 17.9 ; 107.3 ; 6.1 ;6;7;47;0;6;0;6;2;4;6;0;0
13491; 65.3 ; 261.2 ; 36.3 ;4;49;108;0;4;2;2;1;3;1;0;3
13492; 24.4 ; 121.9 ; 10.8 ;5;23;20;0;5;2;3;3;2;3;2;0
13493; 25.1 ; 50.1 ; -   ;2;20;236;0;2;0;2;1;1;2;0;0
13494; 46.2 ; 231.2 ; 55.7 ;5;52;62;0;5;1;4;2;3;2;1;2
13495; 60.2 ; 1,023.9 ; 28.6 ;17;15;20;0;17;8;9;8;9;0;0;17
13496; 34.8 ; 174.2 ; 8.6 ;5;33;5;0;5;0;5;5;0;2;3;0
13497; 21.2 ; 106.1 ; 14.1 ;5;41;11;5;0;3;2;4;1;3;2;0
13498; 42.4 ; 127.2 ; 11.3 ;3;139;83;0;3;0;3;1;2;0;3;0
13499; 43.3 ; 389.8 ; 13.7 ;9;37;20;0;9;3;6;8;1;3;3;3
13500; 38.8 ; 116.4 ; 12.7 ;3;112;1;0;3;0;3;3;0;1;2;0
13501; 47.2 ; 141.7 ; 0.4 ;3;142;31;0;3;0;3;1;2;0;3;0
13502; 47.7 ; 95.4 ; 1.4 ;2;50;158;1;1;1;1;2;0;0;2;0
13503; 17.1 ; 68.6 ; 2.6 ;4;13;47;4;0;0;4;3;1;4;0;0
13504; 17.6 ; 70.5 ; 5.6 ;4;28;46;0;4;4;0;2;2;4;0;0
13505; 28.5 ; 114.0 ; 12.2 ;4;52;143;0;4;2;2;4;0;3;1;0
13506; 23.2 ; 46.5 ; 2.7 ;2;69;146;1;1;2;0;2;0;2;0;0
13507; 61.7 ; 616.5 ; 16.0 ;10;14;0;5;5;1;9;1;9;0;0;10
13508; 33.7 ; 134.6 ; 19.9 ;4;25;10;0;4;1;3;2;2;1;3;0
13509; 49.1 ; 686.9 ; 30.7 ;14;16;1;0;14;4;10;5;9;5;4;5
13510; 32.5 ; 195.3 ; 26.6 ;6;16;263;0;6;3;3;3;3;2;2;2
13511; 57.7 ; 288.6 ; 17.7 ;5;15;10;0;5;1;4;3;2;0;0;5
13512; 20.7 ; 41.5 ; -   ;2;7;107;0;2;2;0;2;0;2;0;0
13513; 74.7 ; 373.6 ; 46.9 ;5;32;52;2;3;0;5;5;0;2;0;3
13514; 34.8 ; 243.6 ; 13.6 ;7;19;163;0;7;0;7;6;1;2;5;0
13515; 26.8 ; 80.3 ; 3.1 ;3;22;163;0;3;0;3;2;1;3;0;0
13516; 41.3 ; 620.2 ; 12.2 ;15;20;5;0;15;2;13;2;13;5;10;0
13517; 16.1 ; 225.5 ; 3.3 ;14;15;84;3;11;3;11;10;4;14;0;0
13518; 49.5 ; 247.7 ; 27.8 ;5;49;74;0;5;0;5;5;0;2;1;2
13519; 31.7 ; 95.1 ; 15.3 ;3;3;226;0;3;0;3;3;0;1;2;0
13520; 31.8 ; 63.7 ; 25.2 ;2;288;21;0;2;0;2;1;1;1;0;1
13521; 56.2 ; 112.3 ; 29.3 ;2;80;99;0;2;1;1;2;0;1;0;1
13522; 28.4 ; 142.1 ; 14.4 ;5;10;139;0;5;5;0;5;0;3;2;0
13523; 15.0 ; 30.0 ; -   ;2;86;223;0;2;1;1;1;1;2;0;0
13524; 50.2 ; 200.9 ; 4.3 ;4;48;79;0;4;0;4;4;0;0;4;0
13525; 97.4 ; 194.8 ; 75.8 ;2;113;95;0;2;0;2;1;1;1;0;1
13526; 45.6 ; 501.1 ; 5.1 ;11;26;47;0;11;0;11;8;3;0;11;0
13527; 52.3 ; 156.8 ; 4.7 ;3;143;71;2;1;2;1;1;2;0;2;1
13528; 47.0 ; 93.9 ; -   ;2;12;110;1;1;0;2;2;0;0;2;0
13529; 28.7 ; 1,005.3 ; 16.7 ;35;9;2;0;35;16;19;7;28;23;12;0
13530; 39.2 ; 78.3 ; 21.1 ;2;259;83;0;2;1;1;1;1;1;0;1
13531; 24.5 ; 195.8 ; 13.3 ;8;19;5;0;8;1;7;2;6;5;3;0
13532; 29.3 ; 146.7 ; 8.1 ;5;7;5;5;0;1;4;5;0;3;2;0
13533; 25.1 ; 50.1 ; -   ;2;99;47;0;2;0;2;2;0;2;0;0
13534; 36.6 ; 475.6 ; 8.3 ;13;10;131;0;13;1;12;4;9;4;9;0
13535; 41.9 ; 83.7 ; 8.4 ;2;23;62;2;0;1;1;1;1;0;2;0
13536; 65.7 ; 394.5 ; 11.7 ;6;27;47;0;6;0;6;0;6;0;0;6
13537; 16.5 ; 65.9 ; 1.2 ;4;31;132;0;4;2;2;3;1;4;0;0
13538; 28.5 ; 113.8 ; 6.2 ;4;4;38;0;4;3;1;2;2;3;1;0
13539; 24.1 ; 72.4 ; 5.6 ;3;24;11;0;3;0;3;1;2;3;0;0
13540; 35.6 ; 71.1 ; 8.0 ;2;14;268;0;2;1;1;1;1;1;1;0
13541; 27.4 ; 137.1 ; 14.0 ;5;52;155;0;5;2;3;3;2;3;2;0
13542; 30.1 ; 60.1 ; 0.2 ;2;222;5;0;2;1;1;1;1;1;1;0
13543; 38.8 ; 620.2 ; 21.2 ;16;11;79;0;16;7;9;6;10;5;6;5
13544; 29.8 ; 297.9 ; 6.7 ;10;21;8;0;10;7;3;3;7;7;3;0
13545; 15.0 ; 45.0 ; -   ;3;4;251;0;3;2;1;2;1;3;0;0
13546; 34.4 ; 103.3 ; 14.2 ;3;11;248;0;3;2;1;1;2;1;2;0
13547; 28.8 ; 201.7 ; 11.6 ;7;46;50;0;7;5;2;7;0;5;2;0
13548; 63.5 ; 126.9 ; 28.6 ;2;104;131;0;2;1;1;2;0;0;0;2
13549; 25.6 ; 51.2 ; 0.8 ;2;14;303;0;2;1;1;0;2;2;0;0
13550; 48.6 ; 194.2 ; 3.3 ;4;53;26;0;4;2;2;4;0;0;4;0
13551; 29.4 ; 117.7 ; 15.2 ;4;56;59;1;3;2;2;4;0;3;1;0
13552; 39.4 ; 157.6 ; 11.3 ;4;48;115;0;4;0;4;4;0;1;3;0
13553; 47.8 ; 143.5 ; 31.1 ;3;50;132;0;3;1;2;2;1;1;1;1
13554; 55.6 ; 111.2 ; 4.9 ;2;125;110;0;2;0;2;1;1;0;0;2
13555; 20.0 ; 219.7 ; 7.8 ;11;9;0;0;11;0;11;4;7;11;0;0
13556; 59.6 ; 298.1 ; 25.1 ;5;22;188;0;5;0;5;5;0;0;0;5
13557; 35.8 ; 71.7 ; 16.3 ;2;85;160;0;2;1;1;2;0;1;1;0
13558; 26.0 ; 780.0 ; 7.8 ;30;10;5;0;30;16;14;6;24;20;10;0
13559; 143.7 ; 287.4 ; 15.5 ;2;11;51;0;2;2;0;2;0;0;0;2
13560; 51.4 ; 102.9 ; 7.0 ;2;2;260;0;2;1;1;0;2;0;1;1
13561; 48.2 ; 481.9 ; 24.2 ;10;28;5;0;10;1;9;7;3;3;4;3
13562; 24.6 ; 172.0 ; 9.0 ;7;13;135;0;7;4;3;5;2;5;2;0
13563; 53.1 ; 159.4 ; 2.1 ;3;56;165;0;3;3;0;3;0;0;2;1
13564; 39.8 ; 79.6 ; 8.0 ;2;48;80;0;2;1;1;0;2;0;2;0
13565; 68.7 ; 550.0 ; 27.2 ;8;32;183;0;8;0;8;0;8;0;0;8
13566; 35.4 ; 212.2 ; 15.8 ;6;54;8;0;6;5;1;0;6;2;4;0
13567; 45.6 ; 91.1 ; 12.6 ;2;84;13;0;2;1;1;2;0;0;1;1
13568; 55.7 ; 278.5 ; 41.3 ;5;39;93;0;5;3;2;2;3;2;0;3
13569; 30.6 ; 122.5 ; 10.4 ;4;46;26;0;4;1;3;4;0;1;3;0
13570; 33.9 ; 169.4 ; 18.2 ;5;28;47;0;5;2;3;2;3;2;3;0
13571; 56.7 ; 226.7 ; 79.4 ;4;52;141;0;4;3;1;4;0;1;0;3
13572; 53.1 ; 265.4 ; 5.1 ;5;21;221;0;5;3;2;1;4;0;3;2
13573; 20.7 ; 103.7 ; 13.5 ;5;33;131;0;5;2;3;2;3;3;2;0
13574; 25.6 ; 409.1 ; 9.8 ;16;18;113;0;16;10;6;3;13;11;5;0
13575; 19.3 ; 57.8 ; 5.5 ;3;120;62;0;3;0;3;1;2;3;0;0
13576; 32.3 ; 129.0 ; 11.9 ;4;37;7;0;4;3;1;2;2;1;3;0
13577; 37.4 ; 224.2 ; 19.8 ;6;55;127;0;6;3;3;6;0;2;2;2
13578; 58.7 ; 762.5 ; 21.5 ;13;30;11;0;13;3;10;9;4;0;0;13
13579; 34.1 ; 68.2 ; 28.6 ;2;3;68;0;2;1;1;1;1;1;0;1
13580; 38.1 ; 114.2 ; 9.3 ;3;131;46;0;3;2;1;2;1;1;2;0
13581; 47.0 ; 1,079.9 ; 0.4 ;23;16;20;0;23;0;23;23;0;0;23;0
13582; 38.6 ; 115.7 ; 7.9 ;3;2;258;0;3;0;3;1;2;0;3;0
13583; 16.7 ; 83.3 ; 4.4 ;5;79;23;0;5;1;4;5;0;5;0;0
13584; 21.9 ; 197.1 ; 4.4 ;9;27;2;0;9;1;8;4;5;9;0;0
13585; 35.6 ; 142.3 ; 20.8 ;4;13;158;0;4;2;2;3;1;1;2;1
13586; 32.7 ; 65.5 ; 9.9 ;2;67;89;0;2;1;1;1;1;1;1;0
13587; 27.6 ; 55.3 ; 3.8 ;2;24;336;0;2;0;2;2;0;1;1;0
13588; 55.0 ; 274.8 ; 28.0 ;5;20;118;0;5;1;4;3;2;2;1;2
13589; 80.8 ; 242.3 ; 24.3 ;3;2;145;0;3;2;1;1;2;0;0;3
13590; 63.7 ; 318.3 ; 21.4 ;5;60;0;0;5;0;5;5;0;0;0;5
13591; 60.0 ; 120.1 ; 5.3 ;2;38;89;0;2;0;2;1;1;0;0;2
13592; 30.2 ; 60.4 ; -   ;2;8;85;2;0;1;1;1;1;0;2;0
13593; 19.7 ; 39.3 ; -   ;2;23;180;0;2;1;1;0;2;2;0;0
13594; 44.8 ; 179.0 ; 22.4 ;4;38;1;0;4;3;1;4;0;1;2;1
13595; 55.5 ; 166.4 ; 42.9 ;3;16;123;0;3;3;0;0;3;1;0;2
13596; 39.1 ; 274.0 ; 17.2 ;7;30;42;0;7;3;4;6;1;2;3;2
13597; 46.3 ; 92.6 ; 0.7 ;2;6;173;0;2;0;2;1;1;0;2;0
13598; 52.5 ; 262.5 ; 4.1 ;5;40;69;0;5;1;4;3;2;0;3;2
13599; 24.1 ; 746.2 ; 10.5 ;31;10;24;0;31;22;9;21;10;21;10;0
13600; 47.1 ; 94.2 ; 0.5 ;2;26;94;2;0;0;2;2;0;0;2;0
13601; 24.1 ; 890.7 ; 9.3 ;37;11;5;0;37;20;17;27;10;25;12;0
13602; 24.8 ; 74.3 ; 9.0 ;3;5;36;0;3;1;2;2;1;2;1;0
13603; 48.9 ; 97.8 ; 3.2 ;2;16;197;0;2;2;0;0;2;0;2;0
13604; 50.0 ; 99.9 ; 2.6 ;2;94;20;0;2;0;2;2;0;0;2;0
13605; 39.5 ; 158.1 ; 9.0 ;4;48;137;0;4;3;1;2;2;0;4;0
13606; 39.4 ; 78.9 ; 13.9 ;2;11;211;0;2;0;2;2;0;1;1;0
13607; 27.6 ; 55.3 ; 3.8 ;2;10;270;0;2;1;1;1;1;1;1;0
13608; 51.0 ; 407.7 ; 22.1 ;8;23;116;1;7;0;8;6;2;3;2;3
13609; 40.2 ; 120.7 ; 6.7 ;3;44;20;0;3;3;0;1;2;0;3;0
13610; 35.6 ; 142.4 ; 43.6 ;4;5;60;0;4;3;1;1;3;1;2;1
13611; 37.4 ; 336.6 ; 7.7 ;9;6;5;0;9;5;4;6;3;3;6;0
13612; 28.0 ; 56.0 ; 12.4 ;2;5;274;0;2;0;2;1;1;1;1;0
13613; 35.7 ; 427.9 ; 5.9 ;12;25;0;0;12;1;11;6;6;4;8;0
13614; 43.8 ; 87.5 ; 4.5 ;2;58;104;0;2;1;1;1;1;0;2;0
13615; 15.5 ; 46.4 ; 0.9 ;3;18;8;0;3;3;0;3;0;3;0;0
13616; 36.2 ; 144.7 ; 14.5 ;4;37;202;0;4;3;1;2;2;1;3;0
13617; 49.2 ; 245.9 ; 21.3 ;5;26;11;0;5;1;4;4;1;2;1;2
13618; 53.7 ; 214.9 ; 9.6 ;4;49;89;0;4;1;3;1;3;0;3;1
13619; 33.2 ; 166.1 ; 14.2 ;5;91;10;0;5;2;3;1;4;2;3;0
13620; 34.0 ; 170.1 ; 12.7 ;5;25;20;5;0;1;4;4;1;2;3;0
13621; 60.0 ; 120.0 ; 18.8 ;2;7;38;0;2;2;0;0;2;0;0;2
13622; 49.4 ; 247.2 ; 16.4 ;5;47;5;0;5;3;2;3;2;0;3;2
13623; 45.9 ; 91.9 ; 39.3 ;2;18;116;0;2;0;2;2;0;1;0;1
13624; 15.6 ; 77.9 ; 1.6 ;5;29;82;0;5;5;0;5;0;5;0;0
13625; 47.2 ; 141.7 ; 0.4 ;3;34;47;1;2;0;3;2;1;0;3;0
13626; 32.8 ; 163.9 ; 8.0 ;5;29;44;0;5;5;0;2;3;2;3;0
13627; 41.6 ; 208.0 ; 7.3 ;5;74;32;0;5;0;5;3;2;0;5;0
13628; 26.9 ; 188.5 ; 10.4 ;7;45;11;0;7;0;7;4;3;5;2;0
13629; 15.0 ; 30.0 ; -   ;2;153;189;1;1;1;1;2;0;2;0;0
13630; 41.2 ; 82.5 ; 16.9 ;2;30;80;0;2;1;1;0;2;1;0;1
13631; 39.3 ; 117.9 ; 8.9 ;3;100;53;0;3;1;2;3;0;0;3;0
13632; 33.4 ; 66.8 ; 4.8 ;2;4;116;0;2;1;1;2;0;1;1;0
13633; 56.8 ; 113.6 ; 15.0 ;2;62;125;0;2;0;2;1;1;0;0;2
13634; 53.2 ; 319.2 ; 23.1 ;6;41;38;1;5;1;5;3;3;0;4;2
13635; 49.4 ; 197.7 ; 18.4 ;4;9;254;0;4;3;1;1;3;0;3;1
13636; 23.4 ; 70.2 ; 6.3 ;3;4;260;0;3;3;0;1;2;3;0;0
13637; 30.2 ; 90.6 ; -   ;3;53;134;3;0;2;1;3;0;0;3;0
13638; 19.7 ; 295.9 ; 9.2 ;15;23;28;0;15;1;14;9;6;15;0;0
13639; 46.3 ; 92.6 ; 1.8 ;2;6;44;0;2;2;0;0;2;0;2;0
13640; 37.7 ; 376.6 ; 15.6 ;10;17;110;0;10;5;5;1;9;3;7;0
13641; 15.0 ; 45.0 ; -   ;3;4;248;0;3;3;0;3;0;3;0;0
13642; 40.0 ; 239.8 ; 5.7 ;6;27;41;0;6;2;4;3;3;0;6;0
13643; 67.2 ; 1,008.5 ; 30.6 ;15;26;14;0;15;9;6;4;11;0;0;15
13644; 38.7 ; 77.4 ; 13.1 ;2;90;94;0;2;1;1;2;0;1;1;0
13645; 39.0 ; 156.0 ; 16.9 ;4;59;41;0;4;3;1;2;2;1;2;1
13646; 65.8 ; 1,052.9 ; 42.8 ;16;22;11;0;16;5;11;9;7;5;0;11
13647; 20.0 ; 40.1 ; 7.6 ;2;4;354;0;2;1;1;2;0;2;0;0
13648; 27.8 ; 417.6 ; 13.8 ;15;20;2;1;14;8;7;12;3;10;5;0
13649; 27.8 ; 638.5 ; 11.6 ;23;15;23;0;23;15;8;16;7;15;8;0
13650; 45.0 ; 269.9 ; 13.4 ;6;7;183;0;6;0;6;5;1;0;4;2
13651; 15.0 ; 30.0 ; -   ;2;99;84;0;2;1;1;2;0;2;0;0
13652; 37.2 ; 186.2 ; 28.7 ;5;88;36;0;5;3;2;2;3;2;1;2
13653; 15.0 ; 59.9 ; -   ;4;17;30;3;1;3;1;4;0;4;0;0
13654; 19.5 ; 39.0 ; 6.7 ;2;5;200;0;2;0;2;0;2;2;0;0
13655; 38.7 ; 116.1 ; 3.8 ;3;54;173;0;3;2;1;1;2;0;3;0
13656; 24.3 ; 97.0 ; 1.7 ;4;52;111;0;4;3;1;2;2;4;0;0
13657; 20.0 ; 40.1 ; 7.6 ;2;11;72;0;2;2;0;2;0;2;0;0
13658; 16.7 ; 83.3 ; 4.4 ;5;13;5;0;5;1;4;3;2;5;0;0
13659; 15.0 ; 30.0 ; -   ;2;85;140;0;2;2;0;0;2;2;0;0
13660; 15.0 ; 30.0 ; -   ;2;3;117;0;2;2;0;1;1;2;0;0
13661; 21.9 ; 43.9 ; 3.3 ;2;9;251;0;2;1;1;2;0;2;0;0
13662; 31.6 ; 315.6 ; 40.5 ;10;2;3;0;10;7;3;6;4;3;4;3
13663; 29.1 ; 145.7 ; 9.5 ;5;9;208;0;5;4;1;3;2;3;2;0
13664; 74.1 ; 1,112.2 ; 50.4 ;15;17;31;0;15;0;15;11;4;5;0;10
13665; 40.4 ; 201.9 ; 16.0 ;5;26;53;0;5;1;4;2;3;2;1;2
13666; 15.0 ; 119.9 ; -   ;8;18;0;0;8;0;8;5;3;8;0;0
13667; 40.4 ; 202.0 ; 8.2 ;5;17;36;0;5;1;4;1;4;0;5;0
13668; 55.3 ; 221.0 ; 44.8 ;4;21;125;0;4;1;3;1;3;1;0;3
13669; 51.0 ; 102.0 ; 38.8 ;2;75;49;2;0;1;1;1;1;1;0;1
13670; 32.8 ; 65.6 ; 18.5 ;2;275;160;0;2;1;1;1;1;1;1;0
13671; 54.9 ; 988.4 ; 13.9 ;18;9;14;0;18;4;14;13;5;0;12;6
13672; 22.6 ; 45.2 ; 11.4 ;2;24;260;0;2;2;0;0;2;1;1;0
13673; 55.1 ; 551.5 ; 14.4 ;10;32;95;0;10;4;6;4;6;0;0;10
13674; 19.4 ; 97.2 ; 9.0 ;5;54;154;0;5;4;1;5;0;5;0;0
13675; 43.2 ; 216.0 ; 0.5 ;5;32;22;0;5;3;2;3;2;0;5;0
13676; 52.3 ; 418.3 ; 11.8 ;8;32;7;8;0;5;3;1;7;0;5;3
13677; 26.2 ; 131.2 ; 1.3 ;5;77;23;0;5;5;0;1;4;5;0;0
13678; 61.0 ; 488.0 ; 19.3 ;8;29;13;5;3;6;2;4;4;0;0;8
13679; 66.0 ; 131.9 ; 61.2 ;2;10;90;0;2;0;2;2;0;1;0;1
13680; 50.5 ; 151.6 ; 22.8 ;3;40;71;0;3;1;2;2;1;1;1;1
13681; 39.8 ; 119.3 ; 13.5 ;3;58;73;0;3;1;2;3;0;1;2;0
13682; 36.0 ; 1,079.7 ; 15.9 ;30;13;53;0;30;11;19;24;6;10;20;0
13683; 32.1 ; 577.3 ; 22.6 ;18;18;1;0;18;9;9;11;7;6;12;0
13684; 36.6 ; 109.9 ; 19.9 ;3;93;5;0;3;1;2;2;1;1;1;1
13685; 21.4 ; 171.6 ; 10.0 ;8;50;16;0;8;1;7;5;3;5;3;0
13686; 49.9 ; 249.7 ; 18.5 ;5;6;70;0;5;3;2;1;4;0;3;2
13687; 26.7 ; 240.4 ; 6.8 ;9;34;5;0;9;1;8;4;5;6;3;0
13688; 20.2 ; 141.5 ; 4.3 ;7;5;241;0;7;2;5;4;3;7;0;0
13689; 24.8 ; 198.1 ; 13.2 ;8;14;38;0;8;3;5;1;7;5;3;0
13690; 46.2 ; 231.2 ; 18.1 ;5;47;78;0;5;1;4;4;1;2;1;2
13691; 60.2 ; 662.6 ; 38.7 ;11;36;21;0;11;0;11;11;0;4;0;7
13692; 28.7 ; 86.2 ; 3.4 ;3;52;1;0;3;2;1;1;2;2;1;0
13693; 46.8 ; 935.0 ; 2.1 ;20;22;27;0;20;7;13;7;13;0;20;0
13694; 22.3 ; 111.4 ; 14.3 ;5;35;166;0;5;5;0;4;1;3;2;0
13695; 56.8 ; 397.3 ; 27.9 ;7;28;2;0;7;3;4;5;2;2;0;5
13696; 61.4 ; 122.8 ; 5.8 ;2;50;152;0;2;0;2;1;1;0;0;2
13697; 28.8 ; 374.7 ; 13.0 ;13;22;6;0;13;5;8;7;6;9;4;0
13698; 17.8 ; 337.9 ; 6.8 ;19;16;32;0;19;1;18;8;11;19;0;0
13699; 52.7 ; 158.0 ; 10.9 ;3;17;262;0;3;2;1;3;0;0;2;1
13700; 45.7 ; 182.8 ; 21.3 ;4;10;116;4;0;3;1;1;3;1;2;1
13701; 16.8 ; 33.6 ; 2.7 ;2;14;128;0;2;2;0;2;0;2;0;0
13702; 17.0 ; 51.0 ; 1.9 ;3;39;113;0;3;1;2;1;2;3;0;0
13703; 61.1 ; 1,343.4 ; 26.3 ;22;6;5;0;22;6;16;11;11;0;0;22
13704; 22.6 ; 45.2 ; 2.3 ;2;19;173;0;2;0;2;0;2;2;0;0
13705; 74.7 ; 149.3 ; 36.8 ;2;415;11;1;1;0;2;2;0;0;0;2
13706; 30.7 ; 153.6 ; 10.6 ;5;86;10;0;5;3;2;1;4;2;3;0
13707; 38.5 ; 76.9 ; 12.4 ;2;106;272;0;2;0;2;2;0;1;1;0
13708; 122.5 ; 1,102.8 ; 43.7 ;9;15;81;6;3;7;2;3;6;0;0;9
13709; 22.7 ; 250.1 ; 11.9 ;11;41;8;0;11;1;10;4;7;7;4;0
13710; 20.5 ; 123.1 ; 6.1 ;6;13;42;0;6;2;4;2;4;6;0;0
13711; 18.3 ; 55.0 ; 6.2 ;3;50;21;0;3;1;2;3;0;3;0;0
13712; 38.0 ; 76.1 ; 29.1 ;2;14;68;0;2;1;1;2;0;1;0;1
13713; 64.4 ; 128.9 ; 51.3 ;2;200;79;1;1;0;2;1;1;1;0;1
13714; 60.3 ; 120.5 ; 20.2 ;2;71;93;0;2;1;1;2;0;0;0;2
13715; 54.2 ; 434.0 ; 32.3 ;8;17;173;0;8;0;8;8;0;3;2;3
13716; 71.7 ; 860.4 ; 21.5 ;12;9;17;0;12;3;9;8;4;0;0;12
13717; 71.1 ; 142.2 ; 33.5 ;2;26;250;0;2;1;1;2;0;0;0;2
13718; 31.5 ; 157.6 ; 9.4 ;5;23;300;0;5;1;4;3;2;2;3;0
13719; 47.1 ; 282.6 ; 11.4 ;6;37;119;0;6;2;4;4;2;0;4;2
13720; 68.2 ; 341.0 ; 26.8 ;5;18;259;0;5;3;2;3;2;0;0;5
13721; 75.6 ; 453.4 ; 37.9 ;6;37;10;0;6;0;6;4;2;0;0;6
13722; 15.0 ; 59.9 ; -   ;4;10;134;0;4;3;1;2;2;4;0;0
13723; 86.5 ; 173.0 ; 50.9 ;2;68;189;0;2;0;2;2;0;0;0;2
13724; 30.8 ; 554.2 ; 12.5 ;18;23;20;0;18;8;10;3;15;6;12;0
13725; 41.1 ; 411.4 ; 17.7 ;10;41;26;0;10;1;9;10;0;3;4;3
13726; 25.6 ; 76.7 ; 11.4 ;3;92;24;0;3;1;2;1;2;2;1;0
13727; 80.9 ; 485.2 ; 9.1 ;6;26;5;0;6;0;6;5;1;0;0;6
13728; 45.6 ; 136.9 ; 27.1 ;3;7;200;0;3;0;3;3;0;1;1;1
13729; 20.1 ; 200.8 ; 8.6 ;10;21;53;0;10;6;4;10;0;10;0;0
13730; 25.1 ; 50.1 ; -   ;2;5;129;0;2;2;0;1;1;2;0;0
13731; 42.7 ; 128.0 ; 6.4 ;3;14;50;0;3;2;1;2;1;0;3;0
13732; 49.1 ; 245.7 ; 7.0 ;5;77;77;0;5;4;1;0;5;0;3;2
13733; 53.1 ; 212.3 ; 24.2 ;4;41;167;0;4;0;4;3;1;1;2;1
13734; 16.1 ; 32.1 ; 1.6 ;2;390;68;1;1;0;2;2;0;2;0;0
13735; 35.2 ; 1,021.7 ; 30.7 ;29;4;333;0;29;19;10;13;16;10;9;10
13736; 49.3 ; 246.7 ; 25.5 ;5;23;95;0;5;0;5;3;2;2;1;2
13737; 36.4 ; 437.2 ; 32.2 ;12;40;2;0;12;3;9;4;8;4;4;4
13738; 28.9 ; 115.7 ; 21.5 ;4;2;274;0;4;2;2;4;0;3;1;0
13739; 28.5 ; 285.1 ; 14.4 ;10;9;5;0;10;4;6;8;2;7;3;0
13740; 15.5 ; 46.4 ; 0.9 ;3;25;5;0;3;0;3;2;1;3;0;0
13741; 41.2 ; 123.5 ; 10.3 ;3;13;125;0;3;0;3;3;0;0;3;0
13742; 15.0 ; 30.0 ; -   ;2;10;265;0;2;1;1;1;1;2;0;0
13743; 23.3 ; 70.0 ; 8.1 ;3;9;168;0;3;1;2;2;1;2;1;0
13744; 47.2 ; 141.7 ; 0.4 ;3;146;29;0;3;2;1;1;2;0;3;0
13745; 36.4 ; 181.9 ; 9.9 ;5;64;4;0;5;5;0;0;5;2;3;0
13746; 43.6 ; 305.3 ; 17.0 ;7;61;47;0;7;1;6;3;4;2;3;2
13747; 44.2 ; 574.5 ; 11.0 ;13;38;15;0;13;1;12;10;3;0;9;4
13748; 18.7 ; 149.9 ; 5.2 ;8;41;0;0;8;4;4;0;8;8;0;0
13749; 40.2 ; 161.0 ; 27.5 ;4;36;293;0;4;0;4;3;1;1;2;1
13750; 47.1 ; 94.2 ; 0.5 ;2;227;47;0;2;0;2;2;0;0;2;0
13751; 46.8 ; 140.3 ; -   ;3;20;260;0;3;1;2;1;2;0;3;0
13752; 55.8 ; 167.5 ; 1.8 ;3;117;110;0;3;0;3;2;1;0;0;3
13753; 16.7 ; 100.3 ; 2.5 ;6;21;157;0;6;0;6;4;2;6;0;0
13754; 21.7 ; 65.1 ; 6.2 ;3;21;41;0;3;3;0;3;0;3;0;0
13755; 36.2 ; 217.0 ; 12.5 ;6;54;59;0;6;3;3;1;5;2;4;0
13756; 18.2 ; 164.2 ; 3.2 ;9;20;116;0;9;4;5;4;5;9;0;0
13757; 51.6 ; 154.7 ; 7.2 ;3;56;168;0;3;0;3;3;0;0;2;1
13758; 22.9 ; 91.6 ; 4.6 ;4;61;15;0;4;0;4;3;1;4;0;0
13759; 16.8 ; 33.6 ; 2.7 ;2;41;269;0;2;0;2;2;0;2;0;0
13760; 33.1 ; 99.4 ; 13.6 ;3;92;116;0;3;0;3;3;0;1;2;0
13761; 44.4 ; 577.0 ; 11.6 ;13;23;0;0;13;4;9;4;9;0;9;4
13762; 22.5 ; 45.0 ; 3.8 ;2;236;52;0;2;1;1;2;0;2;0;0
13763; 46.2 ; 693.0 ; 15.7 ;15;18;11;0;15;5;10;3;12;0;10;5
13764; 30.8 ; 154.1 ; 17.0 ;5;22;14;0;5;1;4;3;2;2;3;0
13765; 18.6 ; 37.2 ; -   ;2;221;83;0;2;0;2;0;2;2;0;0
13766; 46.9 ; 281.6 ; 29.7 ;6;36;68;0;6;1;5;6;0;2;2;2
13767; 15.0 ; 30.0 ; -   ;2;136;62;0;2;1;1;2;0;2;0;0
13768; 39.7 ; 79.5 ; 4.7 ;2;19;178;0;2;0;2;2;0;0;2;0
13769; 23.1 ; 69.3 ; 6.5 ;3;23;239;0;3;1;2;1;2;3;0;0
13770; 80.5 ; 241.6 ; 59.7 ;3;63;20;0;3;0;3;1;2;1;0;2
13771; 21.7 ; 195.3 ; 7.6 ;9;28;10;0;9;2;7;5;4;9;0;0
13772; 24.3 ; 72.9 ; 9.2 ;3;5;108;0;3;2;1;1;2;2;1;0
13773; 42.5 ; 85.1 ; 9.2 ;2;140;116;0;2;1;1;2;0;0;2;0
13774; 24.1 ; 192.4 ; 9.7 ;8;6;233;0;8;4;4;6;2;5;3;0
13775; 44.9 ; 224.7 ; 34.3 ;5;16;285;0;5;4;1;1;4;2;1;2
13776; 15.9 ; 222.9 ; 4.0 ;14;21;14;0;14;2;12;8;6;14;0;0
13777; 15.0 ; 30.0 ; -   ;2;54;119;0;2;1;1;2;0;2;0;0
13778; 34.1 ; 68.2 ; 21.9 ;2;68;273;0;2;0;2;2;0;1;0;1
13779; 36.6 ; 73.2 ; -   ;2;77;324;0;2;1;1;1;1;0;2;0
13780; 43.8 ; 568.9 ; 21.5 ;13;33;7;0;13;10;3;1;12;4;5;4
13781; 63.5 ; 126.9 ; 22.1 ;2;320;7;0;2;2;0;1;1;0;0;2
13782; 19.7 ; 137.9 ; 3.8 ;7;31;83;0;7;4;3;3;4;7;0;0
13783; 33.2 ; 99.7 ; 6.2 ;3;27;6;0;3;1;2;0;3;1;2;0
13784; 34.2 ; 102.6 ; 3.0 ;3;7;11;3;0;1;2;1;2;0;3;0
13785; 16.5 ; 33.0 ; 2.3 ;2;17;52;2;0;1;1;1;1;2;0;0
13786; 44.6 ; 222.8 ; 15.9 ;5;58;15;0;5;0;5;3;2;2;1;2
13787; 47.3 ; 94.7 ; 15.2 ;2;201;93;0;2;2;0;1;1;0;1;1
13788; 50.7 ; 760.4 ; 21.1 ;15;8;237;0;15;4;11;11;4;5;5;5
13789; 65.8 ; 131.5 ; 26.3 ;2;178;0;0;2;1;1;0;2;0;0;2
13790; 65.0 ; 909.9 ; 16.3 ;14;19;2;0;14;2;12;7;7;0;0;14
13791; 82.1 ; 492.8 ; 18.3 ;6;8;239;0;6;2;4;1;5;0;0;6
13792; 53.9 ; 215.5 ; 11.1 ;4;82;142;0;4;1;3;4;0;0;3;1
13793; 15.5 ; 77.3 ; 1.2 ;5;20;197;0;5;4;1;1;4;5;0;0
13794; 22.3 ; 89.0 ; 6.3 ;4;29;22;1;3;0;4;2;2;4;0;0
13795; 23.7 ; 94.8 ; 10.0 ;4;49;115;1;3;0;4;1;3;3;1;0
13796; 25.1 ; 75.2 ; -   ;3;50;270;0;3;3;0;0;3;3;0;0
13797; 95.4 ; 190.9 ; 2.9 ;2;85;140;0;2;1;1;1;1;0;0;2
13798; 15.0 ; 30.0 ; -   ;2;158;20;2;0;0;2;2;0;2;0;0
13799; 51.2 ; 102.4 ; 2.5 ;2;7;132;0;2;1;1;0;2;0;2;0
13800; 40.0 ; 159.8 ; 38.1 ;4;17;74;0;4;1;3;1;3;1;2;1
13801; 22.6 ; 67.9 ; 7.0 ;3;23;133;0;3;2;1;2;1;3;0;0
13802; 45.9 ; 229.5 ; 33.5 ;5;32;84;0;5;0;5;2;3;2;1;2
13803; 41.0 ; 369.2 ; 10.1 ;9;28;52;0;9;0;9;7;2;0;9;0
13804; 29.8 ; 89.5 ; 8.7 ;3;14;328;0;3;3;0;1;2;2;1;0
13805; 32.1 ; 64.2 ; 10.5 ;2;319;5;1;1;1;1;2;0;1;1;0
13806; 52.4 ; 419.2 ; 9.6 ;8;28;5;0;8;0;8;7;1;0;5;3
13807; 41.7 ; 83.4 ; 7.6 ;2;116;158;0;2;1;1;2;0;0;2;0
13808; 24.1 ; 120.7 ; 9.1 ;5;27;23;0;5;4;1;2;3;3;2;0
13809; 53.4 ; 160.3 ; 6.1 ;3;59;131;0;3;0;3;1;2;0;2;1
13810; 30.8 ; 61.7 ; 8.6 ;2;154;31;2;0;1;1;2;0;1;1;0
13811; 55.9 ; 223.6 ; 15.6 ;4;27;205;0;4;1;3;2;2;0;0;4
13812; 32.2 ; 225.5 ; 11.4 ;7;38;35;0;7;4;3;3;4;2;5;0
13813; 26.7 ; 106.6 ; 18.3 ;4;17;220;0;4;1;3;3;1;3;1;0
13814; 24.5 ; 122.6 ; 15.0 ;5;80;5;4;1;1;4;4;1;3;2;0
13815; 43.6 ; 435.7 ; 18.4 ;10;26;78;0;10;2;8;8;2;3;4;3
13816; 45.9 ; 183.5 ; 12.7 ;4;32;89;0;4;0;4;3;1;0;3;1
13817; 47.1 ; 94.3 ; 10.1 ;2;5;263;0;2;0;2;0;2;0;1;1
13818; 30.8 ; 154.1 ; 9.4 ;5;31;2;0;5;3;2;3;2;2;3;0
13819; 23.0 ; 321.7 ; 10.4 ;14;29;12;0;14;9;5;7;7;9;5;0
13820; 22.6 ; 45.2 ; 11.4 ;2;52;218;0;2;1;1;2;0;1;1;0
13821; 49.9 ; 99.7 ; 1.7 ;2;14;255;0;2;1;1;2;0;0;2;0
13822; 36.1 ; 108.3 ; 14.5 ;3;47;250;0;3;3;0;3;0;1;2;0
13823; 16.6 ; 216.2 ; 5.7 ;13;19;101;0;13;5;8;3;10;13;0;0
13824; 34.8 ; 522.5 ; 5.6 ;15;18;21;0;15;7;8;8;7;5;10;0
13825; 39.3 ; 471.6 ; 5.6 ;12;18;53;6;6;3;9;3;9;0;12;0
13826; 47.0 ; 141.1 ; 44.8 ;3;84;44;0;3;1;2;1;2;1;1;1
13827; 53.5 ; 160.4 ; 5.5 ;3;41;47;3;0;0;3;3;0;0;2;1
13828; 60.8 ; 121.6 ; 49.0 ;2;95;73;2;0;0;2;2;0;1;0;1
13829; 18.5 ; 92.7 ; 3.2 ;5;41;2;0;5;4;1;2;3;5;0;0
13830; 30.2 ; 211.6 ; 9.2 ;7;21;71;0;7;5;2;3;4;2;5;0
13831; 15.9 ; 95.2 ; 2.4 ;6;16;92;0;6;3;3;2;4;6;0;0
13832; 41.7 ; 166.6 ; 6.2 ;4;53;87;0;4;1;3;2;2;0;4;0
13833; 42.6 ; 85.3 ; 9.1 ;2;12;200;0;2;0;2;1;1;0;2;0
13834; 50.6 ; 303.7 ; 14.1 ;6;43;14;0;6;3;3;1;5;0;4;2
13835; 46.8 ; 93.5 ; -   ;2;25;105;0;2;0;2;0;2;0;2;0
13836; 36.7 ; 991.0 ; 17.0 ;27;12;6;0;27;4;23;17;10;9;18;0
13837; 30.4 ; 60.9 ; 9.2 ;2;6;42;0;2;0;2;0;2;1;1;0
13838; 53.6 ; 214.2 ; 8.3 ;4;17;160;0;4;4;0;2;2;0;3;1
13839; 16.8 ; 33.6 ; 2.7 ;2;32;53;2;0;0;2;1;1;2;0;0
13840; 27.0 ; 108.1 ; 17.9 ;4;17;100;0;4;2;2;3;1;3;1;0
13841; 46.3 ; 648.7 ; 32.0 ;14;18;89;0;14;2;12;9;5;5;4;5
13842; 44.8 ; 89.6 ; 2.9 ;2;18;330;0;2;0;2;2;0;0;2;0
13843; 34.2 ; 102.6 ; 8.6 ;3;126;47;0;3;0;3;3;0;1;2;0
13844; 18.9 ; 207.7 ; 5.3 ;11;29;0;4;7;4;7;9;2;11;0;0
13845; 30.2 ; 60.4 ; -   ;2;13;292;0;2;2;0;2;0;0;2;0
13846; 24.8 ; 645.8 ; 13.4 ;26;5;51;0;26;14;12;12;14;17;9;0
13847; 39.9 ; 79.7 ; 14.5 ;2;12;120;1;1;0;2;1;1;1;1;0
13848; 28.9 ; 57.7 ; 11.9 ;2;22;22;0;2;1;1;1;1;1;1;0
13849; 45.2 ; 769.0 ; 28.3 ;17;18;5;0;17;7;10;17;0;6;5;6
13850; 46.8 ; 140.3 ; -   ;3;13;199;0;3;0;3;3;0;0;3;0
13851; 28.2 ; 56.3 ; 3.0 ;2;60;23;0;2;1;1;0;2;1;1;0
13852; 23.1 ; 184.9 ; 12.3 ;8;10;2;0;8;5;3;2;6;5;3;0
13853; 52.9 ; 158.8 ; 44.0 ;3;68;283;0;3;0;3;3;0;1;1;1
13854; 95.3 ; 666.9 ; 62.1 ;7;23;140;0;7;7;0;0;7;0;0;7
13855; 33.9 ; 814.6 ; 19.4 ;24;17;31;0;24;14;10;14;10;8;16;0
13856; 16.5 ; 33.0 ; 2.3 ;2;11;68;0;2;1;1;0;2;2;0;0
13857; 84.1 ; 588.7 ; 57.7 ;7;43;36;0;7;1;6;3;4;2;0;5
13858; 95.6 ; 191.3 ; 35.6 ;2;3;268;0;2;1;1;1;1;0;0;2
13859; 68.8 ; 206.3 ; 37.0 ;3;94;152;0;3;0;3;3;0;0;0;3
13860; 53.9 ; 161.6 ; 45.1 ;3;73;113;0;3;3;0;1;2;1;1;1
13861; 33.4 ; 66.8 ; 4.8 ;2;15;136;0;2;1;1;0;2;1;1;0
13862; 47.7 ; 95.5 ; 1.5 ;2;173;99;0;2;1;1;1;1;0;2;0
13863; 33.6 ; 167.9 ; 2.0 ;5;41;208;0;5;1;4;2;3;0;5;0
13864; 23.0 ; 46.0 ; 2.9 ;2;56;185;0;2;2;0;0;2;2;0;0
13865; 23.2 ; 46.4 ; 12.3 ;2;51;23;0;2;2;0;1;1;1;1;0
13866; 25.8 ; 128.8 ; 13.3 ;5;59;37;0;5;2;3;3;2;3;2;0
13867; 56.3 ; 225.4 ; 16.6 ;4;16;63;0;4;0;4;2;2;0;0;4
13868; 42.0 ; 84.1 ; 8.1 ;2;110;30;0;2;1;1;0;2;0;2;0
13869; 42.5 ; 170.1 ; 16.9 ;4;30;137;4;0;1;3;4;0;1;2;1
13870; 38.2 ; 114.6 ; 8.5 ;3;56;71;0;3;1;2;1;2;1;2;0
13871; 15.0 ; 89.9 ; -   ;6;27;5;0;6;1;5;6;0;6;0;0
13872; 37.6 ; 188.1 ; 6.9 ;5;31;17;0;5;0;5;3;2;0;5;0
13873; 19.2 ; 442.6 ; 7.0 ;23;15;10;0;23;10;13;11;12;23;0;0
13874; 77.6 ; 155.2 ; 50.5 ;2;31;11;2;0;0;2;0;2;1;0;1
13875; 25.1 ; 50.1 ; -   ;2;390;58;0;2;0;2;0;2;2;0;0
13876; 23.2 ; 370.6 ; 10.6 ;16;17;68;0;16;12;4;11;5;11;5;0
13877; 50.9 ; 101.9 ; 19.0 ;2;6;178;0;2;0;2;2;0;0;1;1
13878; 25.6 ; 76.7 ; 11.4 ;3;95;57;0;3;2;1;1;2;2;1;0
13879; 54.0 ; 378.0 ; 11.6 ;7;43;23;0;7;2;5;5;2;0;5;2
13880; 29.8 ; 149.0 ; 18.5 ;5;26;142;0;5;0;5;3;2;3;2;0
13881; 21.9 ; 219.4 ; 10.4 ;10;13;238;0;10;7;3;10;0;7;3;0
13882; 58.4 ; 1,167.1 ; 19.0 ;20;17;0;0;20;0;20;12;8;0;0;20
13883; 46.9 ; 93.8 ; 2.7 ;2;2;362;0;2;0;2;0;2;0;2;0
13884; 85.7 ; 171.4 ; 24.4 ;2;43;125;0;2;0;2;1;1;0;0;2
13885; 48.5 ; 291.0 ; 15.4 ;6;35;6;0;6;2;4;4;2;0;4;2
13886; 22.6 ; 90.2 ; 5.3 ;4;35;174;0;4;1;3;4;0;4;0;0
13887; 23.1 ; 92.3 ; 2.4 ;4;54;0;0;4;0;4;4;0;4;0;0
13888; 48.5 ; 436.1 ; 1.8 ;9;23;2;0;9;3;6;8;1;0;9;0
13889; 17.1 ; 34.3 ; 3.2 ;2;9;86;0;2;1;1;1;1;2;0;0
13890; 22.7 ; 227.5 ; 8.1 ;10;8;12;0;10;9;1;9;1;7;3;0
13891; 45.2 ; 632.5 ; 10.2 ;14;23;10;0;14;0;14;5;9;0;9;5
13892; 53.9 ; 269.3 ; 13.1 ;5;24;165;5;0;5;0;0;5;0;3;2
13893; 40.7 ; 163.0 ; 11.6 ;4;28;99;0;4;1;3;4;0;1;3;0
13894; 45.2 ; 1,627.0 ; 14.6 ;36;8;2;0;36;16;20;17;19;0;24;12
13895; 47.7 ; 190.8 ; 13.1 ;4;29;294;0;4;1;3;3;1;0;3;1
13896; 16.2 ; 178.6 ; 4.6 ;11;23;20;0;11;7;4;9;2;11;0;0
13897; 39.4 ; 196.8 ; 7.2 ;5;29;18;0;5;4;1;3;2;0;5;0
13898; 42.6 ; 85.3 ; 9.1 ;2;79;203;0;2;1;1;1;1;0;2;0
13899; 50.4 ; 302.7 ; 3.1 ;6;52;5;0;6;2;4;4;2;0;6;0
13900; 42.0 ; 209.8 ; 11.4 ;5;30;24;0;5;4;1;1;4;0;5;0
13901; 25.8 ; 51.6 ; 16.2 ;2;87;12;0;2;1;1;0;2;1;1;0
13902; 15.0 ; 74.9 ; -   ;5;17;248;0;5;1;4;0;5;5;0;0
13903; 26.1 ; 130.7 ; -   ;5;24;190;0;5;2;3;3;2;5;0;0
13904; 28.4 ; 85.1 ; 5.3 ;3;29;112;0;3;3;0;3;0;2;1;0
13905; 88.0 ; 176.1 ; 52.1 ;2;26;69;0;2;1;1;1;1;0;0;2
13906; 47.0 ; 141.0 ; 0.4 ;3;88;100;0;3;0;3;3;0;0;3;0
13907; 18.3 ; 55.0 ; 6.2 ;3;144;4;0;3;2;1;1;2;3;0;0
13908; 57.8 ; 288.9 ; 19.1 ;5;33;74;0;5;2;3;3;2;0;0;5
13909; 43.3 ; 86.5 ; 13.9 ;2;81;209;0;2;0;2;1;1;1;0;1
13910; 56.2 ; 168.6 ; 3.1 ;3;108;42;0;3;2;1;0;3;0;0;3
13911; 39.5 ; 750.8 ; 11.9 ;19;10;71;0;19;4;15;2;17;6;13;0
13912; 54.4 ; 1,033.9 ; 12.6 ;19;16;77;0;19;9;10;4;15;0;13;6
13913; 15.0 ; 45.0 ; -   ;3;2;85;0;3;2;1;3;0;3;0;0
13914; 18.7 ; 74.9 ; 7.9 ;4;40;1;0;4;1;3;4;0;4;0;0
13915; 49.2 ; 98.3 ; 3.6 ;2;11;304;0;2;1;1;0;2;0;2;0
13916; 51.1 ; 102.3 ; 16.6 ;2;68;215;0;2;1;1;2;0;0;1;1
13917; 86.6 ; 952.9 ; 15.5 ;11;28;16;0;11;1;10;7;4;0;0;11
13918; 64.4 ; 128.9 ; 51.3 ;2;29;38;0;2;0;2;0;2;1;0;1
13919; 42.2 ; 211.0 ; 10.1 ;5;77;74;0;5;1;4;4;1;0;5;0
13920; 54.1 ; 216.3 ; 28.8 ;4;146;0;1;3;2;2;3;1;1;2;1
13921; 15.0 ; 30.0 ; -   ;2;8;122;0;2;2;0;1;1;2;0;0
13922; 45.1 ; 135.2 ; 3.8 ;3;48;94;0;3;1;2;1;2;0;3;0
13923; 61.7 ; 185.0 ; -   ;3;13;5;0;3;0;3;2;1;0;0;3
13924; 46.8 ; 93.5 ; -   ;2;101;283;0;2;0;2;2;0;0;2;0
13925; 26.8 ; 80.5 ; 19.0 ;3;49;68;0;3;2;1;1;2;2;1;0
13926; 24.4 ; 928.3 ; 7.4 ;38;5;0;1;37;18;20;15;23;25;13;0
13927; 19.3 ; 135.1 ; 4.1 ;7;20;10;7;0;3;4;4;3;7;0;0
13928; 41.2 ; 123.7 ; 10.1 ;3;18;125;0;3;1;2;2;1;0;3;0
13929; 47.5 ; 95.0 ; 16.3 ;2;18;0;0;2;0;2;0;2;0;1;1
13930; 84.0 ; 168.0 ; 52.9 ;2;109;116;0;2;1;1;1;1;0;0;2
13931; 58.0 ; 116.0 ; 22.7 ;2;37;116;0;2;0;2;2;0;0;0;2
13932; 46.8 ; 140.5 ; 16.7 ;3;104;36;2;1;0;3;3;0;0;2;1
13933; 46.8 ; 93.5 ; -   ;2;177;136;0;2;0;2;1;1;0;2;0
13934; 58.2 ; 756.4 ; 23.0 ;13;21;5;0;13;3;10;4;9;0;0;13
13935; 56.2 ; 562.1 ; 6.8 ;10;31;6;0;10;2;8;5;5;0;0;10
13936; 43.9 ; 219.6 ; 17.3 ;5;48;26;0;5;1;4;2;3;2;1;2
13937; 97.3 ; 389.3 ; 71.4 ;4;35;173;0;4;0;4;4;0;1;0;3
13938; 26.5 ; 53.0 ; -   ;2;18;53;0;2;0;2;0;2;2;0;0
13939; 80.5 ; 161.0 ; 4.6 ;2;53;172;0;2;1;1;2;0;0;0;2
13940; 19.9 ; 39.9 ; -   ;2;44;236;0;2;0;2;2;0;2;0;0
13941; 39.6 ; 79.1 ; 12.9 ;2;6;13;2;0;2;0;0;2;1;1;0
13942; 24.3 ; 145.6 ; 11.5 ;6;7;233;0;6;3;3;5;1;4;2;0
13943; 35.3 ; 70.5 ; 30.4 ;2;7;184;0;2;0;2;2;0;1;0;1
13944; 37.6 ; 414.0 ; 13.8 ;11;23;16;0;11;1;10;3;8;4;7;0
13945; 26.7 ; 80.1 ; 11.7 ;3;36;43;0;3;0;3;1;2;2;1;0
13946; 32.7 ; 163.7 ; 16.7 ;5;50;147;0;5;1;4;0;5;2;3;0
13947; 50.3 ; 251.4 ; 12.4 ;5;22;16;0;5;0;5;2;3;0;3;2
13948; 20.1 ; 60.4 ; 5.7 ;3;14;77;0;3;3;0;3;0;3;0;0
13949; 21.3 ; 63.8 ; 8.4 ;3;103;92;0;3;3;0;2;1;3;0;0
13950; 68.0 ; 408.0 ; 27.4 ;6;31;69;0;6;2;4;1;5;0;0;6
13951; 30.2 ; 90.6 ; -   ;3;45;102;1;2;3;0;1;2;0;3;0
13952; 55.3 ; 221.0 ; 2.5 ;4;88;26;1;3;1;3;3;1;0;0;4
13953; 46.8 ; 93.5 ; -   ;2;18;252;0;2;0;2;2;0;0;2;0
13954; 58.9 ; 117.7 ; 36.6 ;2;139;42;1;1;0;2;1;1;1;0;1
13955; 29.2 ; 175.2 ; 15.6 ;6;47;38;0;6;1;5;2;4;4;2;0
13956; 22.6 ; 158.4 ; 5.1 ;7;43;12;0;7;3;4;1;6;7;0;0
13957; 15.3 ; 122.6 ; 1.1 ;8;38;6;0;8;5;3;8;0;8;0;0
13958; 40.6 ; 203.1 ; 4.8 ;5;33;31;0;5;2;3;4;1;0;5;0
13959; 32.2 ; 419.2 ; 12.9 ;13;18;80;0;13;9;4;10;3;4;9;0
13960; 17.6 ; 123.0 ; 3.8 ;7;38;52;0;7;0;7;2;5;7;0;0
13961; 63.4 ; 126.9 ; 23.9 ;2;42;0;0;2;0;2;1;1;0;0;2
13962; 38.6 ; 655.6 ; 10.6 ;17;20;4;1;16;8;9;7;10;6;11;0
13963; 20.2 ; 121.3 ; 9.7 ;6;49;23;0;6;6;0;3;3;6;0;0
13964; 54.2 ; 1,138.5 ; 12.7 ;21;21;5;0;21;11;10;11;10;0;14;7
13965; 27.5 ; 55.0 ; 13.4 ;2;138;85;0;2;0;2;0;2;1;1;0
13966; 57.6 ; 345.6 ; 14.1 ;6;41;68;0;6;1;5;3;3;0;0;6
13967; 20.5 ; 205.2 ; 11.3 ;10;48;32;0;10;4;6;6;4;7;3;0
13968; 24.1 ; 48.3 ; 2.2 ;2;104;147;0;2;1;1;0;2;2;0;0
13969; 35.8 ; 430.1 ; 20.9 ;12;27;68;0;12;2;10;10;2;4;4;4
13970; 35.5 ; 639.2 ; 5.1 ;18;16;2;0;18;5;13;3;15;0;18;0
13971; 38.0 ; 189.8 ; 14.4 ;5;93;68;0;5;2;3;2;3;2;3;0
13972; 25.1 ; 50.1 ; -   ;2;117;168;0;2;1;1;0;2;2;0;0
13973; 44.5 ; 222.7 ; 14.3 ;5;11;152;0;5;2;3;1;4;0;3;2
13974; 63.8 ; 191.3 ; 27.4 ;3;44;188;0;3;0;3;1;2;0;0;3
13975; 65.1 ; 130.1 ; 59.9 ;2;5;253;0;2;0;2;2;0;1;0;1
13976; 30.9 ; 61.7 ; 23.8 ;2;71;272;0;2;1;1;1;1;1;1;0
13977; 22.4 ; 44.7 ; 4.6 ;2;48;244;0;2;1;1;2;0;2;0;0
13978; 15.0 ; 45.0 ; -   ;3;86;95;0;3;1;2;1;2;3;0;0
13979; 86.9 ; 434.4 ; 45.7 ;5;23;259;0;5;2;3;1;4;0;0;5
13980; 51.4 ; 102.9 ; 7.0 ;2;45;110;1;1;1;1;1;1;0;1;1
13981; 63.8 ; 255.2 ; 13.4 ;4;66;183;0;4;0;4;2;2;0;0;4
13982; 18.3 ; 91.7 ; 5.5 ;5;20;232;0;5;3;2;4;1;5;0;0
13983; 42.9 ; 128.6 ; -   ;3;27;204;0;3;1;2;3;0;0;3;0
13984; 46.8 ; 93.5 ; -   ;2;13;199;2;0;0;2;2;0;0;2;0
13985; 21.8 ; 304.6 ; 6.8 ;14;17;71;0;14;9;5;14;0;14;0;0
13986; 42.0 ; 210.0 ; 37.2 ;5;14;340;0;5;1;4;3;2;2;1;2
13987; 51.6 ; 103.2 ; 13.1 ;2;13;149;0;2;2;0;1;1;0;1;1
13988; 21.1 ; 105.3 ; 8.8 ;5;27;95;0;5;0;5;2;3;5;0;0
13989; 33.0 ; 66.1 ; 20.5 ;2;19;272;0;2;0;2;2;0;1;1;0
13990; 15.0 ; 45.0 ; -   ;3;83;95;0;3;1;2;2;1;3;0;0
13991; 52.4 ; 209.6 ; 34.7 ;4;91;68;0;4;1;3;2;2;1;2;1
13992; 30.8 ; 123.3 ; 16.0 ;4;70;31;0;4;2;2;1;3;1;3;0
13993; 30.8 ; 61.7 ; 8.6 ;2;68;26;2;0;0;2;2;0;1;1;0
13994; 36.1 ; 361.4 ; 16.3 ;10;39;69;0;10;0;10;7;3;3;7;0
13995; 42.9 ; 171.4 ; -   ;4;41;143;0;4;1;3;2;2;0;4;0
13996; 23.7 ; 189.5 ; 12.6 ;8;16;8;0;8;3;5;1;7;5;3;0
13997; 18.2 ; 36.4 ; 1.6 ;2;130;146;0;2;1;1;1;1;2;0;0
13998; 29.1 ; 145.7 ; 25.1 ;5;29;155;0;5;3;2;3;2;3;2;0
13999; 25.0 ; 49.9 ; 7.5 ;2;9;257;0;2;1;1;1;1;1;1;0
14000; 16.8 ; 67.2 ; 2.2 ;4;53;15;0;4;0;4;2;2;4;0;0
14001; 53.5 ; 481.9 ; 17.2 ;9;35;11;0;9;4;5;6;3;0;6;3
14002; 26.9 ; 80.8 ; 14.7 ;3;177;40;0;3;2;1;1;2;2;1;0
14003; 20.3 ; 40.7 ; 7.1 ;2;50;224;0;2;2;0;2;0;2;0;0
14004; 39.2 ; 235.3 ; 27.5 ;6;30;73;0;6;2;4;4;2;2;2;2
14005; 129.4 ; 258.8 ; 53.8 ;2;16;269;0;2;1;1;1;1;0;0;2
14006; 68.3 ; 136.6 ; 13.9 ;2;72;161;0;2;1;1;0;2;0;0;2
14007; 41.1 ; 615.8 ; 19.4 ;15;19;0;0;15;6;9;7;8;5;5;5
14008; 38.9 ; 116.8 ; 4.3 ;3;16;71;3;0;1;2;1;2;0;3;0
14009; 18.5 ; 74.0 ; 2.5 ;4;36;148;0;4;1;3;2;2;4;0;0
14010; 58.9 ; 176.8 ; 32.1 ;3;37;96;0;3;1;2;3;0;1;0;2
14011; 67.9 ; 339.7 ; 10.2 ;5;46;5;0;5;1;4;5;0;0;0;5
14012; 16.9 ; 33.7 ; -   ;2;24;176;0;2;2;0;0;2;2;0;0
14013; 74.7 ; 149.4 ; 74.3 ;2;176;5;0;2;0;2;2;0;1;0;1
14014; 24.0 ; 240.1 ; 10.5 ;10;41;57;0;10;3;7;2;8;7;3;0
14015; 19.9 ; 119.3 ; 12.9 ;6;12;32;6;0;2;4;2;4;4;2;0
14016; 46.8 ; 93.5 ; -   ;2;30;252;0;2;0;2;2;0;0;2;0
14017; 47.3 ; 425.7 ; 26.3 ;9;22;236;0;9;2;7;5;4;3;3;3
14018; 32.7 ; 163.3 ; 20.8 ;5;62;5;0;5;1;4;3;2;2;3;0
14019; 18.8 ; 75.1 ; 8.0 ;4;21;48;0;4;1;3;2;2;4;0;0
14020; 53.4 ; 160.3 ; 1.7 ;3;49;200;0;3;0;3;2;1;0;2;1
14021; 33.9 ; 101.6 ; 8.3 ;3;82;121;0;3;0;3;2;1;1;2;0
14022; 43.7 ; 306.1 ; 16.2 ;7;22;40;0;7;1;6;4;3;2;3;2
14023; 22.9 ; 91.6 ; 10.9 ;4;62;117;0;4;1;3;0;4;3;1;0
14024; 51.4 ; 205.7 ; 2.8 ;4;77;31;0;4;0;4;4;0;0;4;0
14025; 20.5 ; 41.1 ; 8.3 ;2;26;31;0;2;0;2;1;1;2;0;0
14026; 38.8 ; 77.7 ; 12.9 ;2;3;62;0;2;1;1;1;1;1;1;0
14027; 54.5 ; 381.7 ; 31.8 ;7;38;63;0;7;0;7;5;2;2;3;2
14028; 38.3 ; 306.3 ; 21.2 ;8;28;47;0;8;0;8;7;1;3;2;3
14029; 15.0 ; 30.0 ; -   ;2;7;200;1;1;0;2;0;2;2;0;0
14030; 15.0 ; 45.0 ; -   ;3;24;0;0;3;1;2;1;2;3;0;0
14031; 23.0 ; 230.1 ; 6.4 ;10;34;2;0;10;5;5;7;3;10;0;0
14032; 46.8 ; 93.5 ; -   ;2;50;289;0;2;0;2;1;1;0;2;0
14033; 63.0 ; 126.0 ; 16.9 ;2;1;28;2;0;2;0;0;2;0;0;2
14034; 41.7 ; 83.4 ; 7.6 ;2;33;241;0;2;1;1;1;1;0;2;0
14035; 20.0 ; 220.3 ; 5.6 ;11;20;10;2;9;4;7;4;7;11;0;0
14036; 58.8 ; 293.9 ; 8.5 ;5;3;212;0;5;2;3;2;3;0;0;5
14037; 34.5 ; 69.1 ; 3.4 ;2;20;294;0;2;0;2;0;2;0;2;0
14038; 36.6 ; 73.2 ; -   ;2;19;293;0;2;0;2;1;1;0;2;0
14039; 15.0 ; 30.0 ; -   ;2;118;58;0;2;1;1;1;1;2;0;0
14040; 17.6 ; 316.1 ; 4.7 ;18;10;16;0;18;5;13;7;11;18;0;0
14041; 33.9 ; 948.0 ; 19.1 ;28;12;1;0;28;10;18;24;4;9;19;0
14042; 28.7 ; 57.3 ; 5.4 ;2;23;23;0;2;1;1;0;2;1;1;0
14043; 99.7 ; 398.8 ; 74.8 ;4;51;32;0;4;1;3;2;2;1;0;3
14044; 58.2 ; 232.7 ; 40.3 ;4;50;98;0;4;1;3;1;3;1;0;3
14045; 27.2 ; 217.9 ; 20.6 ;8;27;99;0;8;0;8;8;0;5;3;0
14046; 95.7 ; 191.3 ; 1.1 ;2;12;18;0;2;2;0;1;1;0;0;2
14047; 47.5 ; 190.2 ; 26.8 ;4;59;15;0;4;0;4;3;1;1;2;1
14048; 22.6 ; 45.2 ; 11.4 ;2;9;150;0;2;1;1;2;0;1;1;0
14049; 42.4 ; 720.6 ; 12.3 ;17;1;230;0;17;10;7;9;8;0;17;0
14050; 28.7 ; 86.1 ; 25.1 ;3;77;14;0;3;3;0;3;0;2;1;0
14051; 30.5 ; 122.0 ; 11.5 ;4;62;2;4;0;1;3;3;1;1;3;0
14052; 48.7 ; 97.4 ; -   ;2;18;26;0;2;0;2;1;1;0;2;0
14053; 83.7 ; 167.5 ; 16.8 ;2;49;48;0;2;0;2;1;1;0;0;2
14054; 39.7 ; 675.0 ; 14.1 ;17;6;178;0;17;5;12;16;1;6;11;0
14055; 22.1 ; 88.2 ; 7.1 ;4;32;20;0;4;1;3;2;2;4;0;0
14056; 26.7 ; 267.1 ; 10.7 ;10;22;26;0;10;2;8;3;7;7;3;0
14057; 41.2 ; 741.6 ; 17.0 ;18;14;32;0;18;9;9;3;15;6;6;6
14058; 58.6 ; 117.1 ; 9.1 ;2;6;263;0;2;0;2;1;1;0;0;2
14059; 99.0 ; 297.0 ; 8.3 ;3;122;94;0;3;0;3;2;1;0;0;3
14060; 56.0 ; 279.9 ; 20.0 ;5;5;281;0;5;3;2;5;0;0;0;5
14061; 30.0 ; 59.9 ; -   ;2;1;152;0;2;1;1;0;2;2;0;0
14062; 38.9 ; 155.7 ; 18.7 ;4;58;93;0;4;1;3;2;2;1;2;1
14063; 59.3 ; 237.0 ; 7.5 ;4;34;71;0;4;3;1;2;2;0;0;4
14064; 25.8 ; 387.5 ; 18.2 ;15;27;10;0;15;4;11;5;10;10;5;0
14065; 35.3 ; 282.5 ; 4.1 ;8;23;11;1;7;2;6;1;7;0;8;0
14066; 18.2 ; 90.8 ; 4.4 ;5;39;143;0;5;0;5;5;0;5;0;0
14067; 39.7 ; 158.8 ; 11.8 ;4;143;31;0;4;1;3;4;0;1;3;0
14068; 46.8 ; 93.5 ; -   ;2;22;167;0;2;1;1;0;2;0;2;0
14069; 39.3 ; 78.6 ; 14.0 ;2;2;208;0;2;1;1;0;2;1;1;0
14070; 24.4 ; 170.7 ; 13.1 ;7;22;155;0;7;3;4;3;4;5;2;0
14071; 32.0 ; 448.0 ; 15.4 ;14;18;64;0;14;5;9;12;2;5;9;0
14072; 24.3 ; 48.6 ; 8.5 ;2;6;267;0;2;0;2;1;1;1;1;0
14073; 23.6 ; 117.8 ; 8.7 ;5;26;2;0;5;1;4;2;3;3;2;0
14074; 61.6 ; 123.3 ; 3.1 ;2;88;36;0;2;0;2;1;1;0;0;2
14075; 47.5 ; 142.5 ; 16.6 ;3;97;10;0;3;0;3;1;2;0;2;1
14076; 26.0 ; 155.8 ; 15.1 ;6;46;3;0;6;4;2;1;5;4;2;0
14077; 19.0 ; 57.1 ; 5.6 ;3;9;248;0;3;1;2;3;0;3;0;0
14078; 59.6 ; 119.3 ; 18.2 ;2;258;26;0;2;0;2;2;0;0;0;2
14079; 32.0 ; 224.0 ; 14.2 ;7;34;64;0;7;4;3;5;2;2;5;0
14080; 72.1 ; 504.4 ; 21.7 ;7;39;23;0;7;5;2;5;2;0;0;7
14081; 24.6 ; 442.8 ; 5.7 ;18;15;0;0;18;5;13;3;15;12;6;0
14082; 23.9 ; 310.3 ; 14.3 ;13;11;1;13;0;3;10;4;9;9;4;0
14083; 15.0 ; 30.0 ; -   ;2;56;51;0;2;2;0;1;1;2;0;0
14084; 54.0 ; 215.9 ; 34.0 ;4;18;69;0;4;3;1;1;3;1;2;1
14085; 22.8 ; 45.6 ; 4.6 ;2;113;263;0;2;0;2;2;0;2;0;0
14086; 43.1 ; 1,852.0 ; 19.7 ;43;5;5;0;43;2;41;24;19;14;15;14
14087; 16.0 ; 80.1 ; 1.5 ;5;101;59;0;5;3;2;5;0;5;0;0
14088; 33.1 ; 132.4 ; 3.8 ;4;31;134;0;4;2;2;2;2;1;3;0
14089; 22.4 ; 852.1 ; 4.8 ;38;7;2;0;38;31;7;7;31;38;0;0
14090; 49.8 ; 149.4 ; 21.9 ;3;4;286;0;3;3;0;1;2;1;1;1
14091; 25.0 ; 150.3 ; 12.0 ;6;9;347;0;6;0;6;1;5;4;2;0
14092; 23.1 ; 115.3 ; 8.2 ;5;11;302;0;5;2;3;4;1;3;2;0
14093; 55.0 ; 165.0 ; 41.9 ;3;78;121;0;3;0;3;3;0;1;0;2
14094; 50.9 ; 203.6 ; 4.2 ;4;42;170;0;4;3;1;1;3;0;3;1
14095; 34.0 ; 169.8 ; 15.4 ;5;23;5;2;3;0;5;3;2;2;3;0
14096; 44.1 ; 88.2 ; 43.6 ;2;12;293;0;2;0;2;2;0;1;0;1
14097; 73.3 ; 439.7 ; 19.9 ;6;46;2;0;6;4;2;4;2;0;0;6
14098; 70.1 ; 140.1 ; 9.7 ;2;87;189;0;2;0;2;2;0;0;0;2
14099; 29.3 ; 58.6 ; -   ;2;12;1;0;2;0;2;2;0;2;0;0
14100; 73.0 ; 584.2 ; 39.0 ;8;2;243;0;8;5;3;2;6;0;0;8
14101; 47.5 ; 142.4 ; -   ;3;5;68;0;3;1;2;0;3;0;3;0
14102; 65.8 ; 329.2 ; 44.1 ;5;31;92;0;5;1;4;2;3;2;0;3
14103; 46.8 ; 93.5 ; -   ;2;80;111;1;1;0;2;1;1;0;2;0
14104; 27.6 ; 55.3 ; 3.8 ;2;50;119;0;2;2;0;2;0;1;1;0
14105; 67.2 ; 134.5 ; 30.7 ;2;237;0;1;1;1;1;1;1;0;0;2
14106; 33.6 ; 100.8 ; 18.0 ;3;4;38;0;3;3;0;1;2;1;2;0
14107; 73.0 ; 291.9 ; 29.2 ;4;36;47;0;4;0;4;3;1;0;0;4
14108; 37.3 ; 74.6 ; 18.3 ;2;44;121;0;2;0;2;1;1;1;0;1
14109; 47.5 ; 142.6 ; 3.6 ;3;14;51;0;3;3;0;1;2;0;3;0
14110; 48.2 ; 96.3 ; 2.1 ;2;13;248;0;2;1;1;1;1;0;2;0
14111; 21.6 ; 129.7 ; 3.9 ;6;42;53;4;2;3;3;6;0;6;0;0
14112; 80.8 ; 323.0 ; 46.4 ;4;18;30;0;4;4;0;1;3;0;0;4
14113; 32.4 ; 194.7 ; 18.0 ;6;21;107;0;6;1;5;2;4;2;4;0
14114; 26.6 ; 425.0 ; 15.1 ;16;9;146;0;16;6;10;14;2;11;5;0
14115; 22.2 ; 44.3 ; 4.4 ;2;9;208;0;2;1;1;1;1;2;0;0
14116; 48.7 ; 97.3 ; 0.1 ;2;4;260;0;2;1;1;0;2;0;2;0
14117; 85.5 ; 342.1 ; 45.2 ;4;113;17;1;3;3;1;1;3;0;0;4
14118; 52.3 ; 418.7 ; 24.6 ;8;38;26;0;8;2;6;1;7;3;2;3
14119; 22.2 ; 111.2 ; 3.0 ;5;52;23;5;0;1;4;5;0;5;0;0
14120; 40.1 ; 80.2 ; 5.2 ;2;38;47;0;2;0;2;2;0;0;2;0
14121; 124.9 ; 499.6 ; 33.4 ;4;11;8;4;0;4;0;1;3;0;0;4
14122; 23.4 ; 70.2 ; 4.4 ;3;15;276;0;3;3;0;1;2;3;0;0
14123; 27.9 ; 55.8 ; -   ;2;11;185;0;2;0;2;0;2;2;0;0
14124; 17.4 ; 715.1 ; 5.2 ;41;4;4;0;41;22;19;34;7;41;0;0
14125; 20.9 ; 125.4 ; 5.9 ;6;48;68;0;6;2;4;2;4;6;0;0
14126; 33.3 ; 1,167.1 ; 18.0 ;35;9;1;0;35;17;18;13;22;12;23;0
14127; 40.8 ; 81.6 ; 15.9 ;2;138;166;0;2;2;0;1;1;1;0;1
14128; 25.3 ; 75.8 ; 18.8 ;3;50;106;0;3;0;3;2;1;2;1;0
14129; 42.4 ; 127.1 ; 16.8 ;3;67;164;0;3;1;2;1;2;1;1;1
14130; 33.9 ; 67.8 ; 4.1 ;2;120;89;0;2;0;2;1;1;1;1;0
14131; 39.2 ; 78.3 ; 1.8 ;2;117;22;0;2;0;2;1;1;0;2;0
14132; 15.8 ; 268.8 ; 2.5 ;17;17;12;0;17;4;13;10;7;17;0;0
14133; 17.0 ; 51.1 ; 3.7 ;3;40;273;0;3;2;1;1;2;3;0;0
14134; 30.2 ; 60.4 ; -   ;2;6;283;0;2;0;2;2;0;0;2;0
14135; 25.0 ; 99.9 ; 13.0 ;4;13;246;0;4;2;2;2;2;3;1;0
14136; 38.5 ; 76.9 ; 12.4 ;2;4;278;0;2;1;1;2;0;1;1;0
14137; 32.4 ; 162.2 ; 5.3 ;5;22;179;0;5;1;4;2;3;2;3;0
14138; 44.8 ; 89.6 ; 2.9 ;2;46;220;0;2;1;1;2;0;0;2;0
14139; 15.0 ; 74.9 ; -   ;5;7;17;0;5;2;3;3;2;5;0;0
14140; 17.1 ; 51.4 ; 2.0 ;3;76;83;0;3;0;3;0;3;3;0;0
14141; 36.9 ; 73.8 ; 17.7 ;2;147;4;0;2;1;1;0;2;1;1;0
14142; 27.6 ; 55.3 ; 3.8 ;2;13;356;0;2;0;2;2;0;1;1;0
14143; 29.2 ; 787.6 ; 25.7 ;27;14;5;0;27;4;23;16;11;18;9;0
14144; 58.8 ; 411.7 ; 13.4 ;7;60;36;0;7;0;7;0;7;0;0;7
14145; 34.6 ; 103.9 ; 16.0 ;3;45;82;0;3;1;2;0;3;1;2;0
14146; 30.8 ; 61.6 ; 2.2 ;2;11;173;0;2;0;2;2;0;1;1;0
14147; 38.3 ; 76.7 ; 19.8 ;2;73;99;0;2;1;1;2;0;1;0;1
14148; 56.9 ; 113.7 ; 13.4 ;2;43;246;0;2;0;2;2;0;0;0;2
14149; 65.5 ; 131.0 ; 25.8 ;2;1;266;0;2;1;1;2;0;0;0;2
14150; 39.4 ; 78.9 ; 13.9 ;2;110;133;0;2;1;1;1;1;1;1;0
14151; 38.9 ; 350.0 ; 19.7 ;9;23;136;0;9;5;4;3;6;3;3;3
14152; 75.6 ; 1,361.4 ; 42.0 ;18;8;26;0;18;3;15;3;15;0;0;18
14153; 48.7 ; 97.4 ; -   ;2;4;84;2;0;1;1;1;1;0;2;0
14154; 25.1 ; 50.1 ; -   ;2;77;119;0;2;1;1;1;1;2;0;0
14155; 23.0 ; 91.9 ; 8.6 ;4;113;6;0;4;2;2;2;2;3;1;0
14156; 36.6 ; 73.2 ; -   ;2;59;50;0;2;1;1;0;2;0;2;0
14157; 61.0 ; 366.0 ; 19.1 ;6;51;11;0;6;1;5;2;4;0;0;6
14158; 20.7 ; 332.0 ; 7.9 ;16;19;38;0;16;4;12;3;13;16;0;0
14159; 37.0 ; 148.0 ; 15.4 ;4;88;20;0;4;1;3;4;0;1;3;0
14160; 23.3 ; 442.3 ; 14.2 ;19;11;17;1;18;4;15;5;14;13;6;0
14161; 61.1 ; 305.6 ; 14.1 ;5;60;20;0;5;0;5;3;2;0;0;5
14162; 46.0 ; 551.9 ; 12.0 ;12;12;156;0;12;7;5;9;3;0;8;4
14163; 24.1 ; 458.0 ; 10.3 ;19;18;12;0;19;7;12;13;6;13;6;0
14164; 65.6 ; 196.8 ; 41.4 ;3;108;143;0;3;2;1;3;0;1;0;2
14165; 70.1 ; 140.3 ; 35.0 ;2;47;261;0;2;1;1;0;2;0;0;2
14166; 80.9 ; 161.7 ; 35.0 ;2;3;161;0;2;1;1;1;1;0;0;2
14167; 47.7 ; 95.4 ; 1.4 ;2;86;138;0;2;1;1;1;1;0;2;0
14168; 53.8 ; 269.1 ; 32.2 ;5;34;21;0;5;1;4;2;3;2;1;2
14169; 49.5 ; 148.5 ; 8.9 ;3;160;15;0;3;2;1;1;2;0;2;1
14170; 116.9 ; 233.8 ; 35.0 ;2;21;251;0;2;1;1;1;1;0;0;2
14171; 39.4 ; 78.9 ; 13.9 ;2;18;208;2;0;2;0;0;2;1;1;0
14172; 36.0 ; 144.0 ; 13.4 ;4;25;163;0;4;1;3;1;3;1;3;0
14173; 18.0 ; 36.1 ; 4.6 ;2;38;68;1;1;0;2;2;0;2;0;0
14174; 39.3 ; 117.9 ; 22.8 ;3;121;178;2;1;1;2;2;1;1;1;1
14175; 32.4 ; 194.2 ; 13.2 ;6;37;5;0;6;1;5;3;3;2;4;0
14176; 55.5 ; 443.6 ; 15.9 ;8;45;59;0;8;3;5;3;5;0;0;8
14177; 44.0 ; 88.0 ; 14.3 ;2;141;99;0;2;1;1;1;1;1;0;1
14178; 84.2 ; 589.3 ; 25.5 ;7;28;2;0;7;2;5;5;2;0;0;7
14179; 27.7 ; 249.6 ; 16.4 ;9;46;5;0;9;6;3;2;7;6;3;0
14180; 42.0 ; 126.1 ; 27.2 ;3;105;224;0;3;2;1;1;2;1;1;1
14181; 41.6 ; 124.8 ; 15.4 ;3;74;93;0;3;2;1;3;0;1;1;1
14182; 26.4 ; 105.4 ; 2.7 ;4;14;110;0;4;0;4;3;1;4;0;0
14183; 48.6 ; 145.9 ; 22.2 ;3;22;105;0;3;0;3;2;1;1;1;1
14184; 19.5 ; 117.1 ; 12.7 ;6;41;4;2;4;2;4;5;1;4;2;0
14185; 100.0 ; 200.0 ; 0.9 ;2;32;147;0;2;0;2;0;2;0;0;2
14186; 118.3 ; 473.3 ; 93.0 ;4;88;36;0;4;1;3;4;0;1;0;3
14187; 81.2 ; 162.4 ; 84.0 ;2;73;203;0;2;2;0;1;1;1;0;1
14188; 19.2 ; 288.5 ; -   ;15;8;80;0;15;9;6;5;10;15;0;0
14189; 41.7 ; 125.2 ; 5.0 ;3;2;250;0;3;1;2;3;0;0;3;0
14190; 47.0 ; 188.0 ; 17.2 ;4;76;194;0;4;0;4;3;1;1;2;1
14191; 59.3 ; 474.2 ; 20.8 ;8;35;20;0;8;0;8;6;2;0;0;8
14192; 31.9 ; 127.5 ; 14.4 ;4;58;110;0;4;3;1;3;1;1;3;0
14193; 29.4 ; 147.1 ; 13.0 ;5;17;99;0;5;2;3;5;0;3;2;0
14194; 29.1 ; 87.3 ; 11.4 ;3;59;14;0;3;2;1;1;2;2;1;0
14195; 21.5 ; 301.2 ; 8.1 ;14;16;6;0;14;7;7;11;3;14;0;0
14196; 17.5 ; 70.0 ; 5.3 ;4;85;53;0;4;1;3;4;0;4;0;0
14197; 30.2 ; 60.4 ; -   ;2;106;227;0;2;0;2;0;2;0;2;0
14198; 154.5 ; 463.5 ; 172.3 ;3;71;128;0;3;1;2;1;2;1;0;2
14199; 64.1 ; 320.3 ; 38.2 ;5;42;125;0;5;1;4;5;0;2;0;3
14200; 36.6 ; 183.0 ; -   ;5;2;257;0;5;2;3;3;2;0;5;0
14201; 52.8 ; 105.5 ; 24.2 ;2;55;22;0;2;0;2;2;0;1;0;1
14202; 17.7 ; 354.5 ; 5.5 ;20;9;17;0;20;9;11;17;3;20;0;0
14203; 63.9 ; 255.6 ; 22.2 ;4;49;93;4;0;1;3;3;1;0;0;4
14204; 62.3 ; 187.0 ; 46.2 ;3;97;29;0;3;3;0;1;2;1;0;2
14205; 16.2 ; 64.6 ; 2.5 ;4;83;133;0;4;2;2;4;0;4;0;0
14206; 35.9 ; 71.8 ; 16.2 ;2;12;180;0;2;1;1;0;2;1;1;0
14207; 19.7 ; 39.3 ; -   ;2;5;211;0;2;0;2;2;0;2;0;0
14208; 52.6 ; 735.9 ; 10.2 ;14;15;112;0;14;7;7;11;3;0;9;5
14209; 16.0 ; 48.0 ; 1.9 ;3;18;84;0;3;0;3;3;0;3;0;0
14210; 37.2 ; 111.7 ; 9.1 ;3;175;104;0;3;2;1;2;1;1;2;0
14211; 30.7 ; 153.4 ; 9.0 ;5;39;20;0;5;0;5;5;0;2;3;0
14212; 77.6 ; 155.2 ; 23.8 ;2;81;160;0;2;2;0;2;0;0;0;2
14213; 43.0 ; 85.9 ; 5.7 ;2;42;221;0;2;0;2;0;2;0;2;0
14214; 22.2 ; 44.4 ; 3.8 ;2;5;283;0;2;1;1;0;2;2;0;0
14215; 38.9 ; 116.7 ; 13.9 ;3;59;56;0;3;3;0;2;1;1;2;0
14216; 15.4 ; 30.8 ; -   ;2;37;302;0;2;2;0;2;0;2;0;0
14217; 111.8 ; 670.5 ; 52.7 ;6;50;26;0;6;0;6;5;1;0;0;6
14218; 32.9 ; 427.1 ; 17.3 ;13;13;16;0;13;0;13;7;6;4;9;0
14219; 15.7 ; 63.0 ; 1.6 ;4;23;51;0;4;2;2;1;3;4;0;0
14220; 29.1 ; 639.9 ; 13.8 ;22;14;0;0;22;2;20;11;11;15;7;0
14221; 21.9 ; 109.7 ; 9.2 ;5;58;21;0;5;0;5;5;0;3;2;0
14222; 40.6 ; 162.2 ; 34.4 ;4;8;296;0;4;1;3;1;3;1;2;1
14223; 29.5 ; 884.3 ; 8.3 ;30;11;4;0;30;14;16;14;16;20;10;0
14224; 45.2 ; 135.7 ; 13.0 ;3;113;22;1;2;1;2;1;2;0;2;1
14225; 47.5 ; 94.9 ; -   ;2;52;28;0;2;2;0;2;0;0;2;0
14226; 54.7 ; 273.4 ; 5.8 ;5;26;58;0;5;0;5;4;1;0;3;2
14227; 29.1 ; 58.3 ; 1.6 ;2;1;248;0;2;1;1;2;0;1;1;0
14228; 15.5 ; 170.5 ; 1.9 ;11;28;20;0;11;3;8;11;0;11;0;0
14229; 39.2 ; 78.4 ; 13.5 ;2;31;5;0;2;0;2;2;0;1;1;0
14230; 84.1 ; 168.1 ; 16.3 ;2;14;22;0;2;1;1;1;1;0;0;2
14231; 70.1 ; 140.3 ; 35.0 ;2;61;248;0;2;0;2;1;1;0;0;2
14232; 58.3 ; 175.0 ; 17.9 ;3;173;5;0;3;0;3;3;0;0;0;3
14233; 35.1 ; 526.4 ; 7.2 ;15;15;15;0;15;0;15;8;7;5;10;0
14234; 47.5 ; 713.0 ; 9.9 ;15;17;115;0;15;0;15;5;10;0;10;5
14235; 59.3 ; 118.6 ; 18.8 ;2;112;170;0;2;1;1;2;0;0;0;2
14236; 69.0 ; 138.0 ; 24.7 ;2;75;188;0;2;0;2;2;0;0;0;2
14237; 39.2 ; 117.6 ; 3.7 ;3;20;59;0;3;3;0;0;3;0;3;0
14238; 27.2 ; 217.5 ; 29.5 ;8;27;5;0;8;1;7;4;4;5;0;3
14239; 28.1 ; 589.1 ; 6.2 ;21;22;0;0;21;12;9;4;17;14;7;0
14240; 18.4 ; 73.7 ; 2.9 ;4;22;54;0;4;4;0;4;0;4;0;0
14241; 52.9 ; 264.7 ; 0.7 ;5;65;20;0;5;0;5;4;1;0;5;0
14242; 16.0 ; 640.6 ; 3.5 ;40;10;1;0;40;18;22;37;3;40;0;0
14243; 25.1 ; 75.2 ; -   ;3;7;23;0;3;2;1;1;2;3;0;0
14244; 34.0 ; 101.9 ; 15.1 ;3;34;142;0;3;0;3;1;2;1;2;0
14245; 49.0 ; 1,274.7 ; 34.9 ;26;12;3;0;26;14;12;15;11;9;8;9
14246; 49.2 ; 246.0 ; 5.8 ;5;65;165;0;5;3;2;3;2;0;5;0
14247; 41.3 ; 206.6 ; 8.2 ;5;23;89;0;5;1;4;1;4;0;5;0
14248; 53.5 ; 267.5 ; 28.3 ;5;50;53;0;5;1;4;2;3;2;1;2
14249; 53.9 ; 107.8 ; 43.1 ;2;1;218;0;2;2;0;0;2;1;0;1
14250; 36.0 ; 396.2 ; 16.9 ;11;32;15;0;11;1;10;6;5;4;7;0
14251; 61.0 ; 244.2 ; 28.3 ;4;69;131;0;4;0;4;4;0;0;0;4
14252; 48.7 ; 97.3 ; 4.3 ;2;112;66;0;2;2;0;2;0;0;2;0
14253; 54.2 ; 1,410.0 ; 24.0 ;26;15;62;0;26;0;26;24;2;0;17;9
14254; 16.2 ; 48.6 ; 2.2 ;3;23;291;0;3;1;2;1;2;3;0;0
14255; 54.9 ; 219.7 ; 27.3 ;4;93;146;0;4;0;4;1;3;1;2;1
14256; 45.8 ; 869.7 ; 6.6 ;19;8;0;19;0;2;17;19;0;0;19;0
14257; 72.7 ; 871.9 ; 32.1 ;12;16;44;12;0;12;0;2;10;0;0;12
14258; 26.8 ; 80.3 ; 3.1 ;3;37;285;0;3;2;1;1;2;3;0;0
14259; 62.4 ; 187.3 ; 28.1 ;3;34;80;0;3;0;3;3;0;0;0;3
14260; 29.0 ; 261.0 ; 17.7 ;9;25;27;0;9;1;8;8;1;6;3;0
14261; 57.0 ; 170.9 ; 15.0 ;3;139;119;0;3;1;2;2;1;0;0;3
14262; 18.8 ; 338.0 ; 5.1 ;18;17;0;0;18;7;11;13;5;18;0;0
14263; 49.1 ; 98.3 ; 0.6 ;2;185;5;0;2;1;1;2;0;0;2;0
14264; 16.8 ; 50.4 ; 3.3 ;3;58;113;2;1;1;2;1;2;3;0;0
14265; 60.2 ; 240.9 ; 42.8 ;4;22;174;0;4;1;3;2;2;1;0;3
14266; 75.6 ; 1,134.2 ; 38.0 ;15;16;6;0;15;1;14;10;5;0;0;15
14267; 25.1 ; 50.1 ; -   ;2;14;264;0;2;2;0;0;2;2;0;0
14268; 47.5 ; 94.9 ; -   ;2;4;55;0;2;1;1;1;1;0;2;0
14269; 50.1 ; 300.5 ; 10.1 ;6;50;26;0;6;0;6;5;1;0;4;2
14270; 49.8 ; 99.7 ; 10.5 ;2;43;100;0;2;0;2;0;2;0;1;1
14271; 42.3 ; 211.3 ; 8.7 ;5;24;112;0;5;2;3;4;1;0;5;0
14272; 55.3 ; 331.9 ; 1.9 ;6;29;15;6;0;1;5;6;0;0;0;6
14273; 23.1 ; 323.0 ; 10.0 ;14;8;50;0;14;5;9;6;8;9;5;0
14274; 30.9 ; 61.7 ; 23.8 ;2;43;191;0;2;2;0;1;1;1;1;0
14275; 120.7 ; 362.1 ; 18.5 ;3;29;121;0;3;0;3;3;0;0;0;3
14276; 47.2 ; 141.6 ; 13.9 ;3;78;137;1;2;0;3;1;2;0;2;1
14277; 30.4 ; 213.0 ; 8.9 ;7;10;200;0;7;0;7;2;5;2;5;0
14278; 45.2 ; 271.1 ; 28.4 ;6;54;53;0;6;0;6;5;1;2;2;2
14279; 52.5 ; 262.4 ; 11.9 ;5;59;15;1;4;0;5;2;3;0;3;2
14280; 41.7 ; 125.1 ; 9.9 ;3;83;6;0;3;2;1;1;2;0;3;0
14281; 66.6 ; 532.7 ; 28.8 ;8;40;26;0;8;0;8;4;4;0;0;8
14282; 15.0 ; 30.0 ; -   ;2;2;254;0;2;2;0;1;1;2;0;0
14283; 16.1 ; 224.9 ; 2.9 ;14;13;90;0;14;9;5;9;5;14;0;0
14284; 49.8 ; 99.6 ; 1.8 ;2;31;163;0;2;0;2;0;2;0;2;0
14285; 43.4 ; 477.8 ; 19.2 ;11;29;3;0;11;3;8;5;6;4;3;4
14286; 45.2 ; 90.3 ; -   ;2;130;69;0;2;0;2;1;1;0;2;0
14287; 51.6 ; 206.2 ; 4.4 ;4;50;15;0;4;0;4;4;0;0;3;1
14288; 54.8 ; 274.2 ; 23.0 ;5;54;51;0;5;2;3;2;3;0;3;2
14289; 15.0 ; 59.9 ; -   ;4;8;377;0;4;0;4;4;0;4;0;0
14290; 15.0 ; 74.9 ; -   ;5;35;15;5;0;1;4;1;4;5;0;0
14291; 24.8 ; 99.3 ; 16.8 ;4;73;24;0;4;4;0;2;2;3;1;0
14292; 34.9 ; 279.0 ; 16.2 ;8;49;3;0;8;5;3;3;5;3;5;0
14293; 59.1 ; 118.1 ; 9.8 ;2;43;225;0;2;0;2;1;1;0;0;2
14294; 20.9 ; 313.1 ; 11.4 ;15;14;2;0;15;9;6;15;0;10;5;0
14295; 32.7 ; 163.5 ; 2.5 ;5;45;26;0;5;2;3;4;1;0;5;0
14296; 15.0 ; 74.9 ; -   ;5;15;10;0;5;0;5;3;2;5;0;0
14297; 69.0 ; 206.9 ; 25.6 ;3;36;71;0;3;1;2;1;2;0;0;3
14298; 45.3 ; 135.9 ; 8.2 ;3;56;120;0;3;1;2;0;3;0;3;0
14299; 35.6 ; 71.2 ; 1.5 ;2;32;188;0;2;0;2;0;2;0;2;0
14300; 18.3 ; 55.0 ; 6.2 ;3;74;24;0;3;1;2;3;0;3;0;0
14301; 63.2 ; 126.4 ; 4.9 ;2;3;268;0;2;1;1;2;0;0;0;2
14302; 20.9 ; 125.3 ; 4.7 ;6;25;121;0;6;0;6;1;5;6;0;0
14303; 24.9 ; 323.5 ; 13.5 ;13;10;234;0;13;7;6;9;4;9;4;0
14304; 38.1 ; 152.3 ; 16.4 ;4;27;103;0;4;2;2;1;3;1;3;0
14305; 30.5 ; 274.3 ; 0.4 ;9;39;2;5;4;3;6;1;8;0;9;0
14306; 62.3 ; 311.6 ; 31.7 ;5;27;89;0;5;0;5;5;0;0;0;5
14307; 28.9 ; 86.8 ; 17.2 ;3;133;58;1;2;1;2;3;0;2;1;0
14308; 60.4 ; 544.0 ; 27.8 ;9;35;17;0;9;3;6;3;6;0;0;9
14309; 27.1 ; 189.4 ; 5.9 ;7;15;241;0;7;2;5;4;3;5;2;0
14310; 60.4 ; 241.4 ; 28.8 ;4;9;231;0;4;3;1;3;1;0;0;4
14311; 20.0 ; 40.1 ; 7.6 ;2;23;89;0;2;1;1;1;1;2;0;0
14312; 43.6 ; 130.8 ; 41.9 ;3;105;8;0;3;2;1;2;1;1;1;1
14313; 44.4 ; 88.8 ; 28.9 ;2;27;249;0;2;2;0;1;1;1;0;1
14314; 40.4 ; 202.0 ; 15.0 ;5;43;122;0;5;3;2;3;2;2;1;2
14315; 60.5 ; 302.3 ; 15.3 ;5;33;40;0;5;2;3;3;2;0;0;5
14316; 37.2 ; 111.7 ; 4.6 ;3;70;248;0;3;3;0;3;0;0;3;0
14317; 40.8 ; 81.5 ; 7.6 ;2;2;308;0;2;1;1;2;0;0;2;0
14318; 56.1 ; 168.4 ; -   ;3;25;172;0;3;3;0;3;0;0;0;3
14319; 32.9 ; 955.2 ; 13.3 ;29;5;2;0;29;14;15;18;11;10;19;0
14320; 16.1 ; 80.5 ; 1.7 ;5;45;80;0;5;0;5;2;3;5;0;0
14321; 20.1 ; 120.5 ; 6.4 ;6;25;180;0;6;1;5;4;2;6;0;0
14322; 26.1 ; 209.0 ; 14.8 ;8;19;11;0;8;3;5;2;6;5;3;0
14323; 36.3 ; 72.5 ; 16.8 ;2;19;100;0;2;0;2;2;0;1;1;0
14324; 28.9 ; 86.8 ; 17.2 ;3;11;251;0;3;2;1;1;2;2;1;0
14325; 64.6 ; 258.2 ; 24.5 ;4;103;21;0;4;0;4;4;0;0;0;4
14326; 20.3 ; 101.4 ; 13.7 ;5;24;185;0;5;2;3;2;3;3;2;0
14327; 24.0 ; 95.9 ; 19.1 ;4;51;147;0;4;3;1;2;2;3;1;0
14328; 23.6 ; 47.1 ; 6.4 ;2;5;199;1;1;1;1;2;0;2;0;0
14329; 34.9 ; 244.1 ; 6.7 ;7;50;126;0;7;5;2;1;6;2;5;0
14330; 27.0 ; 378.3 ; 6.7 ;14;14;95;0;14;1;13;14;0;9;5;0
14331; 21.3 ; 213.1 ; 13.0 ;10;22;7;2;8;4;6;5;5;7;3;0
14332; 72.4 ; 217.3 ; 27.9 ;3;57;98;0;3;3;0;1;2;0;0;3
14333; 15.0 ; 30.0 ; -   ;2;32;2;0;2;2;0;0;2;2;0;0
14334; 26.3 ; 263.2 ; 16.0 ;10;23;18;0;10;4;6;6;4;7;3;0
14335; 25.3 ; 354.9 ; 15.1 ;14;23;2;0;14;1;13;11;3;9;5;0
14336; 53.7 ; 107.5 ; 25.7 ;2;21;188;0;2;1;1;2;0;1;0;1
14337; 45.2 ; 90.3 ; 2.4 ;2;142;98;2;0;2;0;2;0;0;2;0
14338; 20.9 ; 1,420.7 ; 7.3 ;68;6;11;0;68;21;47;35;33;68;0;0
14339; 50.0 ; 550.3 ; 23.6 ;11;38;47;0;11;3;8;6;5;4;3;4
14340; 56.7 ; 454.0 ; 17.2 ;8;41;23;0;8;3;5;2;6;0;0;8
14341; 52.3 ; 104.5 ; 14.1 ;2;125;263;0;2;0;2;1;1;0;1;1
14342; 68.0 ; 271.9 ; 65.4 ;4;14;176;4;0;4;0;0;4;1;0;3
14343; 25.8 ; 51.6 ; 16.2 ;2;14;251;0;2;0;2;0;2;1;1;0
14344; 26.7 ; 160.3 ; 9.8 ;6;18;95;6;0;4;2;2;4;4;2;0
14345; 33.4 ; 167.0 ; 16.6 ;5;28;194;0;5;0;5;3;2;2;3;0
14346; 35.0 ; 70.1 ; 7.7 ;2;14;382;0;2;1;1;0;2;1;1;0
14347; 34.2 ; 205.5 ; 11.6 ;6;31;20;0;6;0;6;2;4;2;4;0
14348; 29.8 ; 59.5 ; 7.0 ;2;195;111;0;2;0;2;2;0;1;1;0
14349; 36.2 ; 108.6 ; 10.4 ;3;41;8;0;3;2;1;1;2;1;2;0
14350; 50.2 ; 652.2 ; 28.5 ;13;24;8;0;13;3;10;13;0;4;5;4
14351; 43.3 ; 216.3 ; 6.5 ;5;18;10;0;5;0;5;4;1;0;5;0
14352; 72.5 ; 144.9 ; -   ;2;12;178;0;2;0;2;2;0;0;0;2
14353; 65.8 ; 131.6 ; 26.4 ;2;24;25;2;0;2;0;0;2;0;0;2
14354; 41.0 ; 163.9 ; 15.4 ;4;54;13;0;4;2;2;2;2;1;2;1
14355; 20.0 ; 59.9 ; 9.2 ;3;55;3;0;3;2;1;2;1;3;0;0
14356; 47.5 ; 94.9 ; -   ;2;5;57;0;2;0;2;1;1;0;2;0
14357; 53.7 ; 483.3 ; 21.3 ;9;33;20;0;9;1;8;6;3;0;6;3
14358; 26.5 ; 978.7 ; 15.0 ;37;12;6;0;37;16;21;31;6;25;12;0
14359; 22.9 ; 45.8 ; 4.9 ;2;6;110;0;2;0;2;1;1;2;0;0
14360; 48.1 ; 336.7 ; 29.5 ;7;49;18;4;3;6;1;7;0;2;3;2
14361; 26.2 ; 392.3 ; 9.3 ;15;27;11;0;15;8;7;14;1;10;5;0
14362; 46.8 ; 93.5 ; -   ;2;6;162;0;2;0;2;2;0;0;2;0
14363; 21.1 ; 84.6 ; 5.2 ;4;38;162;0;4;1;3;2;2;4;0;0
14364; 29.5 ; 236.0 ; 11.9 ;8;41;92;0;8;3;5;5;3;5;3;0
14365; 15.0 ; 30.0 ; -   ;2;9;73;0;2;1;1;2;0;2;0;0
14366; 20.7 ; 41.5 ; -   ;2;29;150;0;2;1;1;2;0;2;0;0
14367; 54.8 ; 767.4 ; 17.5 ;14;25;26;0;14;0;14;14;0;0;9;5
14368; 25.1 ; 50.1 ; -   ;2;23;242;0;2;0;2;1;1;2;0;0
14369; 44.3 ; 132.8 ; 20.4 ;3;90;5;0;3;2;1;1;2;1;1;1
14370; 37.9 ; 113.6 ; 14.1 ;3;28;100;3;0;0;3;3;0;1;2;0
14371; 19.4 ; 58.1 ; 8.0 ;3;30;78;3;0;1;2;2;1;3;0;0
14372; 65.7 ; 1,641.8 ; 32.8 ;25;15;5;0;25;1;24;24;1;0;0;25
14373; 18.9 ; 189.0 ; 5.5 ;10;20;20;0;10;6;4;4;6;10;0;0
14374; 60.5 ; 121.1 ; 52.2 ;2;23;113;0;2;1;1;2;0;1;0;1
14375; 57.5 ; 115.0 ; 13.2 ;2;95;95;0;2;1;1;1;1;0;0;2
14376; 31.1 ; 280.2 ; 6.2 ;9;27;59;0;9;5;4;3;6;3;6;0
14377; 27.8 ; 166.7 ; 9.6 ;6;14;200;0;6;4;2;3;3;4;2;0
14378; 64.4 ; 128.7 ; 9.8 ;2;18;152;0;2;0;2;2;0;0;0;2
14379; 37.9 ; 227.5 ; 21.2 ;6;50;2;0;6;4;2;5;1;2;2;2
14380; 19.2 ; 115.5 ; 0.6 ;6;32;102;0;6;1;5;1;5;6;0;0
14381; 15.0 ; 30.0 ; -   ;2;143;22;1;1;0;2;1;1;2;0;0
14382; 46.9 ; 469.1 ; 9.9 ;10;24;6;0;10;1;9;9;1;0;7;3
14383; 50.2 ; 150.6 ; 22.5 ;3;2;44;0;3;1;2;2;1;1;1;1
14384; 37.6 ; 112.7 ; 13.7 ;3;63;293;0;3;1;2;2;1;1;2;0
14385; 31.9 ; 223.0 ; 12.6 ;7;24;105;0;7;4;3;6;1;2;5;0
14386; 49.6 ; 99.3 ; 4.3 ;2;79;257;0;2;1;1;1;1;0;2;0
14387; 86.8 ; 781.4 ; 36.5 ;9;33;26;0;9;1;8;2;7;0;0;9
14388; 32.7 ; 327.0 ; 11.3 ;10;38;32;0;10;7;3;6;4;3;7;0
14389; 17.0 ; 84.8 ; 1.6 ;5;10;140;0;5;2;3;2;3;5;0;0
14390; 22.2 ; 44.4 ; 4.3 ;2;32;234;0;2;2;0;2;0;2;0;0
14391; 59.6 ; 298.2 ; 7.4 ;5;20;65;0;5;1;4;5;0;0;0;5
14392; 82.7 ; 496.3 ; 10.5 ;6;20;10;0;6;0;6;5;1;0;0;6
14393; 45.0 ; 494.9 ; 12.0 ;11;26;32;0;11;6;5;11;0;0;7;4
14394; 34.8 ; 313.3 ; 24.9 ;9;27;5;0;9;2;7;7;2;3;3;3
14395; 53.8 ; 215.3 ; 28.7 ;4;26;89;0;4;2;2;1;3;1;2;1
14396; 27.6 ; 110.3 ; 16.4 ;4;5;123;0;4;2;2;3;1;3;1;0
14397; 41.1 ; 82.2 ; 6.7 ;2;50;104;2;0;1;1;2;0;0;2;0
14398; 64.0 ; 191.9 ; 41.7 ;3;44;98;0;3;2;1;2;1;1;0;2
14399; 25.7 ; 180.0 ; 11.1 ;7;14;123;0;7;5;2;1;6;5;2;0
14400; 52.2 ; 417.7 ; 19.4 ;8;38;15;0;8;3;5;7;1;0;5;3
14401; 37.9 ; 113.7 ; 11.2 ;3;50;236;0;3;0;3;3;0;1;2;0
14402; 15.0 ; 30.0 ; -   ;2;14;5;0;2;1;1;1;1;2;0;0
14403; 35.1 ; 771.9 ; 14.8 ;22;15;21;0;22;15;7;14;8;7;15;0
14404; 15.0 ; 30.0 ; -   ;2;19;251;0;2;1;1;1;1;2;0;0
14405; 61.7 ; 246.9 ; 12.1 ;4;30;32;4;0;1;3;3;1;0;0;4
14406; 89.0 ; 444.8 ; 54.7 ;5;46;69;0;5;2;3;3;2;0;0;5
14407; 48.2 ; 96.4 ; -   ;2;13;7;2;0;2;0;0;2;0;2;0
14408; 36.3 ; 72.5 ; 16.8 ;2;16;96;2;0;1;1;1;1;1;1;0
14409; 53.8 ; 215.0 ; 32.6 ;4;59;47;1;3;1;3;4;0;1;2;1
14410; 28.8 ; 143.9 ; 15.0 ;5;25;194;0;5;2;3;3;2;3;2;0
14411; 16.0 ; 400.4 ; 1.8 ;25;11;38;0;25;10;15;7;18;25;0;0
14412; 30.3 ; 212.1 ; 17.0 ;7;33;26;1;6;2;5;2;5;2;5;0
14413; 20.0 ; 180.3 ; 12.3 ;9;17;219;0;9;5;4;7;2;6;3;0
14414; 21.1 ; 42.2 ; -   ;2;1;80;2;0;2;0;0;2;2;0;0
14415; 49.7 ; 149.1 ; 5.4 ;3;47;194;0;3;0;3;3;0;0;2;1
14416; 72.1 ; 144.1 ; 37.9 ;2;251;89;0;2;0;2;0;2;0;0;2
14417; 41.2 ; 123.7 ; 10.1 ;3;32;175;0;3;3;0;1;2;0;3;0
14418; 48.7 ; 97.4 ; -   ;2;20;205;0;2;1;1;0;2;0;2;0
14419; 37.4 ; 74.9 ; 28.2 ;2;16;26;1;1;1;1;2;0;1;0;1
14420; 21.3 ; 404.2 ; 8.4 ;19;7;10;0;19;5;14;5;14;19;0;0
14421; 44.3 ; 88.6 ; 19.7 ;2;20;73;0;2;0;2;2;0;1;0;1
14422; 40.2 ; 281.3 ; 36.9 ;7;14;14;0;7;2;5;3;4;2;3;2
14423; 37.4 ; 149.8 ; 26.4 ;4;48;40;0;4;3;1;3;1;1;2;1
14424; 27.4 ; 136.8 ; 13.9 ;5;65;0;0;5;1;4;5;0;3;2;0
14425; 47.0 ; 610.8 ; 7.3 ;13;21;31;0;13;0;13;5;8;0;13;0
14426; 84.5 ; 169.1 ; 19.0 ;2;138;105;0;2;0;2;2;0;0;0;2
14427; 21.5 ; 107.5 ; 6.4 ;5;28;149;0;5;4;1;5;0;5;0;0
14428; 20.0 ; 59.9 ; 9.2 ;3;13;173;0;3;2;1;3;0;3;0;0
14429; 39.7 ; 158.8 ; 7.8 ;4;103;23;0;4;2;2;4;0;0;4;0
14430; 18.3 ; 1,078.2 ; 7.7 ;59;7;0;0;59;17;42;26;33;59;0;0
14431; 64.0 ; 127.9 ; 11.8 ;2;220;90;0;2;0;2;2;0;0;0;2
14432; 46.2 ; 138.7 ; 19.2 ;3;67;160;0;3;2;1;2;1;1;1;1
14433; 95.4 ; 286.3 ; 89.3 ;3;22;268;0;3;0;3;3;0;1;0;2
14434; 53.7 ; 107.3 ; 6.1 ;2;13;175;0;2;2;0;0;2;0;1;1
14435; 26.5 ; 132.7 ; 13.0 ;5;54;11;0;5;1;4;2;3;3;2;0
14436; 22.8 ; 639.7 ; 9.9 ;28;11;79;0;28;7;21;25;3;19;9;0
14437; 23.3 ; 535.3 ; 8.1 ;23;16;20;0;23;4;19;4;19;15;8;0
14438; 52.9 ; 105.7 ; -   ;2;18;125;0;2;0;2;2;0;0;2;0
14439; 69.9 ; 209.6 ; 12.8 ;3;28;120;0;3;0;3;2;1;0;0;3
14440; 34.4 ; 68.9 ; -   ;2;18;263;0;2;0;2;2;0;0;2;0
14441; 30.4 ; 425.1 ; 15.9 ;14;16;68;0;14;4;10;8;6;5;9;0
14442; 64.4 ; 451.0 ; 31.5 ;7;20;16;0;7;1;6;3;4;0;0;7
14443; 31.9 ; 191.1 ; 9.1 ;6;17;6;0;6;1;5;4;2;2;4;0
14444; 54.2 ; 108.4 ; 26.4 ;2;14;211;0;2;1;1;0;2;1;0;1
14445; 49.6 ; 396.8 ; 9.9 ;8;40;11;0;8;3;5;6;2;0;5;3
14446; 20.7 ; 103.7 ; 9.6 ;5;58;23;0;5;4;1;1;4;3;2;0
14447; 46.8 ; 93.5 ; -   ;2;12;198;2;0;2;0;2;0;0;2;0
14448; 57.0 ; 171.0 ; 9.8 ;3;95;31;2;1;0;3;3;0;0;0;3
14449; 24.9 ; 49.8 ; 0.3 ;2;95;293;0;2;2;0;2;0;2;0;0
14450; 50.7 ; 304.5 ; 14.2 ;6;28;5;0;6;1;5;3;3;0;4;2
14451; 73.6 ; 662.6 ; 57.0 ;9;16;16;0;9;1;8;7;2;3;0;6
14452; 22.6 ; 45.2 ; 11.4 ;2;62;167;0;2;0;2;2;0;1;1;0
14453; 37.7 ; 188.3 ; 11.0 ;5;38;32;0;5;1;4;0;5;2;3;0
14454; 30.2 ; 301.9 ; 14.9 ;10;17;56;0;10;7;3;8;2;3;7;0
14455; 41.1 ; 658.2 ; 14.1 ;16;17;37;0;16;3;13;10;6;5;6;5
14456; 66.6 ; 133.2 ; 70.6 ;2;50;154;0;2;2;0;2;0;1;0;1
14457; 33.1 ; 662.5 ; 19.5 ;20;14;5;0;20;5;15;8;12;7;13;0
14458; 27.2 ; 570.8 ; 19.8 ;21;10;36;5;16;8;13;7;14;14;7;0
14459; 30.4 ; 273.9 ; 8.0 ;9;25;71;0;9;3;6;3;6;3;6;0
14460; 35.1 ; 175.7 ; 15.2 ;5;16;6;0;5;0;5;2;3;2;3;0
14461; 44.1 ; 88.2 ; 10.4 ;2;28;170;0;2;1;1;1;1;0;2;0
14462; 38.6 ; 115.9 ; 12.4 ;3;106;66;0;3;2;1;1;2;1;2;0
14463; 61.3 ; 306.3 ; 44.8 ;5;42;81;0;5;4;1;5;0;2;0;3
14464; 46.8 ; 187.0 ; -   ;4;10;126;4;0;0;4;4;0;0;4;0
14465; 50.1 ; 100.2 ; 37.5 ;2;310;17;0;2;2;0;0;2;1;0;1
14466; 93.3 ; 279.9 ; 55.5 ;3;79;20;0;3;0;3;3;0;0;0;3
14467; 52.7 ; 421.4 ; 0.3 ;8;30;44;0;8;1;7;3;5;0;8;0
14468; 15.0 ; 30.0 ; -   ;2;74;59;0;2;1;1;1;1;2;0;0
14469; 45.9 ; 91.9 ; 1.2 ;2;75;205;0;2;0;2;2;0;0;2;0
14470; 48.4 ; 96.9 ; 38.2 ;2;122;83;0;2;1;1;2;0;1;0;1
14471; 43.9 ; 219.7 ; 9.1 ;5;55;6;0;5;1;4;2;3;0;5;0
14472; 19.7 ; 98.3 ; 2.1 ;5;26;63;0;5;1;4;2;3;5;0;0
14473; 30.2 ; 60.4 ; -   ;2;5;257;0;2;0;2;1;1;0;2;0
14474; 83.7 ; 167.3 ; 31.8 ;2;161;97;0;2;1;1;1;1;0;0;2
14475; 22.4 ; 44.8 ; 11.1 ;2;6;330;0;2;0;2;1;1;1;1;0
14476; 36.6 ; 732.2 ; 13.0 ;20;17;24;0;20;7;13;17;3;7;13;0
14477; 73.0 ; 145.9 ; 32.9 ;2;79;59;0;2;1;1;0;2;0;0;2
14478; 48.4 ; 96.8 ; 38.2 ;2;48;310;0;2;1;1;0;2;1;0;1
14479; 27.0 ; 108.1 ; 16.9 ;4;115;6;0;4;0;4;2;2;3;1;0
14480; 71.7 ; 215.2 ; 22.2 ;3;6;263;0;3;0;3;3;0;0;0;3
14481; 20.0 ; 719.4 ; 6.3 ;36;5;230;0;36;13;23;21;15;36;0;0
14482; 36.1 ; 108.4 ; 11.5 ;3;5;163;0;3;1;2;0;3;1;2;0
14483; 72.2 ; 144.4 ; 5.4 ;2;138;26;0;2;0;2;2;0;0;0;2
14484; 47.5 ; 285.3 ; 1.1 ;6;9;263;0;6;3;3;1;5;0;6;0
14485; 58.5 ; 409.5 ; 16.7 ;7;51;74;0;7;0;7;6;1;0;0;7
14486; 24.6 ; 393.3 ; 8.8 ;16;10;18;0;16;8;8;14;2;11;5;0
14487; 118.6 ; 2,134.0 ; 46.4 ;18;18;28;0;18;10;8;17;1;0;0;18
14488; 47.8 ; 430.1 ; 3.5 ;9;14;278;0;9;1;8;1;8;0;9;0
14489; 46.8 ; 93.5 ; 25.1 ;2;7;62;0;2;0;2;1;1;1;0;1
14490; 39.2 ; 78.4 ; 0.2 ;2;77;183;0;2;0;2;1;1;0;2;0
14491; 23.1 ; 161.6 ; 11.8 ;7;16;5;7;0;1;6;3;4;5;2;0
14492; 68.6 ; 205.9 ; 41.3 ;3;39;129;0;3;1;2;2;1;1;0;2
14493; 39.2 ; 78.4 ; 13.5 ;2;189;10;2;0;0;2;1;1;1;1;0
14494; 53.8 ; 161.4 ; 22.6 ;3;31;320;0;3;0;3;3;0;0;2;1
14495; 52.2 ; 104.4 ; 8.2 ;2;241;94;0;2;1;1;2;0;0;1;1
14496; 44.3 ; 88.7 ; 43.9 ;2;62;173;0;2;0;2;2;0;1;0;1
14497; 62.3 ; 373.8 ; 43.0 ;6;21;20;0;6;0;6;2;4;2;0;4
14498; 51.7 ; 258.6 ; 6.5 ;5;16;41;0;5;0;5;5;0;0;3;2
14499; 62.3 ; 124.7 ; 17.0 ;2;19;230;0;2;0;2;2;0;0;0;2
14500; 32.6 ; 163.0 ; 5.3 ;5;32;23;0;5;1;4;1;4;2;3;0
14501; 45.5 ; 591.6 ; 17.5 ;13;24;5;0;13;3;10;6;7;4;5;4
14502; 43.1 ; 215.6 ; 17.4 ;5;16;40;1;4;3;2;4;1;2;1;2
14503; 17.5 ; 35.0 ; 3.8 ;2;12;144;0;2;2;0;0;2;2;0;0
14504; 33.5 ; 66.9 ; 19.9 ;2;124;154;0;2;1;1;1;1;1;1;0
14505; 44.4 ; 88.8 ; 10.8 ;2;6;272;0;2;0;2;1;1;0;1;1
14506; 28.5 ; 142.7 ; 7.2 ;5;66;77;0;5;3;2;3;2;3;2;0
14507; 51.0 ; 204.0 ; 24.9 ;4;30;171;0;4;2;2;3;1;1;2;1
14508; 30.8 ; 61.6 ; 0.9 ;2;81;251;0;2;0;2;2;0;1;1;0
14509; 50.7 ; 253.7 ; 4.7 ;5;70;7;4;1;1;4;5;0;0;3;2
14510; 46.8 ; 93.5 ; -   ;2;59;104;0;2;0;2;1;1;0;2;0
14511; 27.4 ; 82.1 ; 18.6 ;3;61;101;0;3;2;1;3;0;2;1;0
14512; 32.8 ; 98.3 ; 7.0 ;3;76;146;0;3;1;2;2;1;1;2;0
14513; 49.2 ; 98.3 ; 3.6 ;2;202;15;0;2;0;2;1;1;0;2;0
14514; 26.0 ; 468.2 ; 15.4 ;18;18;22;0;18;6;12;13;5;12;6;0
14515; 30.1 ; 90.2 ; 11.9 ;3;15;5;3;0;0;3;1;2;1;2;0
14516; 18.3 ; 110.0 ; 2.4 ;6;58;29;0;6;2;4;1;5;6;0;0
14517; 47.7 ; 572.7 ; 14.3 ;12;19;20;12;0;3;9;12;0;0;8;4
14518; 34.8 ; 69.6 ; 24.3 ;2;182;136;0;2;1;1;2;0;1;0;1
14519; 50.6 ; 606.9 ; 18.5 ;12;30;93;0;12;4;8;7;5;0;8;4
14520; 15.0 ; 45.0 ; -   ;3;47;167;0;3;0;3;2;1;3;0;0
14521; 39.6 ; 118.9 ; 12.9 ;3;67;5;0;3;0;3;3;0;1;2;0
14522; 79.1 ; 237.4 ; 26.5 ;3;110;5;0;3;0;3;2;1;0;0;3
14523; 36.6 ; 73.2 ; -   ;2;6;213;0;2;2;0;2;0;0;2;0
14524; 25.1 ; 50.1 ; -   ;2;1;68;0;2;0;2;2;0;2;0;0
14525; 43.6 ; 130.8 ; 17.0 ;3;58;36;0;3;1;2;1;2;1;1;1
14526; 19.5 ; 39.0 ; 0.3 ;2;153;206;0;2;1;1;1;1;2;0;0
14527; 21.0 ; 84.1 ; 3.7 ;4;90;78;0;4;1;3;3;1;4;0;0
14528; 40.3 ; 322.7 ; 14.8 ;8;16;9;0;8;7;1;4;4;3;2;3
14529; 17.0 ; 51.1 ; 3.7 ;3;2;197;0;3;2;1;0;3;3;0;0
14530; 39.2 ; 78.4 ; 13.5 ;2;64;15;0;2;0;2;2;0;1;1;0
14531; 17.6 ; 228.5 ; 3.3 ;13;14;16;0;13;10;3;10;3;13;0;0
14532; 36.6 ; 183.0 ; -   ;5;44;15;0;5;1;4;3;2;0;5;0
14533; 32.3 ; 129.2 ; 11.8 ;4;49;40;0;4;1;3;3;1;1;3;0
14534; 16.8 ; 33.6 ; 2.7 ;2;31;218;0;2;2;0;2;0;2;0;0
14535; 72.1 ; 144.1 ; 49.3 ;2;3;233;0;2;1;1;2;0;1;0;1
14536; 17.2 ; 223.0 ; 5.0 ;13;21;24;0;13;6;7;13;0;13;0;0
14537; 30.8 ; 61.7 ; 8.6 ;2;63;209;0;2;0;2;1;1;1;1;0
14538; 68.0 ; 612.0 ; 16.5 ;9;44;2;0;9;6;3;3;6;0;0;9
14539; 36.8 ; 73.7 ; 17.6 ;2;144;179;0;2;0;2;1;1;1;1;0
14540; 49.0 ; 97.9 ; 5.3 ;2;105;169;0;2;0;2;2;0;0;2;0
14541; 36.0 ; 72.0 ; 24.8 ;2;5;300;0;2;0;2;0;2;1;0;1
14542; 24.8 ; 123.9 ; 14.0 ;5;23;62;0;5;0;5;1;4;3;2;0
14543; 45.0 ; 89.9 ; 44.9 ;2;9;266;0;2;1;1;2;0;1;0;1
14544; 16.8 ; 33.6 ; 2.7 ;2;2;258;0;2;1;1;1;1;2;0;0
14545; 51.6 ; 206.5 ; 10.7 ;4;2;389;0;4;1;3;1;3;0;3;1
14546; 26.1 ; 130.6 ; 7.0 ;5;56;58;0;5;3;2;3;2;3;2;0
14547; 20.0 ; 40.1 ; 7.6 ;2;12;143;0;2;2;0;1;1;2;0;0
14548; 39.3 ; 157.4 ; 17.2 ;4;69;0;0;4;0;4;2;2;1;2;1
14549; 27.7 ; 304.7 ; 32.1 ;11;14;155;0;11;10;1;11;0;7;0;4
14550; 60.7 ; 182.2 ; 53.9 ;3;85;50;2;1;2;1;0;3;1;0;2
14551; 44.6 ; 133.8 ; 26.0 ;3;80;70;0;3;1;2;3;0;1;1;1
14552; 36.6 ; 146.4 ; -   ;4;101;29;0;4;2;2;1;3;0;4;0
14553; 22.9 ; 320.0 ; 11.7 ;14;25;35;0;14;8;6;14;0;9;5;0
14554; 50.6 ; 354.0 ; 23.0 ;7;59;13;0;7;0;7;5;2;2;3;2
14555; 40.1 ; 200.4 ; 8.5 ;5;9;15;0;5;1;4;3;2;0;5;0
14556; 41.1 ; 82.3 ; 11.3 ;2;6;268;0;2;0;2;1;1;1;1;0
14557; 40.3 ; 846.8 ; 7.9 ;21;20;3;7;14;12;9;11;10;0;21;0
14558; 27.5 ; 192.4 ; 14.6 ;7;34;77;0;7;5;2;5;2;5;2;0
14559; 29.5 ; 147.4 ; 17.3 ;5;21;56;0;5;5;0;5;0;3;2;0
14560; 21.3 ; 191.5 ; 4.6 ;9;24;99;0;9;0;9;8;1;9;0;0
14561; 59.3 ; 534.0 ; 24.0 ;9;26;31;0;9;1;8;4;5;0;0;9
14562; 48.2 ; 96.3 ; 2.1 ;2;173;104;0;2;1;1;1;1;0;2;0
14563; 61.3 ; 122.6 ; 20.7 ;2;39;26;2;0;0;2;2;0;0;0;2
14564; 30.0 ; 120.0 ; 31.8 ;4;64;93;0;4;4;0;2;2;1;2;1
14565; 26.9 ; 215.4 ; 8.9 ;8;41;6;7;1;0;8;6;2;5;3;0
14566; 86.0 ; 172.1 ; 36.4 ;2;49;201;0;2;1;1;0;2;0;0;2
14567; 28.1 ; 56.3 ; 4.6 ;2;24;83;1;1;0;2;2;0;1;1;0
14568; 53.3 ; 106.6 ; 42.3 ;2;282;16;1;1;1;1;1;1;1;0;1
14569; 52.1 ; 104.2 ; 7.0 ;2;194;99;0;2;0;2;2;0;0;1;1
14570; 73.1 ; 146.2 ; 16.2 ;2;12;20;0;2;0;2;2;0;0;0;2
14571; 67.5 ; 202.6 ; 28.8 ;3;114;31;0;3;1;2;2;1;0;0;3
14572; 36.6 ; 73.3 ; 17.3 ;2;121;16;0;2;0;2;1;1;1;1;0
14573; 56.1 ; 280.5 ; 22.4 ;5;78;42;0;5;0;5;4;1;0;0;5
14574; 91.4 ; 365.5 ; 37.9 ;4;2;247;0;4;1;3;1;3;0;0;4
14575; 17.3 ; 34.7 ; 3.5 ;2;132;52;2;0;0;2;2;0;2;0;0
14576; 30.8 ; 61.7 ; 8.6 ;2;17;26;0;2;1;1;1;1;1;1;0
14577; 43.1 ; 172.4 ; 8.4 ;4;98;152;0;4;0;4;4;0;0;4;0
14578; 48.8 ; 487.9 ; 12.3 ;10;29;29;0;10;7;3;5;5;0;7;3
14579; 45.3 ; 90.6 ; 2.2 ;2;220;11;2;0;0;2;0;2;0;2;0
14580; 75.7 ; 227.1 ; 12.8 ;3;40;175;0;3;1;2;1;2;0;0;3
14581; 15.7 ; 31.4 ; 1.1 ;2;232;73;0;2;0;2;0;2;2;0;0
14582; 36.3 ; 72.5 ; 17.3 ;2;27;206;0;2;1;1;1;1;1;1;0
14583; 47.2 ; 613.7 ; 0.9 ;13;23;20;0;13;0;13;1;12;0;13;0
14584; 42.1 ; 589.5 ; 34.4 ;14;32;9;0;14;7;7;2;12;5;4;5
14585; 70.3 ; 421.7 ; 8.4 ;6;34;78;0;6;1;5;2;4;0;0;6
14586; 66.6 ; 133.2 ; 28.6 ;2;68;94;0;2;0;2;2;0;0;0;2
14587; 54.1 ; 162.2 ; 14.2 ;3;30;224;0;3;2;1;1;2;0;2;1
14588; 15.9 ; 63.7 ; 0.3 ;4;12;164;0;4;3;1;4;0;4;0;0
14589; 46.8 ; 93.5 ; 25.4 ;2;5;275;0;2;1;1;1;1;1;0;1
14590; 32.5 ; 162.6 ; 20.8 ;5;43;43;2;3;2;3;0;5;2;3;0
14591; 46.3 ; 1,157.5 ; 5.6 ;25;12;0;0;25;0;25;25;0;0;25;0
14592; 58.4 ; 233.4 ; 7.5 ;4;23;5;0;4;2;2;1;3;0;0;4
14593; 48.8 ; 243.8 ; 2.7 ;5;18;0;0;5;1;4;4;1;0;5;0
14594; 67.6 ; 676.3 ; 31.0 ;10;34;11;0;10;4;6;8;2;0;0;10
14595; 67.5 ; 809.5 ; 16.6 ;12;13;0;0;12;0;12;2;10;0;0;12
14596; 26.8 ; 80.4 ; 11.4 ;3;67;48;0;3;2;1;3;0;2;1;0
14597; 70.1 ; 140.3 ; 35.0 ;2;11;368;0;2;0;2;1;1;0;0;2
14598; 30.1 ; 120.5 ; 0.1 ;4;37;36;3;1;1;3;2;2;0;4;0
14599; 53.6 ; 214.5 ; 19.5 ;4;45;28;0;4;1;3;3;1;0;3;1
14600; 17.5 ; 87.4 ; 6.5 ;5;77;55;0;5;1;4;0;5;5;0;0
14601; 21.2 ; 126.9 ; 11.2 ;6;25;266;0;6;4;2;0;6;4;2;0
14602; 88.4 ; 1,060.3 ; 44.8 ;12;32;29;0;12;4;8;12;0;0;0;12
14603; 19.2 ; 229.9 ; 4.0 ;12;18;11;0;12;5;7;5;7;12;0;0
14604; 15.0 ; 30.0 ; -   ;2;6;80;0;2;0;2;2;0;2;0;0
14605; 28.5 ; 85.4 ; 17.9 ;3;18;29;0;3;2;1;1;2;2;1;0
14606; 74.0 ; 370.1 ; 25.7 ;5;57;5;0;5;1;4;3;2;0;0;5
14607; 26.5 ; 185.3 ; 7.9 ;7;22;231;0;7;1;6;4;3;5;2;0
14608; 48.7 ; 146.0 ; 3.5 ;3;86;185;0;3;0;3;3;0;0;3;0
14609; 23.5 ; 188.3 ; 18.3 ;8;27;156;0;8;3;5;4;4;5;3;0
14610; 60.8 ; 729.2 ; 45.7 ;12;28;17;0;12;5;7;3;9;4;0;8
14611; 65.9 ; 395.1 ; 40.5 ;6;8;225;0;6;1;5;1;5;2;0;4
14612; 21.7 ; 65.1 ; 6.2 ;3;49;101;3;0;3;0;3;0;3;0;0
14613; 25.1 ; 50.1 ; -   ;2;12;154;0;2;1;1;2;0;2;0;0
14614; 32.9 ; 560.1 ; 12.6 ;17;18;4;0;17;10;7;7;10;6;11;0
14615; 25.0 ; 124.9 ; 9.9 ;5;23;65;0;5;4;1;2;3;3;2;0
14616; 27.3 ; 191.2 ; 13.8 ;7;28;99;0;7;0;7;1;6;5;2;0
14617; 44.1 ; 2,074.6 ; 22.1 ;47;5;20;0;47;22;25;39;8;16;15;16
14618; 121.9 ; 365.8 ; 65.0 ;3;223;20;0;3;0;3;3;0;0;0;3
14619; 15.0 ; 30.0 ; -   ;2;31;193;0;2;2;0;2;0;2;0;0
14620; 35.1 ; 175.4 ; 15.8 ;5;36;17;5;0;1;4;4;1;2;3;0
14621; 19.2 ; 95.8 ; 7.0 ;5;29;119;0;5;4;1;1;4;5;0;0
14622; 74.8 ; 373.9 ; 27.2 ;5;25;146;0;5;0;5;5;0;0;0;5
14623; 60.9 ; 304.6 ; 18.6 ;5;75;78;0;5;0;5;4;1;0;0;5
14624; 30.8 ; 61.7 ; 8.6 ;2;83;236;0;2;0;2;1;1;1;1;0
14625; 32.4 ; 64.8 ; 21.5 ;2;14;104;0;2;0;2;0;2;1;1;0
14626; 25.8 ; 51.6 ; 16.2 ;2;3;121;1;1;1;1;0;2;1;1;0
14627; 53.5 ; 107.0 ; 9.1 ;2;23;68;0;2;1;1;2;0;0;1;1
14628; 44.9 ; 224.6 ; 12.7 ;5;55;10;0;5;1;4;5;0;0;3;2
14629; 60.5 ; 181.5 ; 65.9 ;3;37;217;0;3;1;2;1;2;1;0;2
14630; 54.2 ; 108.5 ; 4.9 ;2;92;69;0;2;0;2;2;0;0;1;1
14631; 24.3 ; 169.8 ; 8.9 ;7;37;93;0;7;4;3;5;2;5;2;0
14632; 25.2 ; 327.4 ; 21.7 ;13;20;78;0;13;7;6;4;9;9;4;0
14633; 60.7 ; 121.4 ; 18.8 ;2;13;5;0;2;0;2;2;0;0;0;2
14634; 22.5 ; 112.4 ; 13.3 ;5;49;118;0;5;2;3;1;4;3;2;0
14635; 46.8 ; 140.3 ; -   ;3;22;240;0;3;2;1;3;0;0;3;0
14636; 38.4 ; 76.8 ; 20.0 ;2;32;103;0;2;1;1;0;2;1;0;1
14637; 21.3 ; 85.0 ; 4.2 ;4;82;15;0;4;1;3;4;0;4;0;0
14638; 53.7 ; 376.1 ; 4.2 ;7;66;2;0;7;5;2;3;4;0;5;2
14639; 37.7 ; 113.2 ; 33.0 ;3;49;22;0;3;1;2;3;0;1;1;1
14640; 24.7 ; 49.4 ; 14.6 ;2;5;341;0;2;1;1;2;0;1;1;0
14641; 50.0 ; 449.9 ; 17.1 ;9;23;79;0;9;0;9;1;8;0;6;3
14642; 37.1 ; 556.9 ; 10.2 ;15;14;79;0;15;3;12;8;7;5;10;0
14643; 25.0 ; 50.0 ; 0.1 ;2;11;244;0;2;2;0;0;2;2;0;0
14644; 26.6 ; 106.5 ; 14.9 ;4;51;77;0;4;1;3;2;2;3;1;0
14645; 55.5 ; 277.6 ; 24.6 ;5;16;141;0;5;1;4;2;3;0;0;5
14646; 61.6 ; 615.7 ; 20.6 ;10;37;94;0;10;4;6;9;1;0;0;10
14647; 47.5 ; 94.9 ; 1.1 ;2;181;1;0;2;0;2;1;1;0;2;0
14648; 53.3 ; 480.0 ; 15.3 ;9;21;5;0;9;0;9;9;0;0;6;3
14649; 48.2 ; 96.4 ; -   ;2;1;11;2;0;1;1;0;2;0;2;0
14650; 76.8 ; 230.4 ; 27.1 ;3;9;0;0;3;0;3;3;0;0;0;3
14651; 43.0 ; 129.1 ; 10.9 ;3;157;104;1;2;2;1;2;1;0;3;0
14652; 25.8 ; 51.6 ; 11.3 ;2;29;2;0;2;1;1;2;0;1;1;0
14653; 51.5 ; 515.0 ; 24.7 ;10;10;206;0;10;1;9;10;0;3;4;3
14654; 62.4 ; 997.8 ; 42.5 ;16;23;53;0;16;6;10;4;12;5;0;11
14655; 51.7 ; 155.1 ; 8.1 ;3;75;136;0;3;2;1;0;3;0;2;1
14656; 42.9 ; 128.6 ; 6.2 ;3;86;15;1;2;1;2;2;1;0;3;0
14657; 39.5 ; 355.7 ; 22.3 ;9;19;58;0;9;2;7;4;5;3;3;3
14658; 41.9 ; 209.6 ; 16.6 ;5;29;200;0;5;2;3;1;4;2;1;2
14659; 39.2 ; 78.4 ; 13.5 ;2;109;23;0;2;2;0;0;2;1;1;0
14660; 20.9 ; 83.6 ; 12.5 ;4;28;14;0;4;1;3;4;0;3;1;0
14661; 50.7 ; 202.7 ; 22.1 ;4;41;83;0;4;2;2;2;2;1;2;1
14662; 20.0 ; 40.1 ; 7.6 ;2;6;257;0;2;0;2;1;1;2;0;0
14663; 51.0 ; 204.0 ; 21.3 ;4;17;15;0;4;0;4;3;1;1;2;1
14664; 49.0 ; 245.1 ; 1.5 ;5;23;5;0;5;0;5;4;1;0;5;0
14665; 56.5 ; 169.5 ; 36.5 ;3;104;15;0;3;0;3;0;3;1;0;2
14666; 51.6 ; 206.3 ; 5.0 ;4;11;15;0;4;0;4;2;2;0;3;1
14667; 46.8 ; 93.5 ; -   ;2;49;142;0;2;0;2;2;0;0;2;0
14668; 22.6 ; 113.1 ; 7.3 ;5;53;40;0;5;2;3;3;2;5;0;0
14669; 20.5 ; 122.9 ; 4.4 ;6;21;37;0;6;0;6;5;1;6;0;0
14670; 49.9 ; 199.5 ; 30.5 ;4;45;131;0;4;2;2;3;1;1;2;1
14671; 50.4 ; 151.3 ; 6.8 ;3;32;242;0;3;0;3;3;0;0;2;1
14672; 35.5 ; 177.4 ; 12.4 ;5;59;24;0;5;3;2;2;3;2;3;0
14673; 73.3 ; 293.3 ; 21.9 ;4;87;41;0;4;2;2;3;1;0;0;4
14674; 49.9 ; 99.7 ; 1.7 ;2;12;252;0;2;0;2;1;1;0;2;0
14675; 35.7 ; 107.1 ; 10.1 ;3;88;90;0;3;1;2;2;1;1;2;0
14676; 55.1 ; 716.5 ; 30.5 ;13;14;3;0;13;7;6;10;3;4;0;9
14677; 46.8 ; 140.3 ; -   ;3;76;221;0;3;0;3;3;0;0;3;0
14678; 42.1 ; 126.3 ; 15.7 ;3;95;99;0;3;1;2;3;0;1;1;1
14679; 23.1 ; 115.3 ; 4.8 ;5;17;210;0;5;1;4;3;2;5;0;0
14680; 17.1 ; 358.6 ; 4.5 ;21;9;5;0;21;2;19;19;2;21;0;0
14681; 44.4 ; 177.7 ; 17.5 ;4;20;3;0;4;3;1;3;1;1;2;1
14682; 32.6 ; 65.1 ; 10.1 ;2;25;10;0;2;0;2;2;0;1;1;0
14683; 60.7 ; 303.5 ; 5.2 ;5;40;99;0;5;0;5;5;0;0;0;5
14684; 50.5 ; 353.3 ; 22.1 ;7;32;87;0;7;4;3;3;4;2;3;2
14685; 86.0 ; 172.0 ; 57.7 ;2;12;38;0;2;1;1;1;1;1;0;1
14686; 50.5 ; 807.3 ; 12.4 ;16;23;16;0;16;1;15;15;1;0;11;5
14687; 52.9 ; 105.8 ; 0.5 ;2;90;69;0;2;1;1;0;2;0;2;0
14688; 64.8 ; 194.3 ; 14.8 ;3;135;47;0;3;0;3;3;0;0;0;3
14689; 44.8 ; 134.4 ; 3.6 ;3;16;233;0;3;1;2;1;2;0;3;0
14690; 28.5 ; 142.5 ; 16.0 ;5;9;257;0;5;4;1;5;0;3;2;0
14691; 29.0 ; 58.1 ; 11.3 ;2;51;254;0;2;2;0;0;2;1;1;0
14692; 33.4 ; 66.8 ; 4.8 ;2;106;52;2;0;0;2;0;2;1;1;0
14693; 30.0 ; 240.2 ; 0.8 ;8;32;11;0;8;2;6;5;3;3;5;0
14694; 48.9 ; 97.8 ; 3.2 ;2;61;293;0;2;1;1;2;0;0;2;0
14695; 19.6 ; 98.0 ; 3.4 ;5;39;131;0;5;1;4;4;1;5;0;0
14696; 20.0 ; 40.1 ; 7.6 ;2;33;113;0;2;2;0;0;2;2;0;0
14697; 20.7 ; 62.2 ; 1.9 ;3;90;95;0;3;2;1;3;0;3;0;0
14698; 54.4 ; 163.1 ; 29.5 ;3;28;68;0;3;1;2;3;0;1;1;1
14699; 27.8 ; 167.0 ; 12.5 ;6;24;237;0;6;0;6;6;0;4;2;0
14700; 29.4 ; 88.2 ; 17.7 ;3;11;278;0;3;1;2;1;2;2;1;0
14701; 80.6 ; 241.9 ; 74.4 ;3;47;125;0;3;0;3;3;0;1;0;2
14702; 22.9 ; 68.7 ; 4.0 ;3;8;192;3;0;3;0;2;1;3;0;0
14703; 27.4 ; 329.1 ; 17.3 ;12;12;11;0;12;2;10;7;5;8;4;0
14704; 50.7 ; 152.2 ; 10.9 ;3;25;230;0;3;0;3;0;3;0;2;1
14705; 15.0 ; 30.0 ; -   ;2;25;20;0;2;0;2;1;1;2;0;0
14706; 17.9 ; 250.6 ; 5.8 ;14;21;73;0;14;1;13;10;4;14;0;0
14707; 17.2 ; 34.4 ; 3.3 ;2;43;218;0;2;2;0;2;0;2;0;0
14708; 57.2 ; 171.6 ; 47.4 ;3;100;99;0;3;2;1;3;0;1;0;2
14709; 30.2 ; 60.4 ; -   ;2;37;51;0;2;2;0;0;2;0;2;0
14710; 35.5 ; 177.7 ; 12.9 ;5;72;32;0;5;0;5;3;2;2;3;0
14711; 42.8 ; 299.8 ; 13.3 ;7;33;63;0;7;0;7;3;4;2;3;2
14712; 17.7 ; 159.3 ; 5.1 ;9;19;7;0;9;2;7;4;5;9;0;0
14713; 24.4 ; 48.8 ; 8.7 ;2;133;199;0;2;0;2;0;2;1;1;0
14714; 51.4 ; 102.7 ; 0.5 ;2;162;59;0;2;1;1;2;0;0;2;0
14715; 33.7 ; 877.4 ; 12.8 ;26;14;2;2;24;20;6;3;23;9;17;0
14716; 29.4 ; 88.3 ; 15.9 ;3;50;189;0;3;1;2;1;2;2;1;0
14717; 43.9 ; 175.5 ; 28.7 ;4;25;88;0;4;1;3;3;1;1;2;1
14718; 42.9 ; 85.9 ; 12.9 ;2;6;288;0;2;0;2;0;2;1;0;1
14719; 51.4 ; 308.2 ; 5.5 ;6;54;29;0;6;3;3;1;5;0;4;2
14720; 30.7 ; 122.7 ; 11.9 ;4;147;26;0;4;0;4;1;3;1;3;0
14721; 65.4 ; 261.8 ; 15.5 ;4;115;120;0;4;0;4;4;0;0;0;4
14722; 15.0 ; 45.0 ; -   ;3;6;267;0;3;1;2;1;2;3;0;0
14723; 25.1 ; 150.8 ; 13.6 ;6;23;11;0;6;2;4;2;4;4;2;0
14724; 41.7 ; 249.9 ; 24.5 ;6;19;20;0;6;1;5;5;1;2;2;2
14725; 52.4 ; 209.5 ; 8.6 ;4;25;337;0;4;1;3;1;3;0;3;1
14726; 70.2 ; 420.9 ; 12.2 ;6;36;125;0;6;3;3;4;2;0;0;6
14727; 55.2 ; 110.4 ; 9.8 ;2;134;188;0;2;1;1;1;1;0;0;2
14728; 41.6 ; 83.3 ; 10.5 ;2;25;153;0;2;0;2;2;0;0;2;0
14729; 44.1 ; 132.2 ; 9.5 ;3;128;68;0;3;1;2;2;1;0;3;0
14730; 25.8 ; 51.6 ; 16.2 ;2;11;116;0;2;0;2;0;2;1;1;0
14731; 83.3 ; 333.0 ; 26.8 ;4;86;83;0;4;1;3;4;0;0;0;4
14732; 26.1 ; 78.4 ; 12.9 ;3;15;169;0;3;0;3;1;2;2;1;0
14733; 106.7 ; 213.4 ; 7.0 ;2;12;146;0;2;0;2;2;0;0;0;2
14734; 39.2 ; 235.3 ; 15.5 ;6;36;68;0;6;5;1;2;4;2;4;0
14735; 47.0 ; 94.1 ; 19.4 ;2;37;218;0;2;2;0;0;2;1;0;1
14736; 49.3 ; 246.5 ; 36.0 ;5;70;57;0;5;0;5;1;4;2;1;2
14737; 35.3 ; 176.5 ; 19.8 ;5;37;77;0;5;4;1;1;4;2;1;2
14738; 25.1 ; 100.3 ; -   ;4;13;22;0;4;0;4;4;0;4;0;0
14739; 35.2 ; 352.3 ; 16.1 ;10;23;78;0;10;1;9;4;6;3;7;0
14740; 59.6 ; 119.3 ; 5.4 ;2;87;100;0;2;0;2;0;2;0;0;2
14741; 36.9 ; 73.8 ; 17.7 ;2;151;64;0;2;0;2;0;2;1;1;0
14742; 34.6 ; 138.5 ; 14.9 ;4;40;212;0;4;2;2;1;3;1;3;0
14743; 21.0 ; 105.2 ; 5.9 ;5;27;295;0;5;2;3;1;4;5;0;0
14744; 49.6 ; 198.3 ; -   ;4;95;14;0;4;2;2;1;3;0;4;0
14745; 46.9 ; 516.1 ; 14.5 ;11;25;31;0;11;4;7;6;5;0;7;4
14746; 15.0 ; 74.9 ; -   ;5;47;53;1;4;0;5;3;2;5;0;0
14747; 25.0 ; 100.0 ; 13.0 ;4;9;292;0;4;3;1;4;0;3;1;0
14748; 31.2 ; 62.4 ; -   ;2;16;158;0;2;1;1;0;2;0;2;0
14749; 21.5 ; 43.1 ; 5.3 ;2;95;69;0;2;1;1;1;1;2;0;0
14750; 30.8 ; 184.9 ; 19.7 ;6;15;170;0;6;2;4;2;4;2;4;0
14751; 51.8 ; 155.3 ; 39.6 ;3;15;89;0;3;0;3;2;1;1;1;1
14752; 32.2 ; 64.4 ; 3.3 ;2;1;265;0;2;2;0;1;1;1;1;0
14753; 47.1 ; 94.2 ; 0.5 ;2;302;26;0;2;0;2;0;2;0;2;0
14754; 34.0 ; 169.9 ; 16.4 ;5;22;200;2;3;2;3;3;2;2;3;0
14755; 38.2 ; 878.4 ; 19.2 ;23;13;108;0;23;11;12;18;5;8;7;8
14756; 24.2 ; 339.0 ; 9.6 ;14;13;1;14;0;0;14;2;12;9;5;0
14757; 38.9 ; 194.7 ; 30.4 ;5;32;210;0;5;1;4;0;5;2;1;2
14758; 22.6 ; 45.2 ; 11.4 ;2;1;148;0;2;1;1;0;2;1;1;0
14759; 46.7 ; 93.4 ; 10.8 ;2;25;16;0;2;0;2;0;2;0;1;1
14760; 49.6 ; 99.3 ; 4.3 ;2;44;112;0;2;2;0;0;2;0;2;0
14761; 27.7 ; 415.5 ; 6.2 ;15;14;29;0;15;5;10;4;11;10;5;0
14762; 49.3 ; 197.4 ; 2.2 ;4;68;187;0;4;2;2;2;2;0;4;0
14763; 46.8 ; 93.5 ; -   ;2;67;159;0;2;1;1;2;0;0;2;0
14764; 32.7 ; 130.7 ; 14.0 ;4;91;31;0;4;2;2;2;2;1;3;0
14765; 15.0 ; 74.9 ; -   ;5;3;234;0;5;5;0;1;4;5;0;0
14766; 49.3 ; 295.9 ; 7.1 ;6;72;74;0;6;0;6;4;2;0;4;2
14767; 20.0 ; 40.1 ; 7.6 ;2;184;70;0;2;2;0;0;2;2;0;0
14768; 20.9 ; 732.1 ; 2.5 ;35;10;10;0;35;11;24;8;27;35;0;0
14769; 59.0 ; 353.8 ; 25.8 ;6;50;11;0;6;0;6;4;2;0;0;6
14770; 38.6 ; 386.1 ; 30.4 ;10;29;0;0;10;2;8;7;3;3;4;3
14771; 36.9 ; 147.6 ; 8.3 ;4;51;179;0;4;3;1;3;1;1;3;0
14772; 81.8 ; 327.3 ; 24.8 ;4;14;194;0;4;2;2;4;0;0;0;4
14773; 65.9 ; 263.4 ; 12.2 ;4;104;11;0;4;1;3;3;1;0;0;4
14774; 71.8 ; 215.4 ; -   ;3;13;163;0;3;1;2;2;1;0;0;3
14775; 59.2 ; 296.1 ; 35.5 ;5;27;236;0;5;0;5;3;2;2;0;3
14776; 17.1 ; 51.4 ; 4.0 ;3;23;356;0;3;3;0;3;0;3;0;0
14777; 47.6 ; 237.9 ; 22.3 ;5;35;236;0;5;0;5;3;2;2;1;2
14778; 36.9 ; 73.8 ; 10.1 ;2;105;183;0;2;1;1;2;0;1;1;0
14779; 51.4 ; 102.7 ; 0.5 ;2;230;92;0;2;1;1;1;1;0;2;0
14780; 104.6 ; 209.2 ; 47.0 ;2;48;179;0;2;1;1;1;1;0;0;2
14781; 49.2 ; 98.4 ; 51.2 ;2;44;93;1;1;1;1;1;1;1;0;1
14782; 25.8 ; 51.6 ; 16.2 ;2;95;36;0;2;0;2;2;0;1;1;0
14783; 56.7 ; 113.4 ; 17.3 ;2;247;62;0;2;0;2;1;1;0;0;2
14784; 31.1 ; 62.2 ; 15.5 ;2;23;204;2;0;1;1;2;0;1;1;0
14785; 33.2 ; 66.5 ; 25.2 ;2;15;10;0;2;1;1;0;2;1;0;1
14786; 46.8 ; 140.3 ; -   ;3;105;160;0;3;1;2;3;0;0;3;0
14787; 15.0 ; 74.9 ; -   ;5;23;199;0;5;2;3;2;3;5;0;0
14788; 34.1 ; 238.7 ; 26.3 ;7;28;131;0;7;2;5;3;4;2;3;2
14789; 45.8 ; 229.2 ; 2.2 ;5;23;41;0;5;2;3;3;2;0;5;0
14790; 50.7 ; 253.4 ; 15.7 ;5;53;33;0;5;1;4;1;4;0;3;2
14791; 68.3 ; 273.3 ; 20.0 ;4;23;57;0;4;2;2;3;1;0;0;4
14792; 46.6 ; 372.8 ; 10.2 ;8;39;10;0;8;1;7;4;4;0;5;3
14793; 49.6 ; 843.0 ; 5.7 ;17;13;7;0;17;10;7;3;14;0;11;6
14794; 29.1 ; 58.2 ; 4.9 ;2;15;87;2;0;1;1;1;1;1;1;0
14795; 26.6 ; 133.2 ; 9.2 ;5;45;0;0;5;0;5;5;0;3;2;0
14796; 29.3 ; 205.3 ; 14.8 ;7;37;10;0;7;0;7;7;0;5;2;0
14797; 55.7 ; 779.9 ; 17.4 ;14;10;102;0;14;5;9;3;11;0;0;14
14798; 43.4 ; 86.8 ; 19.8 ;2;14;309;0;2;1;1;1;1;1;0;1
14799; 61.0 ; 304.9 ; 9.8 ;5;36;132;0;5;2;3;1;4;0;0;5
14800; 36.6 ; 146.4 ; 5.3 ;4;25;138;0;4;4;0;1;3;0;4;0
14801; 66.2 ; 595.6 ; 29.7 ;9;42;47;0;9;0;9;7;2;0;0;9
14802; 52.4 ; 104.7 ; 5.5 ;2;284;40;0;2;2;0;1;1;0;1;1
14803; 25.1 ; 50.1 ; -   ;2;6;104;0;2;1;1;0;2;2;0;0
14804; 52.5 ; 105.0 ; -   ;2;24;204;1;1;0;2;2;0;0;2;0
14805; 16.9 ; 50.7 ; 3.5 ;3;20;96;0;3;2;1;3;0;3;0;0
14806; 31.0 ; 123.8 ; 2.8 ;4;9;110;0;4;0;4;1;3;1;3;0
14807; 51.0 ; 152.9 ; 25.5 ;3;59;225;0;3;0;3;3;0;1;1;1
14808; 17.3 ; 34.7 ; 3.5 ;2;21;245;0;2;1;1;2;0;2;0;0
14809; 32.2 ; 225.3 ; 15.4 ;7;12;1;0;7;5;2;4;3;2;5;0
14810; 42.1 ; 84.3 ; 11.1 ;2;14;213;0;2;1;1;1;1;0;2;0
14811; 31.9 ; 223.1 ; 4.1 ;7;16;5;0;7;0;7;7;0;2;5;0
14812; 30.3 ; 60.6 ; 10.1 ;2;11;206;0;2;1;1;2;0;1;1;0
14813; 23.7 ; 94.7 ; 12.1 ;4;15;2;0;4;3;1;2;2;3;1;0
14814; 21.2 ; 148.2 ; 3.3 ;7;37;47;0;7;0;7;4;3;7;0;0
14815; 41.2 ; 123.6 ; 11.8 ;3;67;153;0;3;1;2;1;2;1;2;0
14816; 85.2 ; 255.6 ; 22.9 ;3;27;170;0;3;1;2;2;1;0;0;3
14817; 31.1 ; 155.4 ; 24.4 ;5;20;79;0;5;0;5;1;4;2;1;2
14818; 15.0 ; 30.0 ; -   ;2;2;266;0;2;1;1;2;0;2;0;0
14819; 106.8 ; 213.5 ; 17.7 ;2;220;78;0;2;0;2;2;0;0;0;2
14820; 36.6 ; 73.2 ; -   ;2;5;21;0;2;0;2;2;0;0;2;0
14821; 18.3 ; 91.7 ; 5.5 ;5;62;32;0;5;1;4;3;2;5;0;0
14822; 73.9 ; 147.7 ; 52.5 ;2;38;110;0;2;0;2;2;0;1;0;1
14823; 47.8 ; 191.3 ; 2.3 ;4;27;211;0;4;0;4;1;3;0;4;0
14824; 76.4 ; 1,070.2 ; 23.2 ;14;11;3;0;14;10;4;7;7;0;0;14
14825; 18.9 ; 698.5 ; 3.4 ;37;7;4;0;37;26;11;30;7;37;0;0
14826; 30.8 ; 215.9 ; 10.6 ;7;3;260;0;7;3;4;3;4;2;5;0
14827; 63.2 ; 126.5 ; 49.5 ;2;162;83;1;1;2;0;2;0;1;0;1
14828; 25.1 ; 100.3 ; -   ;4;31;273;0;4;2;2;2;2;4;0;0
14829; 25.0 ; 74.9 ; 18.3 ;3;48;20;0;3;2;1;1;2;2;1;0
14830; 35.8 ; 107.4 ; 10.7 ;3;41;26;0;3;1;2;2;1;1;2;0
14831; 52.3 ; 104.5 ; 20.2 ;2;5;116;0;2;0;2;1;1;0;1;1
14832; 33.3 ; 66.6 ; 1.6 ;2;6;274;0;2;0;2;0;2;0;2;0
14833; 29.9 ; 149.3 ; 13.4 ;5;8;290;0;5;4;1;1;4;3;2;0
14834; 22.5 ; 44.9 ; 11.2 ;2;99;62;0;2;1;1;1;1;1;1;0
14835; 58.1 ; 116.1 ; 2.9 ;2;110;20;2;0;1;1;0;2;0;0;2
14836; 47.1 ; 94.2 ; -   ;2;324;124;0;2;1;1;0;2;0;2;0
14837; 20.4 ; 40.9 ; 1.0 ;2;7;41;0;2;1;1;0;2;2;0;0
14838; 15.1 ; 166.1 ; 0.4 ;11;33;6;0;11;4;7;8;3;11;0;0
14839; 56.9 ; 910.0 ; 20.8 ;16;14;42;0;16;8;8;11;5;0;0;16
14840; 25.5 ; 127.6 ; 5.5 ;5;20;79;5;0;1;4;3;2;3;2;0
14841; 15.0 ; 45.0 ; -   ;3;16;60;2;1;3;0;3;0;3;0;0
14842; 15.0 ; 45.0 ; -   ;3;103;110;0;3;2;1;1;2;3;0;0
14843; 16.9 ; 118.0 ; 5.6 ;7;45;2;0;7;3;4;4;3;7;0;0
14844; 36.6 ; 329.3 ; -   ;9;35;2;0;9;1;8;1;8;0;9;0
14845; 16.7 ; 133.5 ; 2.9 ;8;13;65;0;8;4;4;2;6;8;0;0
14846; 73.5 ; 147.0 ; 21.5 ;2;31;226;0;2;0;2;1;1;0;0;2
14847; 42.2 ; 463.8 ; 31.9 ;11;23;9;0;11;4;7;5;6;4;3;4
14848; 21.8 ; 65.5 ; -   ;3;4;268;0;3;2;1;2;1;3;0;0
14849; 83.2 ; 166.3 ; 39.3 ;2;194;125;0;2;0;2;2;0;0;0;2
14850; 45.8 ; 137.5 ; 11.3 ;3;94;110;0;3;0;3;3;0;0;2;1
14851; 47.8 ; 1,577.3 ; 18.9 ;33;10;3;0;33;16;17;10;23;11;11;11
14852; 83.3 ; 416.3 ; 25.3 ;5;45;173;0;5;0;5;2;3;0;0;5
14853; 30.2 ; 60.4 ; -   ;2;85;168;0;2;1;1;0;2;0;2;0
14854; 57.6 ; 288.2 ; 31.8 ;5;32;111;0;5;2;3;2;3;2;0;3
14855; 23.5 ; 117.3 ; 3.1 ;5;32;8;0;5;0;5;2;3;5;0;0
14856; 33.2 ; 66.5 ; 20.2 ;2;114;56;0;2;1;1;1;1;1;1;0
14857; 26.5 ; 265.5 ; 11.4 ;10;16;38;0;10;6;4;4;6;7;3;0
14858; 67.8 ; 271.4 ; 7.6 ;4;71;120;0;4;0;4;4;0;0;0;4
14859; 45.0 ; 360.2 ; 11.8 ;8;44;14;0;8;3;5;4;4;0;5;3
14860; 32.1 ; 224.4 ; 17.7 ;7;38;47;0;7;2;5;4;3;2;5;0
14861; 72.2 ; 2,236.9 ; 21.1 ;31;13;16;0;31;12;19;13;18;0;0;31
14862; 62.4 ; 124.8 ; 16.2 ;2;32;173;1;1;0;2;1;1;0;0;2
14863; 230.8 ; 1,154.1 ; 170.0 ;5;2;251;0;5;2;3;2;3;0;0;5
14864; 83.1 ; 996.9 ; 17.0 ;12;25;31;0;12;0;12;8;4;0;0;12
14865; 27.2 ; 842.1 ; 17.6 ;31;10;14;0;31;13;18;15;16;21;10;0
14866; 49.8 ; 199.2 ; 5.4 ;4;123;36;0;4;1;3;3;1;0;3;1
14867; 43.0 ; 86.1 ; 5.6 ;2;88;99;0;2;0;2;0;2;0;2;0
14868; 105.0 ; 210.1 ; -   ;2;5;341;0;2;0;2;2;0;0;0;2
14869; 61.1 ; 244.5 ; 10.8 ;4;61;36;0;4;0;4;1;3;0;0;4
14870; 45.3 ; 317.4 ; 5.1 ;7;40;5;0;7;0;7;3;4;0;7;0
14871; 70.5 ; 141.0 ; 34.5 ;2;96;99;0;2;0;2;2;0;0;0;2
14872; 47.1 ; 94.2 ; 0.5 ;2;112;75;0;2;1;1;2;0;0;2;0
14873; 70.6 ; 211.9 ; 8.5 ;3;81;227;0;3;0;3;1;2;0;0;3
14874; 24.5 ; 146.7 ; 12.3 ;6;2;180;0;6;4;2;2;4;4;2;0
14875; 51.4 ; 257.2 ; 6.6 ;5;99;13;1;4;3;2;3;2;0;3;2
14876; 86.2 ; 172.3 ; 17.3 ;2;132;141;0;2;0;2;1;1;0;0;2
14877; 18.0 ; 36.1 ; 4.6 ;2;11;197;0;2;2;0;0;2;2;0;0
14878; 65.7 ; 131.3 ; 3.7 ;2;13;10;0;2;0;2;2;0;0;0;2
14879; 36.7 ; 146.9 ; 9.1 ;4;7;29;0;4;1;3;1;3;1;3;0
14880; 44.1 ; 617.0 ; 11.9 ;14;32;12;0;14;2;12;10;4;0;9;5
14881; 48.4 ; 193.8 ; 2.4 ;4;37;122;0;4;2;2;0;4;0;4;0
14882; 46.2 ; 369.4 ; 9.2 ;8;9;26;0;8;3;5;1;7;0;5;3
14883; 52.0 ; 104.1 ; 25.5 ;2;43;320;0;2;0;2;2;0;1;0;1
14884; 39.4 ; 433.9 ; 22.5 ;11;15;5;0;11;3;8;6;5;4;3;4
14885; 51.5 ; 257.7 ; 3.8 ;5;38;62;0;5;0;5;5;0;0;3;2
14886; 60.3 ; 1,446.2 ; 23.3 ;24;14;11;0;24;10;14;23;1;0;0;24
14887; 46.8 ; 140.5 ; 30.0 ;3;9;115;0;3;0;3;2;1;1;1;1
14888; 25.2 ; 100.9 ; 6.6 ;4;50;9;0;4;3;1;4;0;3;1;0
14889; 28.7 ; 86.1 ; 18.4 ;3;60;1;0;3;2;1;2;1;2;1;0
14890; 29.9 ; 119.4 ; 7.0 ;4;28;226;0;4;1;3;1;3;3;1;0
14891; 39.7 ; 397.3 ; 12.5 ;10;13;120;0;10;4;6;2;8;3;7;0
14892; 44.7 ; 759.6 ; 20.6 ;17;16;61;0;17;14;3;3;14;6;5;6
14893; 34.0 ; 67.9 ; 13.3 ;2;5;283;0;2;0;2;2;0;1;1;0
14894; 36.4 ; 437.1 ; 32.9 ;12;27;59;0;12;7;5;6;6;4;4;4
14895; 33.4 ; 100.1 ; 11.0 ;3;86;19;3;0;1;2;3;0;1;2;0
14896; 27.6 ; 110.4 ; 4.5 ;4;49;33;0;4;4;0;3;1;3;1;0
14897; 30.8 ; 184.8 ; 6.6 ;6;54;79;0;6;4;2;4;2;2;4;0
14898; 61.2 ; 306.0 ; 24.1 ;5;50;59;0;5;3;2;0;5;0;0;5
14899; 97.9 ; 195.8 ; 6.7 ;2;5;110;0;2;0;2;1;1;0;0;2
14900; 59.5 ; 714.2 ; 25.7 ;12;30;10;0;12;0;12;7;5;0;0;12
14901; 54.5 ; 109.0 ; 10.5 ;2;261;26;0;2;1;1;1;1;0;1;1
14902; 44.2 ; 176.7 ; 36.9 ;4;54;5;4;0;1;3;2;2;1;2;1
14903; 52.2 ; 574.6 ; 9.4 ;11;29;2;0;11;0;11;2;9;0;7;4
14904; 48.9 ; 195.5 ; 17.4 ;4;36;159;0;4;2;2;0;4;0;3;1
14905; 24.8 ; 74.5 ; 0.2 ;3;11;246;0;3;2;1;1;2;3;0;0
14906; 42.0 ; 210.2 ; 38.6 ;5;27;83;0;5;1;4;2;3;2;1;2
14907; 45.5 ; 136.5 ; 8.8 ;3;64;20;0;3;0;3;1;2;0;3;0
14908; 44.5 ; 222.4 ; 13.0 ;5;68;36;0;5;3;2;4;1;0;3;2
14909; 25.7 ; 51.4 ; 0.9 ;2;11;263;0;2;0;2;0;2;2;0;0
14910; 19.0 ; 95.1 ; 0.6 ;5;30;210;0;5;2;3;2;3;5;0;0
14911; 27.7 ; 166.1 ; 11.3 ;6;26;85;0;6;0;6;1;5;4;2;0
14912; 36.3 ; 290.2 ; 14.7 ;8;14;4;0;8;2;6;1;7;3;5;0
14913; 38.5 ; 77.1 ; 20.2 ;2;108;63;0;2;1;1;0;2;1;0;1
14914; 39.9 ; 319.5 ; 13.8 ;8;34;41;0;8;3;5;3;5;3;5;0
14915; 35.6 ; 178.1 ; 5.8 ;5;3;180;0;5;2;3;3;2;2;3;0
14916; 18.3 ; 55.0 ; 6.2 ;3;5;8;0;3;3;0;0;3;3;0;0
14917; 20.6 ; 41.3 ; 7.5 ;2;215;20;0;2;0;2;2;0;2;0;0
14918; 39.6 ; 118.9 ; 22.9 ;3;27;238;0;3;1;2;1;2;1;1;1
14919; 52.1 ; 104.2 ; 5.1 ;2;31;204;0;2;0;2;1;1;0;1;1
14920; 18.3 ; 55.0 ; 6.2 ;3;14;202;0;3;1;2;2;1;3;0;0
14921; 15.2 ; 167.5 ; 0.9 ;11;21;52;0;11;0;11;2;9;11;0;0
14922; 46.8 ; 93.5 ; -   ;2;17;245;0;2;2;0;2;0;0;2;0
14923; 28.2 ; 366.9 ; 10.6 ;13;33;31;0;13;4;9;6;7;9;4;0
14924; 17.8 ; 53.4 ; 2.9 ;3;84;5;1;2;2;1;3;0;3;0;0
14925; 40.1 ; 80.2 ; 16.1 ;2;28;103;0;2;1;1;1;1;1;0;1
14926; 19.2 ; 57.7 ; -   ;3;86;50;0;3;2;1;2;1;3;0;0
14927; 39.2 ; 78.4 ; 12.4 ;2;40;25;2;0;1;1;0;2;1;1;0
14928; 30.0 ; 90.0 ; 11.4 ;3;36;5;0;3;1;2;1;2;1;2;0
14929; 35.9 ; 143.4 ; 20.3 ;4;5;22;0;4;3;1;4;0;1;2;1
14930; 42.5 ; 127.4 ; 11.4 ;3;5;249;0;3;2;1;1;2;0;3;0
14931; 35.9 ; 215.2 ; 14.9 ;6;29;78;0;6;0;6;1;5;2;4;0
14932; 34.4 ; 619.0 ; 16.4 ;18;19;80;0;18;3;15;6;12;6;12;0
14933; 75.4 ; 452.6 ; 36.1 ;6;34;29;0;6;1;5;6;0;0;0;6
14934; 43.9 ; 615.2 ; 15.6 ;14;11;125;0;14;3;11;3;11;5;4;5
14935; 45.8 ; 91.7 ; 1.4 ;2;97;215;0;2;1;1;2;0;0;2;0
14936; 18.5 ; 129.7 ; 8.8 ;7;46;5;0;7;4;3;4;3;7;0;0
14937; 20.4 ; 224.7 ; 6.4 ;11;25;0;0;11;1;10;8;3;11;0;0
14938; 21.6 ; 302.0 ; 9.3 ;14;29;15;0;14;3;11;6;8;9;5;0
14939; 72.4 ; 362.1 ; 54.3 ;5;69;5;0;5;1;4;2;3;2;0;3
14940; 57.1 ; 114.2 ; 9.1 ;2;189;15;1;1;0;2;2;0;0;0;2
14941; 43.3 ; 433.1 ; 25.9 ;10;23;53;0;10;6;4;9;1;3;4;3
14942; 32.5 ; 1,202.0 ; 9.4 ;37;8;5;0;37;7;30;20;17;12;25;0
14943; 38.5 ; 77.1 ; 19.3 ;2;10;140;0;2;2;0;2;0;1;0;1
14944; 45.4 ; 226.9 ; 8.2 ;5;67;100;0;5;0;5;4;1;0;5;0
14945; 31.2 ; 373.8 ; 21.7 ;12;14;57;0;12;3;9;7;5;4;8;0
14946; 43.6 ; 130.7 ; 26.8 ;3;144;38;0;3;2;1;0;3;1;1;1
14947; 16.5 ; 33.0 ; 2.3 ;2;10;33;0;2;1;1;1;1;2;0;0
14948; 23.0 ; 68.9 ; 6.6 ;3;27;159;0;3;2;1;3;0;3;0;0
14949; 38.8 ; 194.1 ; 21.2 ;5;23;44;0;5;4;1;2;3;2;1;2
14950; 15.0 ; 104.9 ; -   ;7;27;38;7;0;5;2;7;0;7;0;0
14951; 19.7 ; 98.6 ; 5.8 ;5;42;109;0;5;4;1;3;2;5;0;0
14952; 42.0 ; 84.1 ; 39.2 ;2;77;101;2;0;2;0;0;2;1;0;1
14953; 31.8 ; 63.7 ; 25.2 ;2;45;258;0;2;1;1;0;2;1;0;1
14954; 52.3 ; 209.3 ; 38.3 ;4;13;313;0;4;3;1;3;1;1;2;1
14955; 54.3 ; 543.2 ; 27.5 ;10;21;110;0;10;1;9;9;1;3;4;3
14956; 76.9 ; 153.7 ; 42.2 ;2;33;183;0;2;0;2;2;0;0;0;2
14957; 22.7 ; 45.5 ; 4.6 ;2;45;68;2;0;0;2;1;1;2;0;0
14958; 95.2 ; 285.5 ; 33.0 ;3;7;62;3;0;2;1;1;2;0;0;3
14959; 48.4 ; 96.8 ; 1.4 ;2;25;68;0;2;0;2;2;0;0;2;0
14960; 18.6 ; 37.2 ; -   ;2;56;243;0;2;1;1;2;0;2;0;0
14961; 38.5 ; 76.9 ; 12.4 ;2;60;159;2;0;1;1;1;1;1;1;0
14962; 60.7 ; 121.4 ; 16.7 ;2;31;242;0;2;0;2;1;1;0;0;2
14963; 17.9 ; 303.7 ; 9.0 ;17;16;17;0;17;7;10;5;12;17;0;0
14964; 45.9 ; 229.4 ; 10.8 ;5;22;0;0;5;2;3;3;2;0;3;2
14965; 49.2 ; 147.6 ; 36.0 ;3;85;253;0;3;0;3;2;1;1;1;1
14966; 47.7 ; 143.1 ; 32.1 ;3;43;101;0;3;1;2;0;3;1;1;1
14967; 48.2 ; 241.0 ; 10.2 ;5;86;11;0;5;0;5;3;2;0;3;2
14968; 24.8 ; 148.7 ; 15.7 ;6;14;328;0;6;5;1;6;0;4;2;0
14969; 46.8 ; 93.5 ; -   ;2;28;270;0;2;1;1;0;2;0;2;0
14970; 34.5 ; 792.8 ; 21.1 ;23;17;36;0;23;2;21;10;13;8;7;8
14971; 42.3 ; 84.6 ; 7.7 ;2;206;85;0;2;0;2;0;2;0;2;0
14972; 45.9 ; 229.5 ; 9.4 ;5;37;62;0;5;3;2;5;0;0;3;2
14973; 15.6 ; 156.3 ; 1.2 ;10;23;84;0;10;5;5;6;4;10;0;0
14974; 25.6 ; 102.4 ; 16.2 ;4;71;32;0;4;0;4;3;1;3;1;0
14975; 39.6 ; 158.4 ; 11.1 ;4;142;1;0;4;0;4;1;3;1;3;0
14976; 71.0 ; 213.1 ; 44.5 ;3;56;173;0;3;1;2;1;2;1;0;2
14977; 61.2 ; 183.6 ; 7.7 ;3;128;69;0;3;1;2;1;2;0;0;3
14978; 25.3 ; 151.6 ; 0.6 ;6;25;23;6;0;5;1;6;0;6;0;0
14979; 74.9 ; 374.4 ; 40.2 ;5;43;129;0;5;1;4;5;0;0;0;5
14980; 19.3 ; 38.6 ; -   ;2;7;302;0;2;2;0;1;1;2;0;0
14981; 17.9 ; 35.8 ; 0.2 ;2;11;176;0;2;1;1;0;2;2;0;0
14982; 41.1 ; 82.1 ; 37.8 ;2;11;89;0;2;0;2;1;1;1;0;1
14983; 30.2 ; 60.4 ; -   ;2;12;304;0;2;1;1;1;1;0;2;0
14984; 53.6 ; 267.8 ; 5.9 ;5;4;12;0;5;4;1;5;0;0;3;2
14985; 41.8 ; 209.2 ; 17.7 ;5;66;12;1;4;2;3;4;1;2;1;2
14986; 33.0 ; 330.4 ; 14.5 ;10;36;10;0;10;2;8;4;6;3;7;0
14987; 60.2 ; 300.8 ; 23.9 ;5;29;21;0;5;2;3;3;2;0;0;5
14988; 25.8 ; 51.6 ; 16.2 ;2;6;131;0;2;0;2;1;1;1;1;0
14989; 20.3 ; 324.9 ; 6.6 ;16;16;0;0;16;10;6;2;14;16;0;0
14990; 62.2 ; 124.3 ; 23.1 ;2;130;112;0;2;1;1;1;1;0;0;2
14991; 77.7 ; 155.4 ; 45.3 ;2;104;11;0;2;1;1;2;0;0;0;2
14992; 17.2 ; 102.9 ; 6.1 ;6;15;69;0;6;0;6;3;3;6;0;0
14993; 29.7 ; 207.7 ; 13.9 ;7;32;38;1;6;3;4;6;1;5;2;0
14994; 50.4 ; 100.7 ; 4.3 ;2;31;26;0;2;0;2;2;0;0;2;0
14995; 39.4 ; 275.8 ; 23.2 ;7;39;8;0;7;4;3;5;2;2;3;2
14996; 26.9 ; 376.0 ; 29.4 ;14;16;2;0;14;12;2;10;4;9;0;5
14997; 32.3 ; 97.0 ; 3.9 ;3;52;122;0;3;1;2;0;3;1;2;0
14998; 43.1 ; 129.4 ; 12.1 ;3;59;98;0;3;3;0;2;1;0;2;1
14999; 38.4 ; 115.3 ; 15.9 ;3;29;84;0;3;0;3;2;1;1;2;0
15000; 54.2 ; 108.4 ; 11.2 ;2;5;326;0;2;0;2;0;2;0;1;1
15001; 52.4 ; 157.3 ; 25.6 ;3;13;332;0;3;2;1;2;1;1;1;1
15002; 52.5 ; 105.0 ; -   ;2;87;141;0;2;0;2;2;0;0;2;0
15003; 25.1 ; 50.1 ; -   ;2;26;80;0;2;1;1;2;0;2;0;0
15004; 48.0 ; 191.8 ; 6.2 ;4;8;131;4;0;0;4;4;0;0;4;0
15005; 31.5 ; 472.5 ; 12.6 ;15;27;10;0;15;3;12;7;8;5;10;0
15006; 34.8 ; 69.5 ; 6.8 ;2;7;251;0;2;1;1;0;2;1;1;0
15007; 53.4 ; 267.1 ; 20.3 ;5;51;63;0;5;2;3;2;3;0;3;2
15008; 16.7 ; 299.7 ; 4.1 ;18;6;83;0;18;13;5;3;15;18;0;0
15009; 35.7 ; 1,143.2 ; 15.6 ;32;13;2;0;32;21;11;28;4;11;21;0
15010; 80.1 ; 400.6 ; 26.5 ;5;29;136;0;5;1;4;4;1;0;0;5
15011; 107.9 ; 323.6 ; 91.6 ;3;85;10;0;3;0;3;1;2;1;0;2
15012; 46.8 ; 93.5 ; -   ;2;22;259;0;2;1;1;2;0;0;2;0
15013; 43.2 ; 302.4 ; 14.6 ;7;33;5;0;7;0;7;3;4;2;3;2
15014; 39.8 ; 318.4 ; 13.1 ;8;49;10;0;8;2;6;5;3;3;5;0
15015; 42.0 ; 126.1 ; 17.5 ;3;54;182;0;3;2;1;1;2;1;1;1
15016; 17.3 ; 69.3 ; 2.9 ;4;4;258;0;4;1;3;2;2;4;0;0
15017; 35.8 ; 143.0 ; 7.4 ;4;27;83;0;4;4;0;4;0;1;3;0
15018; 36.1 ; 72.2 ; 16.5 ;2;5;105;0;2;0;2;2;0;1;1;0
15019; 48.1 ; 96.2 ; 0.9 ;2;11;19;0;2;2;0;0;2;0;2;0
15020; 34.4 ; 343.6 ; 15.9 ;10;25;56;0;10;10;0;10;0;3;7;0
15021; 20.0 ; 40.1 ; 7.6 ;2;49;173;0;2;1;1;1;1;2;0;0
15022; 24.8 ; 49.6 ; 8.0 ;2;6;173;0;2;0;2;2;0;1;1;0
15023; 24.5 ; 220.4 ; 5.9 ;9;52;5;0;9;1;8;6;3;6;3;0
15024; 39.0 ; 195.1 ; 10.2 ;5;62;21;0;5;1;4;1;4;2;3;0
15025; 47.1 ; 188.3 ; 8.3 ;4;95;31;0;4;1;3;2;2;0;3;1
15026; 19.4 ; 135.7 ; 6.6 ;7;23;60;0;7;3;4;0;7;7;0;0
15027; 27.5 ; 274.6 ; 16.9 ;10;27;69;0;10;1;9;7;3;7;3;0
15028; 48.2 ; 192.6 ; 39.6 ;4;50;5;4;0;0;4;1;3;1;2;1
15029; 41.7 ; 83.4 ; 7.6 ;2;27;259;0;2;2;0;1;1;0;2;0
15030; 23.3 ; 69.8 ; 3.3 ;3;2;326;0;3;1;2;3;0;3;0;0
15031; 46.3 ; 92.6 ; 17.3 ;2;7;272;0;2;0;2;0;2;1;0;1
15032; 48.2 ; 385.6 ; 21.1 ;8;25;13;0;8;3;5;3;5;3;2;3
15033; 27.2 ; 354.2 ; 11.7 ;13;17;83;0;13;6;7;3;10;9;4;0
15034; 63.1 ; 126.1 ; 23.3 ;2;30;157;0;2;1;1;2;0;0;0;2
15035; 47.3 ; 189.2 ; 0.4 ;4;84;62;0;4;0;4;4;0;0;4;0
15036; 22.4 ; 44.7 ; 4.6 ;2;3;239;0;2;1;1;1;1;2;0;0
15037; 22.5 ; 44.9 ; 11.2 ;2;42;180;0;2;1;1;2;0;1;1;0
15038; 45.2 ; 90.5 ; 3.3 ;2;86;69;0;2;0;2;2;0;0;2;0
15039; 50.9 ; 101.8 ; 10.4 ;2;17;193;0;2;2;0;0;2;0;1;1
15040; 48.2 ; 96.4 ; -   ;2;15;2;0;2;2;0;2;0;0;2;0
15041; 51.4 ; 205.5 ; 0.4 ;4;49;62;0;4;0;4;4;0;0;4;0
15042; 49.6 ; 99.2 ; 1.9 ;2;4;78;0;2;1;1;1;1;0;2;0
15043; 48.5 ; 1,116.5 ; 15.5 ;23;13;16;0;23;9;14;20;3;0;15;8
15044; 22.5 ; 112.5 ; 11.1 ;5;114;1;1;4;1;4;1;4;3;2;0
15045; 46.8 ; 140.5 ; 4.2 ;3;25;158;0;3;0;3;3;0;0;3;0
15046; 19.3 ; 38.6 ; -   ;2;21;260;0;2;1;1;0;2;2;0;0
15047; 46.9 ; 797.4 ; 39.2 ;17;15;4;0;17;5;12;17;0;6;5;6
15048; 68.7 ; 137.4 ; 7.6 ;2;140;89;2;0;0;2;2;0;0;0;2
15049; 26.0 ; 1,978.7 ; 18.0 ;76;5;5;0;76;37;39;39;37;51;25;0
15050; 71.1 ; 142.1 ; 36.4 ;2;130;160;0;2;1;1;2;0;0;0;2
15051; 35.9 ; 71.8 ; 16.2 ;2;50;339;0;2;2;0;2;0;1;1;0
15052; 35.9 ; 71.8 ; 16.2 ;2;102;272;0;2;0;2;1;1;1;1;0
15053; 48.1 ; 96.1 ; 1.9 ;2;157;78;2;0;0;2;0;2;0;2;0
15054; 62.7 ; 125.3 ; 20.9 ;2;39;230;0;2;0;2;2;0;0;0;2
15055; 58.7 ; 704.6 ; 10.8 ;12;27;5;0;12;0;12;11;1;0;0;12
15056; 31.0 ; 434.4 ; 31.7 ;14;20;35;0;14;6;8;11;3;5;4;5
15057; 42.0 ; 84.1 ; 8.1 ;2;70;2;1;1;2;0;0;2;0;2;0
15058; 30.5 ; 427.2 ; 9.3 ;14;23;30;0;14;9;5;13;1;5;9;0
15059; 30.6 ; 214.0 ; 19.8 ;7;30;21;0;7;2;5;7;0;2;5;0
15060; 47.4 ; 331.7 ; 0.5 ;7;21;5;0;7;0;7;6;1;0;7;0
15061; 39.7 ; 198.7 ; 9.3 ;5;16;256;0;5;2;3;5;0;0;5;0
15062; 20.0 ; 40.1 ; 7.6 ;2;10;18;0;2;1;1;0;2;2;0;0
15063; 24.4 ; 48.8 ; 8.7 ;2;5;275;0;2;2;0;2;0;1;1;0
15064; 38.5 ; 76.9 ; 12.4 ;2;11;260;0;2;1;1;0;2;1;1;0
15065; 51.1 ; 459.6 ; 18.6 ;9;25;36;0;9;0;9;9;0;0;6;3
15066; 18.4 ; 73.5 ; 1.9 ;4;15;188;0;4;1;3;2;2;4;0;0
15067; 44.8 ; 89.6 ; 2.9 ;2;24;278;0;2;0;2;2;0;0;2;0
15068; 23.7 ; 355.2 ; 7.5 ;15;16;178;0;15;4;11;13;2;10;5;0
15069; 19.9 ; 119.5 ; 3.4 ;6;11;5;0;6;1;5;3;3;6;0;0
15070; 58.4 ; 116.8 ; 3.4 ;2;113;157;0;2;0;2;2;0;0;0;2
15071; 62.3 ; 311.7 ; 7.2 ;5;22;142;0;5;0;5;5;0;0;0;5
15072; 50.4 ; 353.1 ; 3.2 ;7;47;83;0;7;5;2;5;2;0;7;0
15073; 58.4 ; 291.8 ; 11.9 ;5;41;99;0;5;0;5;4;1;0;0;5
15074; 52.9 ; 264.4 ; 23.8 ;5;63;69;0;5;4;1;4;1;2;1;2
15075; 28.7 ; 86.1 ; 11.3 ;3;32;122;0;3;3;0;3;0;2;1;0
15076; 15.0 ; 30.0 ; -   ;2;26;173;0;2;0;2;1;1;2;0;0
15077; 51.0 ; 204.0 ; 16.5 ;4;48;59;0;4;2;2;2;2;0;3;1
15078; 80.3 ; 321.1 ; 21.9 ;4;59;112;0;4;2;2;4;0;0;0;4
15079; 79.5 ; 238.6 ; 6.4 ;3;50;68;0;3;0;3;3;0;0;0;3
15080; 79.2 ; 316.7 ; 21.2 ;4;44;199;0;4;0;4;2;2;0;0;4
15081; 69.4 ; 138.9 ; 66.4 ;2;136;124;0;2;2;0;1;1;1;0;1
15082; 26.7 ; 106.9 ; 16.0 ;4;53;135;0;4;1;3;2;2;3;1;0
15083; 40.4 ; 80.8 ; 28.9 ;2;72;134;0;2;1;1;2;0;1;0;1
15084; 49.0 ; 294.2 ; 21.6 ;6;50;17;0;6;0;6;4;2;2;2;2
15085; 102.0 ; 204.1 ; 4.5 ;2;11;110;0;2;0;2;2;0;0;0;2
15086; 23.3 ; 116.5 ; 10.6 ;5;33;53;0;5;3;2;3;2;3;2;0
15087; 31.2 ; 93.5 ; 2.2 ;3;59;41;0;3;2;1;1;2;1;2;0
15088; 20.7 ; 124.1 ; 10.1 ;6;11;9;1;5;6;0;0;6;4;2;0
15089; 45.0 ; 224.8 ; 10.0 ;5;46;113;0;5;1;4;4;1;0;5;0
15090; 48.1 ; 144.4 ; 0.6 ;3;31;5;0;3;0;3;2;1;0;3;0
15091; 40.1 ; 120.4 ; 13.9 ;3;20;242;0;3;2;1;2;1;1;2;0
15092; 26.8 ; 80.3 ; 3.1 ;3;50;12;0;3;2;1;1;2;3;0;0
15093; 16.4 ; 263.2 ; 4.4 ;16;19;2;0;16;15;1;16;0;16;0;0
15094; 45.8 ; 137.3 ; 14.9 ;3;8;12;0;3;1;2;2;1;0;2;1
15095; 36.9 ; 73.8 ; 16.9 ;2;220;24;2;0;2;0;0;2;1;1;0
15096; 23.9 ; 119.7 ; 9.0 ;5;31;204;0;5;0;5;3;2;3;2;0
15097; 35.5 ; 177.5 ; 12.8 ;5;7;2;0;5;2;3;1;4;2;3;0
15098; 107.3 ; 429.3 ; 23.4 ;4;35;149;0;4;4;0;4;0;0;0;4
15099; 34.5 ; 207.3 ; 15.0 ;6;35;34;0;6;2;4;2;4;2;4;0
15100; 18.7 ; 37.5 ; 3.6 ;2;282;24;0;2;2;0;1;1;2;0;0
15101; 20.7 ; 62.2 ; 4.0 ;3;63;20;0;3;3;0;3;0;3;0;0
15102; 41.5 ; 1,161.9 ; 20.4 ;28;14;6;0;28;9;19;7;21;9;10;9
15103; 22.9 ; 114.6 ; 12.0 ;5;4;285;0;5;3;2;2;3;3;2;0
15104; 22.2 ; 133.0 ; 6.0 ;6;22;2;0;6;1;5;2;4;6;0;0
15105; 30.3 ; 151.5 ; 7.4 ;5;25;23;4;1;2;3;3;2;2;3;0
15106; 26.9 ; 161.5 ; 9.0 ;6;25;57;5;1;2;4;0;6;4;2;0
15107; 25.8 ; 51.6 ; 16.2 ;2;11;26;0;2;0;2;2;0;1;1;0
15108; 56.0 ; 224.0 ; 63.5 ;4;13;159;0;4;2;2;2;2;1;0;3
15109; 15.0 ; 45.0 ; -   ;3;77;15;2;1;2;1;1;2;3;0;0
15110; 54.7 ; 109.4 ; 8.0 ;2;32;26;0;2;0;2;2;0;0;1;1
15111; 30.9 ; 61.7 ; 23.8 ;2;15;131;0;2;1;1;0;2;1;1;0
15112; 38.3 ; 114.8 ; 7.5 ;3;104;104;1;2;3;0;1;2;0;3;0
15113; 91.6 ; 183.1 ; 30.7 ;2;12;54;0;2;1;1;0;2;0;0;2
15114; 42.0 ; 84.1 ; 8.1 ;2;16;71;2;0;1;1;1;1;0;2;0
15115; 19.4 ; 58.3 ; 5.2 ;3;87;50;3;0;3;0;3;0;3;0;0
15116; 38.4 ; 76.8 ; 20.0 ;2;39;57;0;2;0;2;2;0;1;0;1
15117; 69.2 ; 207.6 ; 13.3 ;3;106;168;0;3;0;3;3;0;0;0;3
15118; 49.4 ; 296.4 ; 7.1 ;6;48;26;0;6;0;6;2;4;0;4;2
15119; 48.4 ; 242.0 ; 2.7 ;5;23;36;0;5;1;4;1;4;0;5;0
15120; 43.8 ; 131.3 ; 13.3 ;3;85;125;0;3;1;2;2;1;0;2;1
15121; 46.7 ; 327.2 ; 8.4 ;7;8;5;0;7;3;4;1;6;0;5;2
15122; 51.8 ; 103.5 ; 7.5 ;2;8;103;0;2;1;1;2;0;0;1;1
15123; 15.0 ; 89.9 ; -   ;6;27;29;6;0;6;0;0;6;6;0;0
15124; 31.0 ; 155.1 ; 14.5 ;5;11;20;0;5;2;3;4;1;2;3;0
15125; 16.4 ; 32.8 ; -   ;2;5;44;0;2;2;0;2;0;2;0;0
15126; 30.2 ; 60.4 ; -   ;2;4;260;0;2;1;1;0;2;0;2;0
15127; 37.8 ; 679.9 ; 11.5 ;18;19;2;0;18;12;6;13;5;6;12;0
15128; 23.3 ; 116.4 ; 17.6 ;5;40;171;0;5;3;2;5;0;3;2;0
15129; 59.3 ; 118.6 ; 18.8 ;2;63;278;0;2;0;2;1;1;0;0;2
15130; 15.0 ; 45.0 ; -   ;3;3;45;0;3;3;0;1;2;3;0;0
15131; 15.0 ; 45.0 ; -   ;3;2;179;0;3;1;2;1;2;3;0;0
15132; 28.3 ; 84.9 ; 8.8 ;3;52;127;0;3;0;3;1;2;2;1;0
15133; 43.5 ; 130.5 ; 14.5 ;3;110;68;0;3;1;2;2;1;1;1;1
15134; 15.0 ; 119.9 ; -   ;8;29;59;0;8;5;3;5;3;8;0;0
15135; 16.4 ; 32.9 ; 2.2 ;2;14;263;0;2;1;1;1;1;2;0;0
15136; 34.3 ; 171.3 ; 9.8 ;5;27;0;5;0;1;4;0;5;2;3;0
15137; 62.3 ; 187.0 ; 28.6 ;3;94;121;0;3;0;3;2;1;0;0;3
15138; 33.2 ; 66.4 ; 20.3 ;2;73;257;0;2;1;1;2;0;1;1;0
15139; 33.4 ; 66.8 ; 4.8 ;2;43;357;0;2;0;2;1;1;1;1;0
15140; 47.8 ; 95.5 ; 1.4 ;2;92;157;0;2;1;1;0;2;0;2;0
15141; 52.1 ; 104.2 ; 3.8 ;2;43;117;0;2;1;1;2;0;0;1;1
15142; 22.5 ; 44.9 ; 11.2 ;2;199;83;0;2;1;1;2;0;1;1;0
15143; 35.6 ; 71.1 ; 8.0 ;2;12;135;0;2;2;0;0;2;1;1;0
15144; 40.4 ; 80.8 ; 22.9 ;2;18;231;0;2;0;2;1;1;1;0;1
15145; 47.1 ; 94.2 ; 0.5 ;2;118;94;0;2;1;1;2;0;0;2;0
15146; 28.8 ; 57.6 ; 4.8 ;2;23;180;0;2;1;1;0;2;1;1;0
15147; 45.1 ; 90.3 ; 6.3 ;2;12;53;0;2;0;2;1;1;0;2;0
15148; 56.1 ; 729.7 ; 7.2 ;13;19;142;0;13;2;11;8;5;0;0;13
15149; 54.1 ; 108.1 ; 5.7 ;2;53;218;0;2;1;1;0;2;0;1;1
15150; 44.1 ; 308.8 ; 10.3 ;7;18;104;0;7;2;5;7;0;0;7;0
15151; 48.3 ; 144.8 ; 2.8 ;3;22;209;0;3;1;2;2;1;0;3;0
15152; 32.5 ; 97.6 ; 15.4 ;3;177;20;0;3;2;1;1;2;1;2;0
15153; 51.3 ; 512.9 ; 9.2 ;10;30;32;0;10;0;10;9;1;0;7;3
15154; 54.6 ; 109.3 ; 2.1 ;2;77;29;0;2;1;1;2;0;0;1;1
15155; 55.9 ; 391.0 ; 2.9 ;7;20;155;0;7;6;1;1;6;0;0;7
15156; 20.1 ; 60.2 ; 9.3 ;3;14;322;0;3;2;1;3;0;3;0;0
15157; 50.7 ; 152.1 ; 7.3 ;3;85;110;0;3;0;3;3;0;0;2;1
15158; 69.0 ; 275.9 ; 23.5 ;4;8;57;0;4;1;3;2;2;0;0;4
15159; 25.8 ; 77.4 ; 5.4 ;3;9;126;0;3;0;3;2;1;2;1;0
15160; 54.0 ; 161.9 ; 42.7 ;3;22;194;0;3;1;2;3;0;1;1;1
15161; 59.0 ; 118.1 ; 5.6 ;2;56;199;0;2;0;2;2;0;0;0;2
15162; 41.0 ; 163.9 ; 3.3 ;4;57;74;3;1;0;4;1;3;0;4;0
15163; 52.8 ; 211.3 ; 12.9 ;4;59;146;0;4;0;4;3;1;0;3;1
15164; 37.7 ; 678.9 ; 18.1 ;18;23;36;0;18;5;13;13;5;6;6;6
15165; 18.2 ; 618.7 ; 6.8 ;34;8;1;0;34;10;24;22;12;34;0;0
15166; 46.4 ; 1,437.9 ; 17.0 ;31;9;5;0;31;0;31;30;1;10;11;10
15167; 26.1 ; 130.3 ; 16.7 ;5;14;73;0;5;1;4;3;2;3;2;0
15168; 15.0 ; 30.0 ; -   ;2;325;74;0;2;1;1;2;0;2;0;0
15169; 57.4 ; 114.8 ; 6.2 ;2;20;99;0;2;0;2;1;1;0;0;2
15170; 26.7 ; 374.4 ; 14.4 ;14;29;52;0;14;5;9;8;6;9;5;0
15171; 62.2 ; 248.7 ; 14.5 ;4;8;242;0;4;1;3;2;2;0;0;4
15172; 23.0 ; 91.9 ; 9.2 ;4;94;17;0;4;2;2;2;2;3;1;0
15173; 49.4 ; 296.5 ; 20.5 ;6;50;11;0;6;2;4;3;3;2;2;2
15174; 65.1 ; 130.1 ; 27.4 ;2;24;272;0;2;0;2;0;2;0;0;2
15175; 39.5 ; 276.7 ; 15.6 ;7;56;62;0;7;0;7;7;0;2;3;2
15176; 32.6 ; 228.5 ; 7.3 ;7;33;32;0;7;1;6;6;1;2;5;0
15177; 17.8 ; 196.2 ; 2.8 ;11;28;40;0;11;2;9;6;5;11;0;0
15178; 47.5 ; 142.4 ; -   ;3;22;64;3;0;0;3;0;3;0;3;0
15179; 21.7 ; 65.1 ; 6.2 ;3;65;22;0;3;1;2;1;2;3;0;0
15180; 19.8 ; 197.5 ; 7.8 ;10;14;5;0;10;2;8;6;4;10;0;0
15181; 34.2 ; 342.4 ; 20.1 ;10;36;15;0;10;6;4;5;5;3;7;0
15182; 28.9 ; 86.7 ; 7.0 ;3;67;8;0;3;2;1;1;2;2;1;0
15183; 23.3 ; 116.5 ; 8.1 ;5;32;146;0;5;2;3;3;2;3;2;0
15184; 37.1 ; 148.4 ; 13.0 ;4;40;44;0;4;2;2;3;1;1;3;0
15185; 24.3 ; 121.7 ; 11.3 ;5;34;21;0;5;2;3;1;4;3;2;0
15186; 15.2 ; 60.8 ; 0.5 ;4;26;17;0;4;2;2;3;1;4;0;0
15187; 16.4 ; 98.5 ; 4.0 ;6;39;14;0;6;3;3;2;4;6;0;0
15188; 34.3 ; 103.0 ; 11.8 ;3;11;253;0;3;2;1;2;1;1;2;0
15189; 27.4 ; 136.9 ; 29.3 ;5;9;253;0;5;2;3;2;3;3;0;2
15190; 15.0 ; 104.9 ; -   ;7;28;105;0;7;2;5;5;2;7;0;0
15191; 32.7 ; 65.3 ; 21.1 ;2;9;152;0;2;1;1;2;0;1;1;0
15192; 35.9 ; 107.8 ; 4.7 ;3;10;257;0;3;0;3;1;2;0;3;0
15193; 58.8 ; 352.9 ; 35.3 ;6;44;80;0;6;0;6;5;1;2;0;4
15194; 25.1 ; 50.1 ; -   ;2;71;110;2;0;0;2;2;0;2;0;0
15195; 31.8 ; 159.0 ; 9.8 ;5;31;2;0;5;2;3;4;1;2;3;0
15196; 39.2 ; 196.0 ; 15.5 ;5;27;64;0;5;3;2;3;2;2;3;0
15197; 18.0 ; 36.1 ; 4.6 ;2;205;20;0;2;1;1;2;0;2;0;0
15198; 30.2 ; 60.4 ; -   ;2;31;121;0;2;0;2;2;0;0;2;0
15199; 35.0 ; 349.5 ; 9.6 ;10;29;23;0;10;5;5;2;8;3;7;0
15200; 24.7 ; 49.4 ; -   ;2;17;0;2;0;0;2;2;0;2;0;0
15201; 17.0 ; 85.0 ; 4.8 ;5;43;20;1;4;2;3;1;4;5;0;0
15202; 25.8 ; 103.3 ; 10.8 ;4;14;199;0;4;0;4;3;1;3;1;0
15203; 71.2 ; 142.5 ; 11.4 ;2;64;164;0;2;1;1;2;0;0;0;2
15204; 36.6 ; 73.2 ; -   ;2;73;85;1;1;0;2;0;2;0;2;0
15205; 15.0 ; 59.9 ; -   ;4;11;73;0;4;2;2;2;2;4;0;0
15206; 21.8 ; 43.7 ; 4.9 ;2;146;29;0;2;2;0;2;0;2;0;0
15207; 26.7 ; 213.7 ; 9.1 ;8;23;2;0;8;5;3;5;3;5;3;0
15208; 17.9 ; 71.5 ; 6.1 ;4;23;40;0;4;1;3;4;0;4;0;0
15209; 71.9 ; 790.5 ; 47.9 ;11;28;141;0;11;0;11;8;3;4;0;7
15210; 42.0 ; 630.7 ; 13.6 ;15;14;44;0;15;2;13;5;10;5;5;5
15211; 16.4 ; 49.2 ; 2.6 ;3;5;180;0;3;2;1;0;3;3;0;0
15212; 31.8 ; 63.7 ; 25.2 ;2;5;5;0;2;0;2;1;1;1;0;1
15213; 34.1 ; 613.4 ; 26.3 ;18;7;168;0;18;12;6;12;6;6;6;6
15214; 35.6 ; 605.5 ; 7.7 ;17;17;5;0;17;7;10;13;4;6;11;0
15215; 37.4 ; 373.7 ; 6.1 ;10;32;36;0;10;0;10;8;2;0;10;0
15216; 23.4 ; 70.2 ; 8.2 ;3;3;42;0;3;0;3;1;2;2;1;0
15217; 29.2 ; 262.9 ; 15.0 ;9;32;53;0;9;2;7;5;4;6;3;0
15218; 22.3 ; 89.3 ; 10.6 ;4;36;183;0;4;1;3;4;0;3;1;0
15219; 26.4 ; 132.0 ; 13.9 ;5;16;275;0;5;3;2;2;3;3;2;0
15220; 16.9 ; 84.4 ; 2.8 ;5;24;74;0;5;2;3;5;0;5;0;0
15221; 48.2 ; 240.8 ; 12.5 ;5;45;29;2;3;3;2;4;1;0;3;2
15222; 71.1 ; 142.1 ; 33.6 ;2;32;257;0;2;0;2;2;0;0;0;2
15223; 33.7 ; 573.4 ; 20.6 ;17;23;35;1;16;8;9;14;3;6;11;0
15224; 24.4 ; 48.8 ; 8.7 ;2;63;233;0;2;2;0;1;1;1;1;0
15225; 79.1 ; 158.1 ; 3.2 ;2;5;176;0;2;2;0;1;1;0;0;2
15226; 54.6 ; 546.5 ; 12.3 ;10;34;40;0;10;3;7;8;2;0;7;3
15227; 61.4 ; 858.9 ; 15.0 ;14;26;6;0;14;8;6;14;0;0;0;14
15228; 51.8 ; 103.5 ; 1.1 ;2;6;262;0;2;0;2;2;0;0;2;0
15229; 40.1 ; 120.4 ; 13.8 ;3;113;21;0;3;0;3;1;2;1;2;0
15230; 33.7 ; 134.8 ; 6.1 ;4;49;38;2;2;1;3;2;2;1;3;0
15231; 23.1 ; 115.3 ; 4.8 ;5;23;200;0;5;0;5;1;4;5;0;0
15232; 52.8 ; 686.6 ; 20.2 ;13;8;5;13;0;0;13;5;8;0;9;4
15233; 15.0 ; 30.0 ; -   ;2;8;297;0;2;1;1;0;2;2;0;0
15234; 49.0 ; 245.2 ; 25.7 ;5;85;4;0;5;3;2;3;2;2;1;2
15235; 38.4 ; 230.4 ; 25.3 ;6;28;129;0;6;3;3;0;6;2;2;2
15236; 106.6 ; 213.3 ; 28.4 ;2;108;176;0;2;2;0;2;0;0;0;2
15237; 43.7 ; 174.7 ; 9.8 ;4;14;133;0;4;1;3;3;1;0;4;0
15238; 77.4 ; 154.8 ; 43.0 ;2;17;258;0;2;0;2;1;1;0;0;2
15239; 20.4 ; 81.8 ; 1.5 ;4;92;41;0;4;0;4;3;1;4;0;0
15240; 26.2 ; 52.4 ; 15.5 ;2;37;89;1;1;1;1;0;2;1;1;0
15241; 42.4 ; 932.2 ; 14.9 ;22;12;17;0;22;10;12;5;17;7;8;7
15242; 70.7 ; 212.1 ; 16.7 ;3;38;215;0;3;0;3;3;0;0;0;3
15243; 49.5 ; 148.6 ; 3.5 ;3;104;99;0;3;0;3;1;2;0;3;0
15244; 43.1 ; 129.2 ; 12.2 ;3;18;58;0;3;1;2;1;2;0;2;1
15245; 22.3 ; 44.7 ; 11.0 ;2;10;75;0;2;1;1;1;1;1;1;0
15246; 31.2 ; 124.8 ; 9.3 ;4;8;270;0;4;3;1;4;0;1;3;0
15247; 73.2 ; 146.4 ; 54.8 ;2;80;26;0;2;1;1;0;2;1;0;1
15248; 44.5 ; 844.8 ; 19.2 ;19;14;55;0;19;8;11;19;0;6;7;6
15249; 60.3 ; 120.5 ; 17.3 ;2;201;99;0;2;0;2;2;0;0;0;2
15250; 47.7 ; 476.9 ; 2.9 ;10;31;16;0;10;1;9;9;1;0;10;0
15251; 32.2 ; 96.7 ; 3.7 ;3;11;279;0;3;2;1;1;2;1;2;0
15252; 46.8 ; 93.5 ; -   ;2;6;273;0;2;0;2;0;2;0;2;0
15253; 60.0 ; 239.9 ; 7.6 ;4;94;31;0;4;1;3;4;0;0;0;4
15254; 61.7 ; 308.3 ; 27.0 ;5;43;89;0;5;0;5;5;0;0;0;5
15255; 26.5 ; 159.2 ; 11.2 ;6;40;5;0;6;3;3;4;2;4;2;0
15256; 54.2 ; 216.6 ; 31.3 ;4;41;63;0;4;2;2;2;2;1;2;1
15257; 40.0 ; 160.1 ; 9.9 ;4;98;34;0;4;2;2;1;3;0;4;0
15258; 42.8 ; 85.5 ; 18.8 ;2;46;131;1;1;1;1;1;1;1;0;1
15259; 27.5 ; 82.6 ; 11.4 ;3;5;1;0;3;1;2;1;2;2;1;0
15260; 51.4 ; 102.9 ; 7.0 ;2;11;161;2;0;2;0;2;0;0;1;1
15261; 46.8 ; 93.5 ; -   ;2;6;283;0;2;0;2;0;2;0;2;0
15262; 38.3 ; 76.7 ; 19.8 ;2;19;126;0;2;0;2;2;0;1;0;1
15263; 57.3 ; 114.6 ; 15.8 ;2;30;120;0;2;1;1;1;1;0;0;2
15264; 69.5 ; 347.7 ; 9.0 ;5;37;15;1;4;1;4;4;1;0;0;5
15265; 44.5 ; 266.8 ; 23.6 ;6;19;35;0;6;3;3;1;5;2;2;2
15266; 20.5 ; 82.0 ; 3.3 ;4;9;288;0;4;1;3;1;3;4;0;0
15267; 70.5 ; 281.9 ; 16.5 ;4;56;85;0;4;1;3;4;0;0;0;4
15268; 59.4 ; 356.2 ; 10.9 ;6;32;57;6;0;0;6;6;0;0;0;6
15269; 26.6 ; 106.6 ; 3.1 ;4;33;5;0;4;0;4;1;3;4;0;0
15270; 99.5 ; 497.4 ; 38.2 ;5;48;36;0;5;0;5;2;3;0;0;5
15271; 64.1 ; 128.2 ; 66.4 ;2;13;236;0;2;0;2;1;1;1;0;1
15272; 27.6 ; 55.3 ; 3.8 ;2;132;159;0;2;2;0;0;2;1;1;0
15273; 28.6 ; 229.0 ; 11.9 ;8;27;115;0;8;3;5;1;7;5;3;0
15274; 36.8 ; 147.3 ; 16.3 ;4;103;12;0;4;3;1;1;3;1;3;0
15275; 30.9 ; 61.7 ; 23.8 ;2;231;74;0;2;0;2;1;1;1;1;0
15276; 19.0 ; 323.8 ; 7.0 ;17;18;5;0;17;7;10;8;9;17;0;0
15277; 37.0 ; 407.5 ; 10.3 ;11;32;58;0;11;3;8;7;4;4;7;0
15278; 35.8 ; 179.1 ; 13.0 ;5;15;99;0;5;2;3;2;3;2;3;0
15279; 110.1 ; 220.3 ; 4.1 ;2;32;251;0;2;0;2;2;0;0;0;2
15280; 36.1 ; 108.3 ; 11.3 ;3;16;346;0;3;0;3;1;2;1;2;0
15281; 17.5 ; 52.5 ; 2.4 ;3;5;95;0;3;1;2;2;1;3;0;0
15282; 60.8 ; 303.9 ; 27.4 ;5;37;120;0;5;1;4;2;3;0;0;5
15283; 74.2 ; 148.5 ; 3.6 ;2;20;158;0;2;1;1;1;1;0;0;2
15284; 30.6 ; 153.2 ; 15.0 ;5;41;115;0;5;3;2;3;2;2;3;0
15285; 63.7 ; 318.3 ; 15.5 ;5;65;61;0;5;3;2;0;5;0;0;5
15286; 17.6 ; 405.1 ; 8.0 ;23;6;95;0;23;12;11;18;5;23;0;0
15287; 43.1 ; 258.8 ; 8.3 ;6;41;6;0;6;1;5;1;5;0;6;0
15288; 21.8 ; 43.7 ; 4.9 ;2;28;145;2;0;1;1;2;0;2;0;0
15289; 15.0 ; 59.9 ; -   ;4;62;3;0;4;3;1;1;3;4;0;0
15290; 19.4 ; 252.5 ; 5.4 ;13;14;59;0;13;10;3;2;11;13;0;0
15291; 18.6 ; 37.2 ; -   ;2;14;2;2;0;2;0;2;0;2;0;0
15292; 53.0 ; 211.9 ; 5.0 ;4;50;2;0;4;2;2;1;3;0;3;1
15293; 51.7 ; 103.4 ; 4.5 ;2;10;230;0;2;2;0;2;0;0;1;1
15294; 59.5 ; 535.3 ; 44.7 ;9;25;221;0;9;3;6;3;6;3;0;6
15295; 49.5 ; 98.9 ; 3.0 ;2;94;64;2;0;0;2;0;2;0;2;0
15296; 36.2 ; 108.6 ; 11.4 ;3;32;52;0;3;0;3;0;3;1;2;0
15297; 22.7 ; 45.3 ; 5.1 ;2;4;257;0;2;1;1;1;1;2;0;0
15298; 22.3 ; 44.5 ; 4.2 ;2;3;236;0;2;1;1;2;0;2;0;0
15299; 78.5 ; 392.5 ; 64.7 ;5;17;11;0;5;0;5;1;4;2;0;3
15300; 44.1 ; 1,321.7 ; 13.6 ;30;8;5;0;30;0;30;26;4;0;20;10
15301; 68.0 ; 679.7 ; 41.1 ;10;24;26;0;10;0;10;7;3;3;0;7
15302; 28.7 ; 143.4 ; 15.2 ;5;55;38;0;5;2;3;1;4;3;2;0
15303; 36.1 ; 541.1 ; 16.5 ;15;8;26;0;15;4;11;5;10;5;10;0
15304; 51.0 ; 102.1 ; 2.2 ;2;99;164;0;2;0;2;1;1;0;2;0
15305; 55.5 ; 110.9 ; 10.9 ;2;223;2;0;2;2;0;0;2;0;0;2
15306; 63.0 ; 252.2 ; 3.2 ;4;59;146;0;4;2;2;4;0;0;0;4
15307; 86.9 ; 260.7 ; 63.4 ;3;86;20;0;3;0;3;3;0;1;0;2
15308; 21.7 ; 65.1 ; 6.2 ;3;24;53;3;0;1;2;1;2;3;0;0
15309; 48.4 ; 193.5 ; 3.4 ;4;19;83;3;1;0;4;4;0;0;4;0
15310; 36.7 ; 183.4 ; 25.8 ;5;80;10;0;5;0;5;4;1;2;1;2
15311; 32.4 ; 129.5 ; 11.2 ;4;97;29;0;4;2;2;4;0;1;3;0
15312; 19.0 ; 38.0 ; 6.0 ;2;252;62;1;1;0;2;1;1;2;0;0
15313; 42.6 ; 85.3 ; 9.1 ;2;12;178;0;2;0;2;1;1;0;2;0
15314; 46.8 ; 93.5 ; -   ;2;35;173;1;1;1;1;1;1;0;2;0
15315; 25.0 ; 50.0 ; 7.4 ;2;73;125;0;2;1;1;0;2;1;1;0
15316; 86.1 ; 172.2 ; 18.5 ;2;1;90;0;2;1;1;1;1;0;0;2
15317; 37.6 ; 112.7 ; 8.9 ;3;198;17;0;3;1;2;1;2;1;2;0
15318; 53.3 ; 906.9 ; 27.1 ;17;20;8;0;17;6;11;12;5;6;5;6
15319; 41.6 ; 83.3 ; 8.7 ;2;293;99;0;2;1;1;1;1;0;2;0
15320; 38.8 ; 77.7 ; 12.9 ;2;101;46;1;1;1;1;0;2;1;1;0
15321; 43.9 ; 87.8 ; 16.7 ;2;14;194;0;2;0;2;1;1;1;0;1
15322; 25.1 ; 351.9 ; 10.8 ;14;26;14;0;14;12;2;13;1;9;5;0
15323; 38.3 ; 115.0 ; 4.8 ;3;88;73;3;0;0;3;0;3;0;3;0
15324; 33.5 ; 167.6 ; 14.3 ;5;49;0;2;3;0;5;5;0;2;3;0
15325; 18.1 ; 36.2 ; 0.2 ;2;27;6;2;0;1;1;1;1;2;0;0
15326; 46.2 ; 369.7 ; 23.9 ;8;30;168;0;8;2;6;3;5;3;2;3
15327; 31.1 ; 341.8 ; 22.5 ;11;19;89;0;11;5;6;5;6;4;7;0
15328; 26.0 ; 130.0 ; 6.9 ;5;41;125;0;5;0;5;2;3;3;2;0
15329; 73.5 ; 220.4 ; 11.4 ;3;44;31;0;3;0;3;3;0;0;0;3
15330; 24.2 ; 556.0 ; 12.6 ;23;9;10;23;0;11;12;16;7;15;8;0
15331; 62.0 ; 123.9 ; 8.7 ;2;125;225;0;2;0;2;2;0;0;0;2
15332; 63.4 ; 317.0 ; 20.0 ;5;7;40;5;0;3;2;1;4;0;0;5
15333; 21.3 ; 42.6 ; 9.4 ;2;112;181;1;1;2;0;1;1;1;1;0
15334; 43.9 ; 702.2 ; 24.4 ;16;20;1;0;16;5;11;10;6;5;6;5
15335; 39.9 ; 279.1 ; 20.0 ;7;36;16;1;6;1;6;5;2;2;3;2
15336; 16.1 ; 64.4 ; 2.4 ;4;16;126;0;4;0;4;4;0;4;0;0
15337; 15.0 ; 30.0 ; -   ;2;148;30;0;2;1;1;0;2;2;0;0
15338; 98.9 ; 197.7 ; 24.2 ;2;42;278;0;2;1;1;2;0;0;0;2
15339; 39.3 ; 275.1 ; 10.4 ;7;40;16;0;7;2;5;5;2;2;5;0
15340; 35.0 ; 175.1 ; 21.2 ;5;22;197;0;5;2;3;5;0;2;1;2
15341; 49.6 ; 99.2 ; 3.2 ;2;19;61;2;0;2;0;2;0;0;2;0
15342; 40.5 ; 323.6 ; 6.2 ;8;34;36;0;8;0;8;7;1;0;8;0
15343; 44.4 ; 399.3 ; 22.2 ;9;34;8;0;9;2;7;5;4;3;3;3
15344; 27.6 ; 55.3 ; 3.8 ;2;73;99;0;2;1;1;2;0;1;1;0
15345; 45.9 ; 137.6 ; 6.5 ;3;82;111;0;3;0;3;1;2;0;3;0
15346; 102.3 ; 204.6 ; 24.1 ;2;307;59;0;2;0;2;1;1;0;0;2
15347; 43.8 ; 131.5 ; 6.7 ;3;53;36;0;3;0;3;3;0;0;3;0
15348; 15.0 ; 30.0 ; -   ;2;14;57;0;2;0;2;2;0;2;0;0
15349; 89.3 ; 357.1 ; 49.9 ;4;7;239;0;4;3;1;1;3;0;0;4
15350; 31.3 ; 375.1 ; 14.0 ;12;17;10;0;12;1;11;10;2;4;8;0
15351; 20.0 ; 40.1 ; 7.6 ;2;9;83;0;2;1;1;2;0;2;0;0
15352; 52.2 ; 104.3 ; 8.1 ;2;60;210;0;2;1;1;2;0;0;1;1
15353; 23.7 ; 47.5 ; 13.1 ;2;8;251;0;2;1;1;1;1;1;1;0
15354; 32.4 ; 64.8 ; 21.5 ;2;211;105;0;2;1;1;0;2;1;1;0
15355; 63.9 ; 319.5 ; 11.5 ;5;54;99;0;5;0;5;4;1;0;0;5
15356; 33.5 ; 234.5 ; 9.7 ;7;28;91;0;7;2;5;2;5;2;5;0
15357; 16.7 ; 366.7 ; 4.1 ;22;8;236;0;22;10;12;4;18;22;0;0
15358; 22.6 ; 45.2 ; 11.4 ;2;81;163;0;2;0;2;2;0;1;1;0
15359; 73.3 ; 219.8 ; 22.9 ;3;31;47;3;0;0;3;3;0;0;0;3
15360; 50.9 ; 305.2 ; 16.3 ;6;46;44;3;3;1;5;4;2;0;4;2
15361; 42.9 ; 214.6 ; 20.4 ;5;50;73;0;5;3;2;3;2;2;1;2
15362; 54.5 ; 272.5 ; 8.4 ;5;26;68;5;0;0;5;4;1;0;3;2
15363; 21.6 ; 108.1 ; 14.3 ;5;22;147;0;5;4;1;3;2;3;2;0
15364; 51.5 ; 1,339.0 ; 36.4 ;26;12;5;0;26;13;13;13;13;9;8;9
15365; 42.7 ; 128.2 ; 5.6 ;3;98;10;3;0;0;3;3;0;0;3;0
15366; 44.6 ; 89.1 ; 21.5 ;2;67;10;0;2;1;1;1;1;1;0;1
15367; 60.0 ; 300.2 ; 40.7 ;5;88;20;0;5;1;4;4;1;2;0;3
15368; 47.9 ; 143.6 ; 1.0 ;3;107;5;0;3;0;3;3;0;0;3;0
15369; 31.4 ; 596.1 ; 8.3 ;19;10;107;0;19;8;11;19;0;6;13;0
15370; 44.8 ; 89.7 ; 12.6 ;2;23;74;0;2;1;1;2;0;0;1;1
15371; 72.5 ; 145.1 ; 7.6 ;2;150;146;0;2;0;2;2;0;0;0;2
15372; 16.4 ; 65.4 ; 2.9 ;4;40;194;0;4;0;4;3;1;4;0;0
15373; 49.6 ; 99.3 ; 4.3 ;2;2;284;0;2;1;1;1;1;0;2;0
15374; 58.4 ; 408.8 ; 27.0 ;7;38;39;0;7;0;7;7;0;0;0;7
15375; 51.5 ; 257.5 ; 10.6 ;5;75;26;0;5;2;3;3;2;0;3;2
15376; 46.3 ; 139.0 ; 9.8 ;3;98;113;0;3;3;0;1;2;0;2;1
15377; 24.1 ; 362.0 ; 10.1 ;15;28;26;0;15;2;13;12;3;10;5;0
15378; 28.8 ; 287.6 ; 13.5 ;10;36;94;0;10;5;5;4;6;7;3;0
15379; 88.7 ; 177.4 ; 59.8 ;2;37;186;2;0;2;0;2;0;1;0;1
15380; 17.0 ; 85.0 ; 2.9 ;5;23;248;0;5;4;1;5;0;5;0;0
15381; 21.9 ; 109.7 ; 9.2 ;5;14;5;0;5;1;4;2;3;3;2;0
15382; 55.1 ; 165.2 ; 18.7 ;3;48;36;0;3;0;3;3;0;0;0;3
15383; 16.5 ; 33.0 ; 2.3 ;2;9;117;0;2;2;0;1;1;2;0;0
15384; 35.9 ; 71.8 ; 16.2 ;2;77;231;0;2;1;1;2;0;1;1;0
15385; 19.9 ; 79.7 ; 7.5 ;4;127;29;0;4;3;1;3;1;4;0;0
15386; 47.1 ; 141.4 ; 9.7 ;3;14;107;0;3;2;1;1;2;0;2;1
15387; 20.1 ; 40.2 ; 2.3 ;2;12;118;0;2;2;0;2;0;2;0;0
15388; 23.9 ; 383.0 ; 14.9 ;16;16;11;0;16;6;10;10;6;11;5;0
15389; 15.0 ; 30.0 ; -   ;2;24;184;2;0;0;2;2;0;2;0;0
15390; 23.4 ; 70.2 ; 3.2 ;3;5;388;0;3;0;3;1;2;3;0;0
15391; 15.7 ; 78.5 ; 1.7 ;5;9;262;0;5;0;5;3;2;5;0;0
15392; 84.5 ; 253.5 ; 59.4 ;3;150;22;0;3;0;3;3;0;1;0;2
15393; 58.1 ; 116.2 ; 6.2 ;2;25;23;2;0;2;0;2;0;0;0;2
15394; 39.9 ; 358.9 ; 12.8 ;9;18;255;0;9;2;7;2;7;3;6;0
15395; 15.0 ; 59.9 ; -   ;4;70;25;0;4;4;0;3;1;4;0;0
15396; 73.6 ; 1,029.7 ; 37.2 ;14;23;6;0;14;7;7;4;10;0;0;14
15397; 68.6 ; 343.1 ; 34.3 ;5;34;35;0;5;4;1;3;2;0;0;5
15398; 47.7 ; 619.7 ; 22.0 ;13;20;8;0;13;6;7;9;4;4;5;4
15399; 24.5 ; 147.2 ; 12.2 ;6;14;310;0;6;2;4;1;5;4;2;0
15400; 15.0 ; 30.0 ; -   ;2;314;100;0;2;0;2;2;0;2;0;0
15401; 15.0 ; 74.9 ; -   ;5;22;9;2;3;4;1;1;4;5;0;0
15402; 41.9 ; 83.8 ; 25.2 ;2;295;7;0;2;1;1;1;1;1;0;1
15403; 128.2 ; 256.4 ; 69.5 ;2;13;11;0;2;0;2;0;2;0;0;2
15404; 40.7 ; 203.5 ; 17.6 ;5;43;16;0;5;2;3;4;1;2;1;2
15405; 102.6 ; 1,129.1 ; 29.0 ;11;22;36;0;11;0;11;11;0;0;0;11
15406; 185.2 ; 370.5 ; 41.5 ;2;35;98;0;2;2;0;0;2;0;0;2
15407; 53.6 ; 160.7 ; 8.0 ;3;14;243;0;3;2;1;0;3;0;2;1
15408; 42.1 ; 168.4 ; 25.2 ;4;57;77;0;4;2;2;0;4;1;2;1
15409; 47.5 ; 94.9 ; -   ;2;25;62;0;2;1;1;2;0;0;2;0
15410; 27.2 ; 217.3 ; 12.0 ;8;20;3;0;8;3;5;4;4;5;3;0
15411; 47.5 ; 94.9 ; -   ;2;14;74;2;0;0;2;2;0;0;2;0
15412; 30.8 ; 61.7 ; 8.6 ;2;27;219;0;2;1;1;2;0;1;1;0
15413; 15.6 ; 46.8 ; 1.1 ;3;24;231;0;3;0;3;0;3;3;0;0
15414; 36.9 ; 73.8 ; 17.7 ;2;6;0;0;2;0;2;2;0;1;1;0
15415; 26.7 ; 507.9 ; 12.9 ;19;8;62;0;19;8;11;9;10;13;6;0
15416; 42.1 ; 126.4 ; 10.2 ;3;72;89;0;3;0;3;2;1;0;3;0
15417; 118.4 ; 236.8 ; 27.5 ;2;2;187;0;2;1;1;2;0;0;0;2
15418; 65.1 ; 585.6 ; 45.0 ;9;14;68;0;9;1;8;9;0;3;0;6
15419; 19.7 ; 59.0 ; -   ;3;38;58;0;3;0;3;1;2;3;0;0
15420; 21.8 ; 261.2 ; 8.0 ;12;24;11;0;12;3;9;4;8;12;0;0
15421; 33.4 ; 133.5 ; 11.1 ;4;27;54;0;4;1;3;2;2;1;3;0
15422; 24.9 ; 49.7 ; 4.9 ;2;75;77;0;2;2;0;0;2;2;0;0
15423; 56.3 ; 112.7 ; 39.5 ;2;210;25;0;2;1;1;2;0;1;0;1
15424; 48.2 ; 96.3 ; 2.1 ;2;8;236;0;2;1;1;2;0;0;2;0
15425; 48.3 ; 241.4 ; 17.9 ;5;47;68;0;5;2;3;3;2;0;3;2
15426; 47.7 ; 381.5 ; 6.9 ;8;40;44;0;8;2;6;3;5;0;8;0
15427; 42.6 ; 85.2 ; 9.0 ;2;36;263;0;2;0;2;2;0;0;2;0
15428; 19.8 ; 39.7 ; 1.9 ;2;15;160;0;2;1;1;1;1;2;0;0
15429; 29.0 ; 57.9 ; 13.9 ;2;88;282;0;2;2;0;1;1;1;1;0
15430; 40.7 ; 122.1 ; 14.4 ;3;92;78;0;3;0;3;1;2;1;1;1
15431; 48.2 ; 144.5 ; 2.6 ;3;85;115;0;3;1;2;3;0;0;3;0
15432; 41.2 ; 206.1 ; 27.6 ;5;68;53;0;5;1;4;2;3;2;1;2
15433; 30.1 ; 90.2 ; 17.1 ;3;14;15;1;2;1;2;2;1;1;2;0
15434; 24.9 ; 274.4 ; 10.5 ;11;14;12;0;11;8;3;7;4;7;4;0
15435; 19.0 ; 75.9 ; 4.2 ;4;28;212;0;4;4;0;4;0;4;0;0
15436; 62.7 ; 188.1 ; 3.2 ;3;72;167;0;3;0;3;3;0;0;0;3
15437; 44.8 ; 986.6 ; 8.6 ;22;21;19;0;22;4;18;15;7;0;22;0
15438; 23.7 ; 118.4 ; 11.5 ;5;61;125;0;5;5;0;0;5;3;2;0
15439; 68.4 ; 136.8 ; 17.0 ;2;125;162;0;2;0;2;2;0;0;0;2
15440; 55.3 ; 166.0 ; 36.9 ;3;141;36;0;3;0;3;3;0;1;0;2
15441; 71.8 ; 287.1 ; 19.7 ;4;73;47;0;4;0;4;4;0;0;0;4
15442; 28.2 ; 112.9 ; 16.1 ;4;63;116;0;4;2;2;4;0;3;1;0
15443; 37.2 ; 372.2 ; 9.1 ;10;13;88;0;10;4;6;4;6;3;7;0
15444; 66.9 ; 401.5 ; 22.6 ;6;44;7;5;1;2;4;5;1;0;0;6
15445; 37.1 ; 74.2 ; 8.4 ;2;7;14;0;2;1;1;2;0;1;1;0
15446; 22.3 ; 111.4 ; 6.7 ;5;1;259;0;5;3;2;3;2;5;0;0
15447; 41.2 ; 123.5 ; 24.5 ;3;94;6;0;3;0;3;1;2;1;1;1
15448; 62.6 ; 438.5 ; 12.9 ;7;53;80;0;7;4;3;2;5;0;0;7
15449; 27.9 ; 111.5 ; 4.4 ;4;8;47;0;4;1;3;0;4;3;1;0
15450; 32.0 ; 63.9 ; 22.2 ;2;60;275;0;2;1;1;0;2;1;1;0
15451; 83.6 ; 167.3 ; 3.2 ;2;1;242;0;2;1;1;1;1;0;0;2
15452; 19.7 ; 196.9 ; 8.2 ;10;21;98;0;10;4;6;7;3;10;0;0
15453; 27.1 ; 54.2 ; -   ;2;26;98;0;2;2;0;2;0;2;0;0
15454; 52.3 ; 104.6 ; 14.1 ;2;11;185;0;2;0;2;0;2;0;1;1
15455; 22.7 ; 113.7 ; 10.0 ;5;70;59;0;5;1;4;3;2;3;2;0
15456; 36.3 ; 1,671.9 ; 15.8 ;46;7;0;0;46;16;30;24;22;15;31;0
15457; 79.5 ; 476.9 ; 41.8 ;6;50;26;0;6;0;6;6;0;0;0;6
15458; 26.7 ; 80.1 ; 12.2 ;3;41;110;0;3;0;3;1;2;2;1;0
15459; 18.8 ; 75.1 ; 4.1 ;4;57;142;0;4;1;3;0;4;4;0;0
15460; 24.3 ; 121.6 ; 9.1 ;5;32;74;0;5;1;4;3;2;3;2;0
15461; 44.3 ; 265.8 ; 26.7 ;6;14;144;0;6;5;1;2;4;2;2;2
15462; 20.9 ; 250.7 ; 8.2 ;12;24;32;0;12;4;8;6;6;12;0;0
15463; 29.0 ; 232.3 ; 17.0 ;8;23;16;0;8;4;4;6;2;5;3;0
15464; 23.9 ; 71.8 ; 5.8 ;3;72;93;0;3;2;1;0;3;3;0;0
15465; 28.9 ; 86.8 ; 17.2 ;3;61;134;0;3;2;1;1;2;2;1;0
15466; 54.7 ; 109.3 ; 3.2 ;2;42;69;0;2;0;2;0;2;0;1;1
15467; 64.0 ; 768.1 ; 22.5 ;12;5;232;0;12;8;4;10;2;0;0;12
15468; 15.0 ; 30.0 ; -   ;2;4;86;2;0;1;1;0;2;2;0;0
15469; 34.9 ; 209.5 ; 8.6 ;6;37;63;0;6;0;6;3;3;2;4;0
15470; 43.0 ; 128.9 ; 12.4 ;3;54;110;0;3;0;3;2;1;0;2;1
15471; 30.8 ; 61.7 ; 8.6 ;2;19;223;0;2;2;0;2;0;1;1;0
15472; 37.7 ; 150.6 ; 2.3 ;4;5;94;0;4;1;3;2;2;0;4;0
15473; 56.8 ; 794.8 ; 26.9 ;14;24;6;0;14;3;11;3;11;5;0;9
15474; 101.3 ; 202.6 ; 120.1 ;2;95;23;1;1;2;0;1;1;1;0;1
15475; 42.6 ; 85.3 ; 9.1 ;2;86;300;0;2;0;2;1;1;0;2;0
15476; 45.3 ; 135.9 ; 13.9 ;3;22;80;0;3;0;3;3;0;0;2;1
15477; 39.8 ; 79.5 ; 10.5 ;2;188;4;0;2;2;0;2;0;1;1;0
15478; 41.8 ; 167.3 ; 19.1 ;4;42;36;0;4;1;3;2;2;1;2;1
15479; 17.1 ; 34.3 ; 3.2 ;2;72;197;0;2;1;1;2;0;2;0;0
15480; 35.9 ; 71.8 ; 16.2 ;2;6;241;0;2;0;2;0;2;1;1;0
15481; 20.0 ; 40.1 ; 7.6 ;2;240;26;0;2;0;2;0;2;2;0;0
15482; 51.8 ; 1,036.8 ; 28.2 ;20;16;7;0;20;14;6;5;15;7;6;7
15483; 24.1 ; 96.3 ; 7.1 ;4;50;8;0;4;3;1;4;0;3;1;0
15484; 57.0 ; 114.0 ; 6.7 ;2;35;351;0;2;1;1;1;1;0;0;2
15485; 51.6 ; 258.2 ; 7.0 ;5;38;245;0;5;3;2;2;3;0;3;2
15486; 110.3 ; 220.6 ; 18.8 ;2;5;236;0;2;0;2;2;0;0;0;2
15487; 108.7 ; 434.9 ; 60.3 ;4;110;77;0;4;2;2;2;2;0;0;4
15488; 34.3 ; 616.9 ; 18.8 ;18;15;93;0;18;11;7;7;11;6;12;0
15489; 33.2 ; 99.7 ; 15.0 ;3;72;99;1;2;0;3;3;0;1;2;0
15490; 24.9 ; 174.2 ; 9.7 ;7;30;8;0;7;4;3;5;2;5;2;0
15491; 45.1 ; 135.4 ; 26.9 ;3;59;10;0;3;0;3;2;1;1;1;1
15492; 42.3 ; 127.0 ; 11.0 ;3;48;182;0;3;2;1;1;2;0;3;0
15493; 47.6 ; 142.8 ; 1.8 ;3;120;221;0;3;0;3;1;2;0;3;0
15494; 44.8 ; 89.6 ; 2.9 ;2;149;140;0;2;2;0;0;2;0;2;0
15495; 45.9 ; 275.5 ; 10.2 ;6;9;5;0;6;0;6;4;2;0;4;2
15496; 18.2 ; 90.8 ; 7.0 ;5;27;9;0;5;3;2;3;2;5;0;0
15497; 28.3 ; 254.4 ; 5.0 ;9;19;121;0;9;4;5;1;8;6;3;0
15498; 54.3 ; 271.4 ; 15.9 ;5;61;6;0;5;0;5;4;1;0;3;2
15499; 72.7 ; 290.9 ; 13.6 ;4;49;184;1;3;0;4;4;0;0;0;4
15500; 20.0 ; 100.1 ; 5.9 ;5;38;73;0;5;0;5;5;0;5;0;0
15501; 37.2 ; 74.3 ; -   ;2;6;271;0;2;2;0;0;2;0;2;0
15502; 27.9 ; 251.5 ; 13.5 ;9;14;35;0;9;4;5;5;4;6;3;0
15503; 35.9 ; 71.9 ; 6.1 ;2;1;99;0;2;0;2;2;0;1;1;0
15504; 63.6 ; 254.5 ; 20.3 ;4;112;47;0;4;1;3;3;1;0;0;4
15505; 23.3 ; 46.6 ; 10.3 ;2;296;38;0;2;2;0;2;0;1;1;0
15506; 67.3 ; 336.6 ; 27.8 ;5;35;160;0;5;4;1;5;0;0;0;5
15507; 29.7 ; 148.4 ; 6.7 ;5;29;53;0;5;1;4;2;3;3;2;0
15508; 15.0 ; 30.0 ; -   ;2;96;186;0;2;2;0;1;1;2;0;0
15509; 48.8 ; 682.9 ; 30.9 ;14;18;5;0;14;3;11;10;4;5;4;5
15510; 37.1 ; 259.8 ; 15.3 ;7;6;146;0;7;2;5;4;3;2;5;0
15511; 35.0 ; 595.2 ; 12.1 ;17;15;54;0;17;8;9;10;7;6;11;0
15512; 33.3 ; 100.0 ; 11.0 ;3;58;99;3;0;1;2;3;0;1;2;0
15513; 24.3 ; 121.3 ; 8.2 ;5;35;67;0;5;3;2;5;0;3;2;0
15514; 40.8 ; 367.5 ; 13.3 ;9;51;5;0;9;0;9;2;7;3;6;0
15515; 53.8 ; 107.7 ; 3.4 ;2;5;258;0;2;0;2;1;1;0;1;1
15516; 26.0 ; 312.5 ; 12.4 ;12;20;5;0;12;2;10;8;4;8;4;0
15517; 45.1 ; 225.3 ; 37.2 ;5;39;0;0;5;2;3;3;2;2;1;2
15518; 36.0 ; 324.2 ; 14.1 ;9;25;3;0;9;7;2;5;4;3;6;0
15519; 47.5 ; 94.9 ; -   ;2;31;73;0;2;0;2;0;2;0;2;0
15520; 49.0 ; 146.9 ; 0.6 ;3;20;234;0;3;2;1;1;2;0;3;0
15521; 64.7 ; 129.3 ; 18.6 ;2;82;165;0;2;2;0;2;0;0;0;2
15522; 49.6 ; 99.2 ; 3.2 ;2;5;44;0;2;1;1;2;0;0;2;0
15523; 20.0 ; 40.1 ; 7.6 ;2;5;263;0;2;1;1;0;2;2;0;0
15524; 61.4 ; 122.8 ; 21.9 ;2;24;241;0;2;0;2;2;0;0;0;2
15525; 21.6 ; 43.3 ; 5.1 ;2;145;0;0;2;0;2;1;1;2;0;0
15526; 47.8 ; 95.7 ; 0.5 ;2;43;20;2;0;0;2;0;2;0;2;0
15527; 40.8 ; 122.5 ; 12.0 ;3;93;113;0;3;2;1;1;2;1;2;0
15528; 19.0 ; 398.1 ; 8.1 ;21;11;2;0;21;16;5;13;8;21;0;0
15529; 68.7 ; 137.4 ; 16.8 ;2;7;243;0;2;2;0;0;2;0;0;2
15530; 27.1 ; 81.3 ; 23.3 ;3;44;66;3;0;3;0;3;0;2;1;0
15531; 20.7 ; 41.3 ; 1.1 ;2;10;11;0;2;0;2;2;0;2;0;0
15532; 46.2 ; 184.7 ; 17.2 ;4;5;119;0;4;3;1;1;3;1;2;1
15533; 38.5 ; 307.8 ; 15.9 ;8;30;16;0;8;1;7;2;6;3;5;0
15534; 36.3 ; 72.5 ; 16.8 ;2;46;5;0;2;0;2;0;2;1;1;0
15535; 44.4 ; 88.9 ; 11.8 ;2;3;163;0;2;1;1;0;2;0;1;1
15536; 72.4 ; 434.2 ; 40.1 ;6;39;20;0;6;0;6;4;2;0;0;6
15537; 32.7 ; 65.4 ; 4.1 ;2;115;52;0;2;1;1;1;1;1;1;0
15538; 41.1 ; 123.3 ; 14.7 ;3;26;230;0;3;1;2;3;0;1;1;1
15539; 93.4 ; 186.7 ; 49.4 ;2;4;110;2;0;1;1;1;1;0;0;2
15540; 47.1 ; 94.2 ; 9.2 ;2;193;44;0;2;1;1;0;2;0;1;1
15541; 35.8 ; 393.6 ; 21.3 ;11;8;99;0;11;2;9;6;5;4;3;4
15542; 48.8 ; 243.9 ; 7.5 ;5;47;81;1;4;3;2;1;4;0;3;2
15543; 36.4 ; 109.1 ; 11.3 ;3;25;57;3;0;1;2;1;2;1;2;0
15544; 66.0 ; 396.2 ; 42.6 ;6;52;35;0;6;5;1;6;0;2;0;4
15545; 15.0 ; 30.0 ; -   ;2;29;295;0;2;0;2;1;1;2;0;0
15546; 54.4 ; 163.1 ; 9.2 ;3;160;11;0;3;0;3;2;1;0;2;1
15547; 31.1 ; 155.5 ; 10.0 ;5;47;11;0;5;0;5;3;2;2;3;0
15548; 38.5 ; 153.8 ; 11.3 ;4;50;131;0;4;1;3;0;4;1;3;0
15549; 15.0 ; 45.0 ; -   ;3;51;2;0;3;2;1;1;2;3;0;0
15550; 15.0 ; 45.0 ; -   ;3;20;155;0;3;2;1;1;2;3;0;0
15551; 46.8 ; 187.0 ; -   ;4;26;195;0;4;1;3;1;3;0;4;0
15552; 85.1 ; 425.6 ; 46.7 ;5;76;15;0;5;1;4;4;1;0;0;5
15553; 47.1 ; 188.5 ; 11.1 ;4;62;42;1;3;2;2;0;4;0;3;1
15554; 76.4 ; 305.6 ; 49.5 ;4;95;104;1;3;0;4;4;0;1;0;3
15555; 18.0 ; 36.1 ; 4.6 ;2;102;51;0;2;1;1;0;2;2;0;0
15556; 18.2 ; 218.3 ; 4.2 ;12;21;23;12;0;9;3;12;0;12;0;0
15557; 69.5 ; 347.6 ; 20.8 ;5;20;320;0;5;2;3;3;2;0;0;5
15558; 17.1 ; 34.2 ; 3.2 ;2;28;73;0;2;1;1;0;2;2;0;0
15559; 42.5 ; 127.6 ; 16.2 ;3;27;258;0;3;1;2;1;2;1;1;1
15560; 46.5 ; 92.9 ; 41.8 ;2;67;236;0;2;1;1;1;1;1;0;1
15561; 47.8 ; 95.7 ; 0.5 ;2;94;15;0;2;1;1;2;0;0;2;0
15562; 51.3 ; 102.7 ; 15.6 ;2;87;310;0;2;0;2;0;2;0;1;1
15563; 19.7 ; 39.5 ; -   ;2;2;270;0;2;2;0;0;2;2;0;0
15564; 46.9 ; 93.9 ; 6.1 ;2;19;199;2;0;0;2;2;0;0;2;0
15565; 61.5 ; 491.8 ; 30.5 ;8;19;45;1;7;1;7;4;4;0;0;8
15566; 36.5 ; 619.8 ; 12.7 ;17;23;11;0;17;11;6;5;12;6;11;0
15567; 29.6 ; 414.2 ; 22.5 ;14;28;25;0;14;4;10;10;4;9;5;0
15568; 51.3 ; 256.7 ; 7.6 ;5;19;188;0;5;0;5;0;5;0;3;2
15569; 15.0 ; 45.0 ; -   ;3;31;344;0;3;1;2;1;2;3;0;0
15570; 27.8 ; 333.8 ; 11.9 ;12;32;33;0;12;2;10;10;2;8;4;0
15571; 56.1 ; 1,010.1 ; 39.0 ;18;18;5;0;18;5;13;15;3;6;0;12
15572; 50.6 ; 253.1 ; 5.0 ;5;26;62;0;5;1;4;1;4;0;3;2
15573; 28.2 ; 225.9 ; 12.5 ;8;39;30;0;8;5;3;5;3;5;3;0
15574; 44.5 ; 222.7 ; 7.3 ;5;65;8;0;5;2;3;2;3;0;5;0
15575; 79.1 ; 316.5 ; 10.8 ;4;64;48;0;4;1;3;4;0;0;0;4
15576; 121.9 ; 731.3 ; 102.3 ;6;30;110;0;6;0;6;5;1;2;0;4
15577; 122.1 ; 244.2 ; 109.9 ;2;163;125;0;2;0;2;2;0;1;0;1
15578; 95.9 ; 287.8 ; 56.6 ;3;120;89;0;3;0;3;3;0;0;0;3
15579; 36.8 ; 257.5 ; 10.4 ;7;23;38;0;7;0;7;7;0;2;5;0
15580; 17.1 ; 34.3 ; 3.2 ;2;19;262;0;2;0;2;1;1;2;0;0
15581; 15.0 ; 45.0 ; -   ;3;41;38;0;3;2;1;2;1;3;0;0
15582; 22.8 ; 113.8 ; 15.5 ;5;35;5;0;5;0;5;3;2;3;2;0
15583; 43.1 ; 258.5 ; 36.9 ;6;25;1;0;6;0;6;2;4;2;2;2
15584; 48.5 ; 97.0 ; 1.6 ;2;158;34;0;2;2;0;0;2;0;2;0
15585; 81.5 ; 163.0 ; 38.0 ;2;129;136;0;2;1;1;2;0;0;0;2
15586; 31.5 ; 694.0 ; 14.8 ;22;14;7;0;22;9;13;5;17;7;15;0
15587; 38.1 ; 190.4 ; 12.6 ;5;5;242;0;5;3;2;1;4;2;3;0
15588; 20.1 ; 221.5 ; 4.0 ;11;12;7;0;11;9;2;11;0;11;0;0
15589; 40.4 ; 201.8 ; 6.5 ;5;48;10;0;5;0;5;4;1;0;5;0
15590; 48.1 ; 433.2 ; 10.4 ;9;14;82;0;9;6;3;9;0;0;6;3
15591; 22.5 ; 338.1 ; 20.6 ;15;12;7;0;15;7;8;6;9;10;5;0
15592; 49.5 ; 247.3 ; 4.2 ;5;16;58;0;5;1;4;2;3;0;5;0
15593; 116.9 ; 233.8 ; 35.0 ;2;1;131;0;2;0;2;2;0;0;0;2
15594; 21.5 ; 86.0 ; 1.6 ;4;32;92;2;2;1;3;4;0;4;0;0
15595; 49.4 ; 148.3 ; 27.3 ;3;68;227;0;3;1;2;3;0;1;1;1
15596; 55.5 ; 166.5 ; 5.5 ;3;77;143;0;3;1;2;1;2;0;0;3
15597; 20.0 ; 40.1 ; 7.6 ;2;12;227;0;2;0;2;0;2;2;0;0
15598; 31.1 ; 93.4 ; 10.7 ;3;20;197;0;3;3;0;2;1;1;2;0
15599; 20.0 ; 40.1 ; 7.6 ;2;9;250;0;2;1;1;2;0;2;0;0
15600; 33.9 ; 101.8 ; 17.7 ;3;122;38;0;3;0;3;3;0;1;2;0
15601; 47.1 ; 94.2 ; 0.5 ;2;76;103;1;1;2;0;1;1;0;2;0
15602; 17.0 ; 51.0 ; 1.9 ;3;61;41;0;3;1;2;0;3;3;0;0
15603; 44.9 ; 89.8 ; 25.2 ;2;245;63;0;2;0;2;1;1;1;0;1
15604; 32.5 ; 65.0 ; 11.1 ;2;75;115;0;2;0;2;2;0;1;1;0
15605; 34.0 ; 67.9 ; 13.3 ;2;20;188;0;2;0;2;2;0;1;1;0
15606; 30.0 ; 59.9 ; -   ;2;12;262;0;2;0;2;2;0;2;0;0
15607; 27.8 ; 278.0 ; 13.8 ;10;23;32;0;10;4;6;7;3;7;3;0
15608; 50.4 ; 151.3 ; 27.5 ;3;86;75;0;3;2;1;1;2;1;1;1
15609; 94.7 ; 1,041.6 ; 33.6 ;11;40;10;0;11;3;8;5;6;0;0;11
15610; 15.0 ; 30.0 ; -   ;2;33;41;0;2;1;1;0;2;2;0;0
15611; 20.8 ; 208.0 ; 11.0 ;10;19;6;0;10;4;6;2;8;7;3;0
15612; 59.4 ; 118.8 ; 57.3 ;2;5;152;0;2;0;2;1;1;1;0;1
15613; 25.1 ; 50.1 ; -   ;2;10;19;2;0;1;1;0;2;2;0;0
15614; 25.7 ; 128.3 ; 8.2 ;5;36;137;0;5;3;2;1;4;3;2;0
15615; 194.0 ; 582.1 ; 70.1 ;3;2;248;0;3;2;1;1;2;0;0;3
15616; 25.0 ; 75.1 ; 9.2 ;3;13;251;0;3;1;2;1;2;2;1;0
15617; 35.1 ; 105.2 ; 18.5 ;3;37;101;0;3;1;2;1;2;1;2;0
15618; 65.6 ; 262.2 ; 17.2 ;4;60;77;0;4;4;0;4;0;0;0;4
15619; 59.6 ; 178.9 ; 73.9 ;3;137;32;0;3;1;2;1;2;1;0;2
15620; 40.5 ; 121.5 ; 13.2 ;3;32;312;0;3;3;0;3;0;1;2;0
15621; 79.7 ; 159.4 ; 17.2 ;2;166;50;0;2;1;1;2;0;0;0;2
15622; 38.7 ; 116.1 ; 3.4 ;3;31;2;0;3;1;2;1;2;0;3;0
15623; 23.3 ; 140.1 ; 6.8 ;6;9;242;0;6;2;4;2;4;4;2;0
15624; 47.1 ; 94.2 ; 0.5 ;2;40;99;0;2;0;2;2;0;0;2;0
15625; 56.4 ; 451.0 ; 21.0 ;8;34;78;0;8;0;8;8;0;0;0;8
15626; 40.7 ; 81.4 ; 31.5 ;2;1;314;0;2;1;1;2;0;1;0;1
15627; 62.0 ; 495.8 ; 36.8 ;8;41;113;0;8;2;6;6;2;3;0;5
15628; 71.7 ; 143.3 ; 28.7 ;2;18;220;0;2;0;2;2;0;0;0;2
15629; 50.3 ; 603.3 ; 10.3 ;12;27;83;0;12;0;12;12;0;0;8;4
15630; 33.2 ; 66.4 ; 22.4 ;2;18;5;0;2;0;2;1;1;1;0;1
15631; 37.2 ; 111.5 ; 14.1 ;3;97;10;0;3;0;3;3;0;1;2;0
15632; 70.0 ; 140.0 ; 27.3 ;2;3;99;0;2;1;1;1;1;0;0;2
15633; 38.8 ; 77.6 ; 20.5 ;2;3;392;0;2;1;1;0;2;1;0;1
15634; 26.1 ; 182.4 ; 12.2 ;7;36;21;0;7;1;6;3;4;5;2;0
15635; 20.0 ; 80.1 ; 6.2 ;4;17;143;0;4;2;2;2;2;4;0;0
15636; 65.1 ; 130.1 ; 18.8 ;2;135;126;0;2;1;1;1;1;0;0;2
15637; 49.4 ; 444.2 ; 48.6 ;9;20;12;0;9;4;5;3;6;3;3;3
15638; 41.3 ; 123.8 ; 2.2 ;3;120;20;1;2;0;3;3;0;0;3;0
15639; 15.0 ; 30.0 ; -   ;2;108;249;0;2;2;0;2;0;2;0;0
15640; 63.1 ; 126.3 ; 15.9 ;2;25;367;0;2;0;2;2;0;0;0;2
15641; 64.9 ; 324.3 ; 20.7 ;5;59;62;0;5;0;5;5;0;0;0;5
15642; 103.4 ; 310.3 ; 98.9 ;3;63;47;0;3;0;3;3;0;1;0;2
15643; 51.2 ; 358.7 ; 31.0 ;7;41;5;0;7;1;6;3;4;2;3;2
15644; 31.4 ; 125.8 ; 9.4 ;4;92;11;0;4;1;3;2;2;1;3;0
15645; 47.1 ; 94.2 ; 0.5 ;2;94;57;0;2;0;2;2;0;0;2;0
15646; 32.6 ; 65.1 ; 11.2 ;2;69;52;0;2;0;2;2;0;1;1;0
15647; 50.4 ; 151.1 ; 5.3 ;3;59;84;0;3;0;3;1;2;0;2;1
15648; 24.9 ; 49.7 ; 14.8 ;2;339;58;1;1;0;2;2;0;1;1;0
15649; 15.5 ; 108.7 ; 1.1 ;7;18;70;0;7;5;2;7;0;7;0;0
15650; 36.9 ; 110.6 ; 12.4 ;3;5;37;0;3;2;1;1;2;1;2;0
15651; 21.8 ; 43.5 ; 2.7 ;2;183;20;0;2;2;0;1;1;2;0;0
15652; 49.7 ; 149.2 ; 45.2 ;3;19;47;0;3;0;3;2;1;1;1;1
15653; 25.1 ; 50.1 ; -   ;2;108;152;0;2;0;2;0;2;2;0;0
15654; 37.5 ; 299.6 ; 15.5 ;8;35;20;0;8;5;3;5;3;3;5;0
15655; 35.1 ; 105.3 ; 5.2 ;3;4;80;0;3;3;0;1;2;1;2;0
15656; 36.7 ; 807.1 ; 10.7 ;22;16;0;0;22;2;20;10;12;7;15;0
15657; 18.0 ; 54.0 ; -   ;3;7;141;0;3;0;3;1;2;3;0;0
15658; 53.5 ; 588.6 ; 12.6 ;11;8;15;0;11;4;7;5;6;0;7;4
15659; 20.9 ; 41.7 ; 4.6 ;2;2;213;0;2;1;1;0;2;2;0;0
15660; 15.8 ; 189.5 ; 1.4 ;12;23;22;0;12;3;9;4;8;12;0;0
15661; 23.1 ; 46.2 ; 3.0 ;2;44;120;0;2;0;2;1;1;2;0;0
15662; 20.0 ; 200.3 ; 6.3 ;10;27;50;9;1;3;7;6;4;10;0;0
15663; 22.4 ; 44.8 ; 11.1 ;2;2;319;0;2;1;1;0;2;1;1;0
15664; 48.4 ; 96.7 ; 27.2 ;2;12;218;0;2;2;0;1;1;1;0;1
15665; 21.0 ; 126.1 ; 6.1 ;6;68;0;0;6;3;3;3;3;6;0;0
15666; 114.8 ; 229.5 ; 3.4 ;2;35;17;2;0;1;1;2;0;0;0;2
15667; 59.8 ; 119.6 ; 13.6 ;2;133;183;0;2;0;2;1;1;0;0;2
15668; 39.3 ; 157.2 ; 14.0 ;4;23;105;0;4;1;3;3;1;1;3;0
15669; 49.9 ; 299.2 ; 9.6 ;6;14;83;0;6;6;0;6;0;0;4;2
15670; 56.4 ; 112.9 ; 3.7 ;2;88;10;0;2;0;2;1;1;0;0;2
15671; 42.1 ; 379.2 ; 18.3 ;9;17;5;0;9;1;8;5;4;3;3;3
15672; 39.9 ; 119.6 ; 7.6 ;3;38;5;0;3;1;2;2;1;0;3;0
15673; 64.0 ; 255.9 ; 20.9 ;4;24;65;0;4;1;3;4;0;0;0;4
15674; 17.2 ; 34.4 ; 3.3 ;2;388;29;0;2;1;1;1;1;2;0;0
15675; 41.3 ; 248.0 ; 6.3 ;6;53;22;0;6;0;6;3;3;0;6;0
15676; 37.8 ; 1,209.6 ; 10.4 ;32;11;6;0;32;12;20;10;22;11;21;0
15677; 27.8 ; 361.9 ; 12.1 ;13;28;30;0;13;8;5;11;2;9;4;0
15678; 48.4 ; 145.1 ; 3.0 ;3;10;245;0;3;1;2;3;0;0;3;0
15679; 39.5 ; 474.5 ; 7.0 ;12;14;215;0;12;2;10;8;4;0;12;0
15680; 37.5 ; 150.0 ; 15.8 ;4;59;98;0;4;1;3;4;0;1;3;0
15681; 46.8 ; 93.5 ; -   ;2;40;230;0;2;1;1;1;1;0;2;0
15682; 33.0 ; 66.0 ; -   ;2;1;128;0;2;2;0;0;2;0;2;0
15683; 77.8 ; 778.1 ; 29.4 ;10;16;35;0;10;7;3;3;7;0;0;10
15684; 79.3 ; 555.4 ; 26.3 ;7;8;11;7;0;0;7;2;5;0;0;7
15685; 48.9 ; 537.8 ; 4.1 ;11;23;125;0;11;0;11;8;3;0;11;0
15686; 28.1 ; 280.9 ; 12.1 ;10;32;96;0;10;5;5;9;1;7;3;0
15687; 19.7 ; 98.6 ; 7.8 ;5;26;160;0;5;3;2;2;3;5;0;0
15688; 20.0 ; 39.9 ; 7.4 ;2;3;255;0;2;1;1;1;1;2;0;0
15689; 35.8 ; 393.9 ; 10.5 ;11;21;5;0;11;4;7;11;0;4;7;0
15690; 23.1 ; 46.2 ; 11.7 ;2;15;11;1;1;1;1;1;1;1;1;0
15691; 15.8 ; 31.7 ; -   ;2;63;38;2;0;2;0;2;0;2;0;0
15692; 79.8 ; 798.3 ; 31.3 ;10;32;57;0;10;1;9;5;5;0;0;10
15693; 148.0 ; 296.1 ; 101.3 ;2;35;154;0;2;1;1;2;0;0;0;2
15694; 35.1 ; 491.6 ; 15.5 ;14;14;86;0;14;6;8;7;7;5;9;0
15695; 42.1 ; 84.1 ; 25.5 ;2;8;226;0;2;1;1;1;1;1;0;1
15696; 17.9 ; 304.6 ; 4.8 ;17;18;3;0;17;9;8;11;6;17;0;0
15697; 32.5 ; 162.5 ; 16.1 ;5;26;35;0;5;2;3;0;5;2;3;0
15698; 50.0 ; 100.0 ; 4.9 ;2;30;131;2;0;1;1;1;1;0;2;0
15699; 46.0 ; 184.2 ; 13.8 ;4;43;86;1;3;3;1;3;1;0;3;1
15700; 49.6 ; 248.1 ; 26.9 ;5;40;257;0;5;2;3;2;3;2;1;2
15701; 64.0 ; 192.0 ; 31.0 ;3;97;65;0;3;2;1;2;1;0;0;3
15702; 29.3 ; 87.8 ; 1.3 ;3;113;8;0;3;2;1;1;2;2;1;0
15703; 37.1 ; 185.5 ; 21.5 ;5;47;95;0;5;2;3;5;0;2;1;2
15704; 36.9 ; 73.8 ; 17.7 ;2;20;389;0;2;1;1;0;2;1;1;0
15705; 18.0 ; 36.1 ; 4.6 ;2;34;133;0;2;2;0;2;0;2;0;0
15706; 30.0 ; 120.0 ; 22.0 ;4;47;8;0;4;3;1;4;0;3;1;0
15707; 33.5 ; 200.9 ; 21.6 ;6;46;17;0;6;3;3;3;3;2;2;2
15708; 19.1 ; 76.4 ; 7.7 ;4;42;56;0;4;3;1;3;1;4;0;0
15709; 35.9 ; 71.8 ; 16.2 ;2;23;296;0;2;2;0;2;0;1;1;0
15710; 25.8 ; 51.5 ; 15.0 ;2;28;251;0;2;2;0;0;2;1;1;0
15711; 31.1 ; 62.1 ; 24.0 ;2;9;265;0;2;1;1;1;1;1;0;1
15712; 28.8 ; 661.8 ; 11.5 ;23;13;16;0;23;4;19;20;3;15;8;0
15713; 23.4 ; 374.8 ; 13.3 ;16;14;194;0;16;9;7;11;5;11;5;0
15714; 60.9 ; 121.7 ; 14.1 ;2;95;104;0;2;0;2;2;0;0;0;2
15715; 46.8 ; 93.5 ; -   ;2;20;261;0;2;1;1;0;2;0;2;0
15716; 18.0 ; 108.0 ; 8.4 ;6;31;110;0;6;3;3;2;4;6;0;0
15717; 30.8 ; 369.5 ; 22.8 ;12;14;71;1;11;1;11;6;6;4;8;0
15718; 18.3 ; 55.0 ; 6.2 ;3;52;107;0;3;1;2;2;1;3;0;0
15719; 32.3 ; 322.7 ; 13.0 ;10;29;43;3;7;3;7;4;6;3;7;0
15720; 49.0 ; 98.0 ; 0.5 ;2;139;62;0;2;0;2;2;0;0;2;0
15721; 32.3 ; 129.3 ; 20.1 ;4;56;15;0;4;2;2;4;0;1;3;0
15722; 17.6 ; 123.1 ; 2.6 ;7;35;2;0;7;6;1;7;0;7;0;0
15723; 49.2 ; 886.5 ; 22.1 ;18;14;26;0;18;3;15;16;2;6;6;6
15724; 44.5 ; 445.2 ; 13.5 ;10;20;43;0;10;4;6;8;2;0;7;3
15725; 20.7 ; 62.2 ; 1.1 ;3;4;26;1;2;1;2;3;0;3;0;0
15726; 26.1 ; 130.7 ; 8.3 ;5;25;125;0;5;1;4;5;0;3;2;0
15727; 38.0 ; 114.0 ; 14.3 ;3;41;47;0;3;0;3;2;1;1;2;0
15728; 23.2 ; 325.2 ; 9.1 ;14;19;37;0;14;3;11;9;5;9;5;0
15729; 16.8 ; 117.6 ; 3.9 ;7;39;15;0;7;1;6;1;6;7;0;0
15730; 64.3 ; 128.5 ; 48.1 ;2;218;5;0;2;1;1;1;1;1;0;1
15731; 55.1 ; 165.2 ; 3.1 ;3;67;167;0;3;1;2;0;3;0;0;3
15732; 27.8 ; 222.1 ; 9.6 ;8;48;26;0;8;2;6;1;7;5;3;0
15733; 57.5 ; 287.4 ; -   ;5;34;163;0;5;2;3;1;4;0;0;5
15734; 35.8 ; 178.9 ; 18.2 ;5;63;69;0;5;2;3;2;3;2;3;0
15735; 61.4 ; 245.4 ; 30.4 ;4;19;160;0;4;2;2;4;0;0;0;4
15736; 47.7 ; 95.4 ; 1.4 ;2;5;373;0;2;0;2;1;1;0;2;0
15737; 30.9 ; 494.9 ; 19.1 ;16;20;110;0;16;6;10;9;7;5;11;0
15738; 29.8 ; 119.0 ; 11.4 ;4;27;45;0;4;3;1;0;4;3;1;0
15739; 69.1 ; 345.7 ; 28.9 ;5;67;83;0;5;0;5;5;0;0;0;5
15740; 34.5 ; 276.4 ; 12.4 ;8;26;59;2;6;1;7;0;8;3;5;0
15741; 26.1 ; 601.0 ; 12.7 ;23;14;14;0;23;14;9;12;11;15;8;0
15742; 65.3 ; 195.9 ; 26.7 ;3;72;36;0;3;1;2;2;1;0;0;3
15743; 41.8 ; 167.0 ; 10.7 ;4;82;21;0;4;1;3;2;2;0;4;0
15744; 64.4 ; 193.3 ; 3.8 ;3;40;22;0;3;0;3;3;0;0;0;3
15745; 53.6 ; 160.7 ; 7.5 ;3;205;15;0;3;0;3;3;0;0;2;1
15746; 48.9 ; 293.1 ; 7.1 ;6;58;41;0;6;0;6;2;4;0;4;2
15747; 94.9 ; 189.9 ; 71.1 ;2;8;57;2;0;1;1;2;0;1;0;1
15748; 52.0 ; 207.9 ; 11.5 ;4;41;241;0;4;1;3;2;2;0;3;1
15749; 49.5 ; 148.4 ; 7.5 ;3;92;200;1;2;0;3;1;2;0;2;1
15750; 65.4 ; 261.7 ; 37.3 ;4;103;5;0;4;0;4;4;0;1;0;3
15751; 29.2 ; 87.7 ; 0.7 ;3;49;116;0;3;2;1;3;0;3;0;0
15752; 19.7 ; 59.0 ; -   ;3;9;266;0;3;3;0;1;2;3;0;0
15753; 63.1 ; 126.3 ; 21.6 ;2;6;216;0;2;0;2;2;0;0;0;2
15754; 77.1 ; 1,156.7 ; 44.1 ;15;19;42;0;15;3;12;12;3;0;0;15
15755; 33.1 ; 165.3 ; 9.6 ;5;42;26;5;0;1;4;2;3;2;3;0
15756; 17.1 ; 68.2 ; 2.8 ;4;96;32;0;4;1;3;1;3;4;0;0
15757; 35.3 ; 106.0 ; 11.2 ;3;18;18;0;3;2;1;1;2;1;2;0
15758; 38.9 ; 272.0 ; 17.4 ;7;61;19;0;7;3;4;4;3;2;3;2
15759; 45.0 ; 404.6 ; 15.1 ;9;23;230;0;9;0;9;6;3;3;3;3
15760; 51.6 ; 154.7 ; 19.6 ;3;31;36;1;2;0;3;3;0;0;2;1
15761; 24.9 ; 99.4 ; 2.8 ;4;32;171;0;4;2;2;3;1;4;0;0
15762; 15.8 ; 331.8 ; 2.3 ;21;7;41;0;21;17;4;18;3;21;0;0
15763; 23.9 ; 167.5 ; 13.5 ;7;9;68;0;7;3;4;3;4;5;2;0
15764; 81.8 ; 408.8 ; 28.7 ;5;32;140;0;5;3;2;5;0;0;0;5
15765; 30.9 ; 247.0 ; 8.3 ;8;26;55;0;8;3;5;1;7;3;5;0
15766; 24.1 ; 48.2 ; 9.1 ;2;28;90;0;2;1;1;0;2;1;1;0
15767; 47.5 ; 95.0 ; 48.7 ;2;244;20;0;2;1;1;1;1;1;0;1
15768; 19.5 ; 39.0 ; 6.7 ;2;14;40;0;2;1;1;2;0;2;0;0
15769; 23.5 ; 117.3 ; 7.3 ;5;31;206;0;5;5;0;3;2;3;2;0
15770; 59.9 ; 239.7 ; 12.9 ;4;71;147;0;4;0;4;4;0;0;0;4
15771; 41.3 ; 165.2 ; 26.0 ;4;59;113;0;4;2;2;1;3;1;2;1
15772; 47.3 ; 568.0 ; 15.7 ;12;27;45;0;12;8;4;7;5;0;8;4
15773; 75.2 ; 301.0 ; 18.4 ;4;35;291;0;4;3;1;4;0;0;0;4
15774; 30.9 ; 61.7 ; 23.8 ;2;4;254;0;2;1;1;1;1;1;1;0
15775; 57.2 ; 171.7 ; 13.5 ;3;106;20;0;3;3;0;3;0;0;0;3
15776; 45.7 ; 91.5 ; 39.0 ;2;49;258;0;2;0;2;0;2;1;0;1
15777; 47.3 ; 283.6 ; 0.6 ;6;26;22;0;6;0;6;2;4;0;6;0
15778; 29.4 ; 264.2 ; 14.3 ;9;10;203;0;9;2;7;9;0;6;3;0
15779; 46.8 ; 93.5 ; -   ;2;35;143;0;2;1;1;1;1;0;2;0
15780; 42.0 ; 84.0 ; 25.3 ;2;296;10;0;2;0;2;2;0;1;0;1
15781; 27.5 ; 109.9 ; 2.3 ;4;19;351;0;4;2;2;1;3;4;0;0
15782; 59.4 ; 1,069.6 ; 22.6 ;18;24;12;0;18;7;11;6;12;0;0;18
15783; 28.6 ; 57.2 ; 20.4 ;2;32;241;0;2;0;2;2;0;1;1;0
15784; 39.3 ; 78.7 ; 21.4 ;2;57;69;0;2;0;2;2;0;1;0;1
15785; 56.7 ; 113.5 ; 12.0 ;2;62;141;0;2;0;2;2;0;0;0;2
15786; 53.4 ; 106.9 ; 28.5 ;2;75;179;0;2;0;2;2;0;1;0;1
15787; 19.4 ; 58.3 ; 8.1 ;3;9;9;0;3;3;0;3;0;3;0;0
15788; 41.1 ; 780.9 ; 33.8 ;19;21;7;7;12;12;7;11;8;6;7;6
15789; 18.4 ; 55.3 ; 6.3 ;3;31;137;1;2;0;3;1;2;3;0;0
15790; 35.5 ; 284.3 ; 12.9 ;8;41;23;0;8;5;3;2;6;3;5;0
15791; 54.7 ; 218.6 ; 14.5 ;4;63;20;0;4;1;3;3;1;0;3;1
15792; 90.1 ; 270.4 ; 44.2 ;3;22;263;0;3;0;3;2;1;0;0;3
15793; 24.3 ; 146.0 ; 14.3 ;6;23;124;0;6;3;3;3;3;4;2;0
15794; 47.7 ; 238.6 ; 9.0 ;5;59;0;0;5;0;5;5;0;0;3;2
15795; 15.2 ; 212.7 ; 0.8 ;14;21;2;0;14;6;8;4;10;14;0;0
15796; 37.3 ; 186.4 ; 17.9 ;5;63;62;0;5;0;5;2;3;2;1;2
15797; 84.2 ; 168.4 ; 42.0 ;2;5;299;0;2;0;2;2;0;0;0;2
15798; 95.2 ; 190.5 ; 59.3 ;2;121;36;0;2;0;2;2;0;0;0;2
15799; 44.9 ; 134.8 ; 15.3 ;3;4;211;0;3;1;2;1;2;1;1;1
15800; 17.7 ; 124.1 ; 3.2 ;7;38;47;0;7;0;7;4;3;7;0;0
15801; 45.8 ; 275.0 ; 2.2 ;6;25;73;0;6;1;5;4;2;0;6;0
15802; 48.2 ; 96.4 ; -   ;2;14;6;2;0;1;1;2;0;0;2;0
15803; 42.1 ; 505.6 ; 8.6 ;12;23;15;0;12;0;12;9;3;0;12;0
15804; 32.1 ; 996.6 ; 22.0 ;31;10;17;0;31;10;21;23;8;10;21;0
15805; 31.5 ; 157.5 ; 7.7 ;5;69;5;0;5;0;5;2;3;2;3;0
15806; 30.4 ; 182.5 ; 11.2 ;6;38;5;0;6;0;6;6;0;2;4;0
15807; 43.5 ; 217.3 ; 2.5 ;5;17;200;0;5;3;2;2;3;0;5;0
15808; 47.6 ; 142.8 ; 27.4 ;3;22;307;0;3;3;0;2;1;1;1;1
15809; 15.8 ; 79.2 ; 2.0 ;5;14;69;0;5;1;4;1;4;5;0;0
15810; 16.5 ; 82.4 ; 3.9 ;5;32;89;0;5;2;3;0;5;5;0;0
15811; 42.6 ; 213.1 ; 15.7 ;5;50;89;0;5;2;3;0;5;2;1;2
15812; 22.2 ; 44.4 ; 10.8 ;2;18;194;0;2;0;2;1;1;1;1;0
15813; 66.6 ; 266.4 ; 17.6 ;4;69;105;0;4;0;4;4;0;0;0;4
15814; 35.7 ; 1,106.2 ; 4.2 ;31;10;115;0;31;0;31;31;0;0;31;0
15815; 29.7 ; 296.7 ; 13.5 ;10;20;16;0;10;4;6;3;7;7;3;0
15816; 27.0 ; 81.0 ; 13.8 ;3;115;221;0;3;2;1;2;1;2;1;0
15817; 36.8 ; 221.0 ; 14.8 ;6;33;10;0;6;1;5;1;5;2;4;0
15818; 27.6 ; 331.2 ; 10.8 ;12;16;11;0;12;5;7;8;4;8;4;0
15819; 72.6 ; 435.6 ; 34.1 ;6;27;6;0;6;0;6;4;2;0;0;6
15820; 46.9 ; 93.9 ; 6.1 ;2;32;116;0;2;0;2;2;0;0;2;0
15821; 65.3 ; 130.5 ; 5.6 ;2;70;141;0;2;0;2;2;0;0;0;2
15822; 24.2 ; 218.2 ; 17.5 ;9;43;20;0;9;2;7;6;3;6;3;0
15823; 49.5 ; 198.2 ; 21.4 ;4;65;23;4;0;3;1;1;3;1;2;1
15824; 47.5 ; 94.9 ; 1.1 ;2;123;8;1;1;2;0;0;2;0;2;0
15825; 29.1 ; 174.4 ; 8.4 ;6;48;23;0;6;3;3;5;1;4;2;0
15826; 32.3 ; 96.9 ; 13.3 ;3;142;126;0;3;0;3;2;1;1;2;0
15827; 19.8 ; 39.7 ; 1.9 ;2;69;18;2;0;2;0;0;2;2;0;0
15828; 26.3 ; 131.6 ; 13.9 ;5;13;305;0;5;2;3;3;2;3;2;0
15829; 22.5 ; 44.9 ; 11.2 ;2;71;292;0;2;1;1;1;1;1;1;0
15830; 37.5 ; 187.3 ; 13.3 ;5;41;104;0;5;0;5;5;0;2;3;0
15831; 26.1 ; 338.9 ; 23.8 ;13;14;2;0;13;10;3;2;11;9;4;0
15832; 48.8 ; 97.5 ; 0.9 ;2;13;25;2;0;2;0;0;2;0;2;0
15833; 16.3 ; 195.7 ; 3.1 ;12;15;5;12;0;0;12;5;7;12;0;0
15834; 53.9 ; 107.8 ; 2.1 ;2;50;225;0;2;0;2;2;0;0;1;1
15835; 38.9 ; 194.3 ; 13.4 ;5;45;146;0;5;0;5;5;0;2;3;0
15836; 27.9 ; 390.3 ; 13.4 ;14;23;1;0;14;5;9;9;5;9;5;0
15837; 52.2 ; 104.4 ; 37.2 ;2;2;124;0;2;1;1;0;2;1;0;1
15838; 39.8 ; 119.3 ; 12.2 ;3;90;152;0;3;0;3;3;0;1;2;0
15839; 31.1 ; 62.2 ; 15.5 ;2;8;263;0;2;1;1;2;0;1;1;0
15840; 44.3 ; 398.9 ; 24.2 ;9;32;2;0;9;0;9;4;5;3;3;3
15841; 94.6 ; 945.7 ; 38.4 ;10;22;108;0;10;3;7;5;5;0;0;10
15842; 25.3 ; 101.4 ; 0.6 ;4;31;315;0;4;1;3;1;3;4;0;0
15843; 44.2 ; 221.2 ; 5.9 ;5;15;201;0;5;4;1;5;0;0;5;0
15844; 19.2 ; 57.7 ; 7.8 ;3;22;43;0;3;1;2;2;1;3;0;0
15845; 73.8 ; 1,033.4 ; 36.7 ;14;16;73;0;14;0;14;12;2;0;0;14
15846; 33.5 ; 535.3 ; 10.7 ;16;19;16;0;16;2;14;8;8;5;11;0
15847; 17.9 ; 125.2 ; 2.6 ;7;36;52;0;7;0;7;3;4;7;0;0
15848; 46.0 ; 368.2 ; 14.7 ;8;14;6;1;7;0;8;5;3;0;5;3
15849; 18.0 ; 89.9 ; 7.8 ;5;54;36;0;5;1;4;3;2;5;0;0
15850; 34.0 ; 67.9 ; 13.3 ;2;185;74;0;2;1;1;2;0;1;1;0
15851; 94.6 ; 189.2 ; 31.2 ;2;41;80;0;2;1;1;0;2;0;0;2
15852; 42.0 ; 377.6 ; 19.8 ;9;34;8;0;9;2;7;2;7;3;3;3
15853; 37.0 ; 74.0 ; 23.8 ;2;13;188;0;2;0;2;2;0;1;0;1
15854; 31.8 ; 63.7 ; 18.8 ;2;167;80;1;1;1;1;2;0;1;1;0
15855; 15.9 ; 79.4 ; 1.4 ;5;5;23;0;5;4;1;3;2;5;0;0
15856; 17.5 ; 490.5 ; 4.4 ;28;11;8;0;28;9;19;7;21;28;0;0
15857; 34.1 ; 170.3 ; 18.5 ;5;32;186;0;5;2;3;2;3;2;3;0
15858; 21.8 ; 65.3 ; 7.9 ;3;2;242;0;3;2;1;1;2;3;0;0
15859; 24.3 ; 462.5 ; 13.7 ;19;15;29;0;19;9;10;10;9;13;6;0
15860; 16.7 ; 233.2 ; 4.8 ;14;6;46;0;14;6;8;6;8;14;0;0
15861; 48.7 ; 243.5 ; 17.9 ;5;54;99;0;5;2;3;4;1;0;3;2
15862; 21.2 ; 127.4 ; 13.4 ;6;49;19;0;6;4;2;1;5;4;2;0
15863; 30.7 ; 122.8 ; 14.1 ;4;37;44;0;4;2;2;4;0;1;3;0
15864; 58.6 ; 175.9 ; 6.4 ;3;63;32;0;3;0;3;1;2;0;0;3
15865; 213.1 ; 639.3 ; 189.0 ;3;1;298;0;3;1;2;0;3;1;0;2
15866; 42.9 ; 85.7 ; -   ;2;19;109;0;2;1;1;2;0;0;2;0
15867; 29.5 ; 265.9 ; 11.6 ;9;35;8;0;9;5;4;4;5;6;3;0
15868; 52.9 ; 105.8 ; 0.5 ;2;88;99;0;2;0;2;2;0;0;2;0
15869; 26.8 ; 160.7 ; 12.3 ;6;23;89;3;3;1;5;5;1;4;2;0
15870; 42.5 ; 170.1 ; 21.5 ;4;17;73;0;4;2;2;1;3;1;2;1
15871; 48.0 ; 479.7 ; 10.2 ;10;12;152;0;10;8;2;4;6;0;7;3
15872; 42.6 ; 85.3 ; 9.1 ;2;6;199;0;2;0;2;1;1;0;2;0
15873; 34.4 ; 309.7 ; 20.8 ;9;22;32;0;9;2;7;4;5;3;3;3
15874; 38.4 ; 153.5 ; 17.2 ;4;110;4;0;4;3;1;2;2;1;2;1
15875; 58.6 ; 234.5 ; 17.2 ;4;80;167;0;4;0;4;2;2;0;0;4
15876; 42.9 ; 85.7 ; -   ;2;8;258;0;2;1;1;1;1;0;2;0
15877; 17.4 ; 69.5 ; 1.7 ;4;13;10;0;4;1;3;3;1;4;0;0
15878; 25.7 ; 514.8 ; 10.7 ;20;14;15;0;20;0;20;10;10;13;7;0
15879; 38.0 ; 76.1 ; 13.1 ;2;148;154;0;2;1;1;2;0;1;1;0
15880; 53.4 ; 213.7 ; 14.3 ;4;43;77;2;2;2;2;2;2;0;3;1
15881; 29.2 ; 146.2 ; 12.9 ;5;49;25;0;5;2;3;2;3;3;2;0
15882; 36.9 ; 73.8 ; 10.0 ;2;11;43;1;1;0;2;0;2;1;1;0
15883; 28.0 ; 56.0 ; 12.0 ;2;11;145;0;2;2;0;2;0;1;1;0
15884; 17.1 ; 120.0 ; 3.2 ;7;26;41;0;7;5;2;3;4;7;0;0
15885; 69.0 ; 138.0 ; 11.9 ;2;102;99;0;2;0;2;2;0;0;0;2
15886; 42.9 ; 85.9 ; 33.2 ;2;33;259;0;2;2;0;2;0;1;0;1
15887; 76.4 ; 152.7 ; 15.1 ;2;5;193;0;2;2;0;0;2;0;0;2
15888; 20.3 ; 101.5 ; 6.8 ;5;26;62;0;5;0;5;1;4;5;0;0
15889; 27.9 ; 195.3 ; 13.6 ;7;13;136;1;6;0;7;5;2;5;2;0
15890; 26.8 ; 80.3 ; 11.1 ;3;88;63;1;2;1;2;2;1;2;1;0
15891; 28.2 ; 310.6 ; 6.0 ;11;21;69;0;11;3;8;8;3;7;4;0
15892; 23.2 ; 231.7 ; 13.4 ;10;16;15;0;10;0;10;9;1;7;3;0
15893; 68.3 ; 136.6 ; 38.1 ;2;12;141;0;2;0;2;2;0;0;0;2
15894; 26.4 ; 79.2 ; 3.5 ;3;93;114;0;3;2;1;0;3;3;0;0
15895; 35.6 ; 71.2 ; 30.8 ;2;41;128;0;2;1;1;1;1;1;0;1
15896; 32.5 ; 715.1 ; 19.1 ;22;17;11;0;22;9;13;10;12;7;15;0
15897; 77.4 ; 387.0 ; 37.5 ;5;29;92;0;5;3;2;2;3;0;0;5
15898; 66.3 ; 331.7 ; 17.5 ;5;12;211;0;5;2;3;1;4;0;0;5
15899; 32.9 ; 98.8 ; 14.4 ;3;74;149;0;3;1;2;1;2;1;2;0
15900; 53.4 ; 1,335.8 ; 19.2 ;25;14;38;0;25;17;8;13;12;0;17;8
15901; 15.0 ; 45.0 ; -   ;3;104;65;0;3;3;0;3;0;3;0;0
15902; 15.0 ; 104.9 ; -   ;7;18;132;0;7;4;3;3;4;7;0;0
15903; 24.9 ; 49.7 ; 7.7 ;2;32;15;0;2;0;2;2;0;1;1;0
15904; 30.4 ; 121.8 ; 19.5 ;4;59;142;0;4;1;3;2;2;1;3;0
15905; 24.9 ; 49.9 ; 7.9 ;2;7;107;0;2;2;0;1;1;1;1;0
15906; 17.9 ; 142.9 ; 4.4 ;8;16;11;0;8;1;7;7;1;8;0;0
15907; 34.5 ; 344.5 ; 20.0 ;10;43;4;0;10;3;7;3;7;3;7;0
15908; 25.1 ; 50.1 ; -   ;2;14;58;0;2;1;1;2;0;2;0;0
15909; 33.5 ; 234.3 ; 18.7 ;7;44;2;0;7;4;3;1;6;2;5;0
15910; 52.6 ; 1,579.5 ; 20.8 ;30;10;5;0;30;5;25;13;17;0;20;10
15911; 36.8 ; 184.2 ; 18.0 ;5;45;10;0;5;0;5;4;1;2;3;0
15912; 32.5 ; 162.5 ; 6.5 ;5;51;218;0;5;3;2;2;3;2;3;0
15913; 20.3 ; 263.9 ; 5.1 ;13;16;3;0;13;6;7;12;1;13;0;0
15914; 49.4 ; 98.8 ; 2.4 ;2;104;91;0;2;1;1;1;1;0;2;0
15915; 30.2 ; 60.4 ; -   ;2;28;350;0;2;1;1;2;0;0;2;0
15916; 48.9 ; 244.5 ; 6.3 ;5;29;92;0;5;1;4;4;1;0;3;2
15917; 42.7 ; 85.4 ; 12.4 ;2;113;170;0;2;1;1;2;0;0;1;1
15918; 39.7 ; 596.1 ; 11.2 ;15;22;55;0;15;7;8;5;10;5;10;0
15919; 46.7 ; 93.4 ; 2.3 ;2;185;24;0;2;1;1;2;0;0;2;0
15920; 38.5 ; 76.9 ; 12.4 ;2;13;104;2;0;0;2;2;0;1;1;0
15921; 34.8 ; 69.7 ; 15.2 ;2;116;257;0;2;1;1;2;0;1;1;0
15922; 54.8 ; 383.7 ; 26.4 ;7;26;126;0;7;0;7;5;2;2;3;2
15923; 29.7 ; 59.4 ; 12.8 ;2;70;299;0;2;0;2;1;1;1;1;0
15924; 47.5 ; 94.9 ; -   ;2;44;26;1;1;0;2;1;1;0;2;0
15925; 62.9 ; 125.9 ; 14.5 ;2;5;85;2;0;0;2;2;0;0;0;2
15926; 22.4 ; 111.9 ; 4.1 ;5;23;291;0;5;2;3;2;3;5;0;0
15927; 50.6 ; 101.2 ; 2.9 ;2;18;169;0;2;0;2;0;2;0;2;0
15928; 34.7 ; 69.4 ; 17.6 ;2;218;212;1;1;1;1;2;0;1;1;0
15929; 33.6 ; 67.3 ; 22.5 ;2;155;32;0;2;0;2;2;0;1;0;1
15930; 19.1 ; 190.7 ; 7.4 ;10;23;105;0;10;3;7;5;5;10;0;0
15931; 56.3 ; 506.7 ; 17.3 ;9;35;5;0;9;3;6;7;2;0;0;9
15932; 30.6 ; 152.9 ; 7.6 ;5;51;79;0;5;1;4;4;1;2;3;0
15933; 28.2 ; 84.6 ; 11.0 ;3;39;115;2;1;1;2;2;1;2;1;0
15934; 36.9 ; 73.8 ; 17.7 ;2;8;254;0;2;2;0;0;2;1;1;0
15935; 49.0 ; 245.1 ; 4.4 ;5;19;31;0;5;0;5;4;1;0;5;0
15936; 50.9 ; 203.4 ; 8.7 ;4;50;2;0;4;1;3;3;1;0;3;1
15937; 35.9 ; 322.8 ; 17.9 ;9;29;53;0;9;4;5;6;3;3;6;0
15938; 68.2 ; 136.4 ; 7.5 ;2;32;0;0;2;0;2;0;2;0;0;2
15939; 43.2 ; 86.3 ; 19.4 ;2;122;88;2;0;2;0;2;0;1;0;1
15940; 19.6 ; 98.0 ; 3.3 ;5;32;89;0;5;4;1;2;3;5;0;0
15941; 44.7 ; 268.1 ; 27.8 ;6;65;67;0;6;4;2;4;2;2;2;2
15942; 37.3 ; 74.6 ; 10.6 ;2;11;164;2;0;0;2;1;1;1;1;0
15943; 55.4 ; 443.6 ; 17.5 ;8;50;10;0;8;4;4;6;2;0;0;8
15944; 37.1 ; 185.5 ; 14.9 ;5;48;32;0;5;1;4;3;2;2;3;0
15945; 57.0 ; 171.1 ; 39.1 ;3;103;104;0;3;3;0;3;0;1;0;2
15946; 47.7 ; 1,335.7 ; 16.4 ;28;10;16;0;28;13;15;24;4;0;19;9
15947; 38.8 ; 155.2 ; 17.4 ;4;7;251;0;4;2;2;2;2;1;2;1
15948; 38.4 ; 153.6 ; 10.2 ;4;54;263;0;4;1;3;4;0;1;3;0
15949; 18.3 ; 55.0 ; 6.2 ;3;5;38;0;3;2;1;1;2;3;0;0
15950; 42.0 ; 83.9 ; 7.2 ;2;155;110;0;2;1;1;2;0;0;2;0
15951; 18.3 ; 73.3 ; 2.4 ;4;12;244;0;4;3;1;4;0;4;0;0
15952; 29.7 ; 118.8 ; 3.7 ;4;33;302;0;4;2;2;4;0;3;1;0
15953; 71.0 ; 426.1 ; 60.7 ;6;41;13;1;5;2;4;5;1;2;0;4
15954; 21.5 ; 236.5 ; 13.2 ;11;17;6;0;11;4;7;6;5;7;4;0
15955; 43.3 ; 216.5 ; 33.3 ;5;61;44;0;5;4;1;3;2;2;1;2
15956; 48.3 ; 241.3 ; 4.0 ;5;60;14;0;5;1;4;1;4;0;5;0
15957; 42.0 ; 83.9 ; 2.6 ;2;51;173;0;2;1;1;1;1;0;2;0
15958; 33.6 ; 336.2 ; 12.3 ;10;32;28;0;10;4;6;4;6;3;7;0
15959; 52.5 ; 105.0 ; -   ;2;32;146;0;2;0;2;0;2;0;2;0
15960; 57.3 ; 286.7 ; 58.8 ;5;24;29;0;5;2;3;3;2;2;0;3
15961; 58.0 ; 289.8 ; 29.5 ;5;15;7;0;5;1;4;4;1;2;0;3
15962; 104.7 ; 209.3 ; 85.6 ;2;39;8;0;2;1;1;2;0;1;0;1
15963; 48.1 ; 96.1 ; 1.9 ;2;168;90;0;2;0;2;1;1;0;2;0
15964; 29.5 ; 147.7 ; 10.6 ;5;34;1;0;5;2;3;2;3;3;2;0
15965; 22.7 ; 1,478.5 ; 15.2 ;65;6;1;1;64;19;46;63;2;43;22;0
15966; 53.6 ; 107.2 ; 16.1 ;2;32;110;0;2;0;2;2;0;0;1;1
15967; 42.9 ; 257.4 ; 5.7 ;6;32;10;0;6;0;6;4;2;0;6;0
15968; 32.7 ; 98.1 ; 9.7 ;3;101;148;0;3;0;3;1;2;1;2;0
15969; 39.1 ; 1,290.0 ; 17.9 ;33;11;11;0;33;9;24;10;23;11;11;11
15970; 22.5 ; 44.9 ; 11.2 ;2;5;42;2;0;0;2;2;0;1;1;0
15971; 22.3 ; 289.7 ; 12.0 ;13;20;6;13;0;4;9;9;4;9;4;0
15972; 42.9 ; 128.6 ; 12.8 ;3;5;137;3;0;1;2;1;2;0;2;1
15973; 74.3 ; 371.5 ; 28.2 ;5;42;53;0;5;0;5;5;0;0;0;5
15974; 16.5 ; 66.1 ; 1.7 ;4;37;155;0;4;4;0;4;0;4;0;0
15975; 51.7 ; 1,655.9 ; 23.4 ;32;9;13;0;32;13;19;23;9;11;10;11
15976; 27.6 ; 110.5 ; 3.1 ;4;32;78;0;4;1;3;2;2;3;1;0
15977; 42.2 ; 126.5 ; 19.6 ;3;66;158;0;3;1;2;3;0;1;1;1
15978; 17.3 ; 500.9 ; 6.7 ;29;12;3;0;29;17;12;12;17;29;0;0
15979; 37.9 ; 75.7 ; 12.0 ;2;320;11;1;1;0;2;1;1;1;1;0
15980; 22.3 ; 44.7 ; 5.6 ;2;202;53;0;2;0;2;1;1;2;0;0
15981; 33.8 ; 101.3 ; 13.3 ;3;115;22;0;3;0;3;1;2;1;2;0
15982; 21.7 ; 65.1 ; 6.2 ;3;68;58;0;3;1;2;1;2;3;0;0
15983; 39.3 ; 196.6 ; 23.2 ;5;55;41;0;5;4;1;5;0;2;1;2
15984; 47.7 ; 143.1 ; 0.4 ;3;38;3;0;3;3;0;0;3;0;3;0
15985; 19.4 ; 271.1 ; 9.2 ;14;23;0;0;14;7;7;14;0;14;0;0
15986; 47.1 ; 94.2 ; 0.5 ;2;377;62;0;2;0;2;2;0;0;2;0
15987; 43.3 ; 86.5 ; 18.7 ;2;239;146;0;2;0;2;1;1;1;0;1
15988; 91.7 ; 183.5 ; 18.3 ;2;131;158;0;2;0;2;2;0;0;0;2
15989; 34.8 ; 486.7 ; 10.1 ;14;24;10;0;14;4;10;8;6;5;9;0
15990; 31.5 ; 94.5 ; 11.1 ;3;58;3;0;3;2;1;1;2;1;2;0
15991; 29.5 ; 147.7 ; 17.7 ;5;20;209;0;5;4;1;2;3;3;2;0
15992; 40.8 ; 81.7 ; 23.6 ;2;5;11;0;2;0;2;1;1;1;0;1
15993; 46.2 ; 184.9 ; 13.4 ;4;17;235;0;4;1;3;2;2;0;3;1
15994; 40.7 ; 122.1 ; 21.5 ;3;58;94;0;3;1;2;3;0;1;1;1
15995; 59.5 ; 119.0 ; 3.0 ;2;49;218;0;2;1;1;2;0;0;0;2
15996; 21.3 ; 85.2 ; 6.6 ;4;46;269;0;4;2;2;3;1;4;0;0
15997; 48.9 ; 97.8 ; 3.2 ;2;120;208;0;2;2;0;1;1;0;2;0
15998; 29.3 ; 175.8 ; 17.8 ;6;54;5;0;6;3;3;1;5;4;2;0
15999; 27.2 ; 81.5 ; 5.6 ;3;5;374;0;3;0;3;3;0;2;1;0
16000; 27.6 ; 137.9 ; 11.3 ;5;57;41;0;5;3;2;4;1;3;2;0
16001; 29.3 ; 146.3 ; 15.8 ;5;68;48;2;3;2;3;0;5;3;2;0
16002; 33.2 ; 331.8 ; 10.8 ;10;17;16;0;10;4;6;7;3;3;7;0
16003; 46.5 ; 186.2 ; 6.8 ;4;17;15;0;4;0;4;4;0;0;4;0
16004; 26.5 ; 53.0 ; 2.1 ;2;10;190;0;2;1;1;2;0;2;0;0
16005; 47.5 ; 94.9 ; -   ;2;32;41;1;1;1;1;2;0;0;2;0
16006; 46.8 ; 93.5 ; -   ;2;14;177;0;2;1;1;1;1;0;2;0
16007; 24.0 ; 143.9 ; 12.8 ;6;18;57;0;6;4;2;2;4;4;2;0
16008; 63.8 ; 893.3 ; 21.0 ;14;15;53;0;14;1;13;6;8;0;0;14
16009; 73.2 ; 146.5 ; 14.0 ;2;28;83;1;1;1;1;1;1;0;0;2
16010; 53.7 ; 161.0 ; 6.3 ;3;14;160;2;1;1;2;2;1;0;2;1
16011; 50.8 ; 152.5 ; 3.1 ;3;78;100;0;3;0;3;2;1;0;3;0
16012; 60.0 ; 180.1 ; 20.8 ;3;9;167;0;3;3;0;1;2;0;0;3
16013; 46.5 ; 325.7 ; 17.6 ;7;39;21;0;7;1;6;5;2;2;3;2
16014; 48.6 ; 145.7 ; 21.7 ;3;9;58;0;3;0;3;3;0;1;1;1
16015; 27.4 ; 137.2 ; 10.1 ;5;14;194;0;5;2;3;5;0;3;2;0
16016; 38.5 ; 76.9 ; 12.4 ;2;94;215;0;2;1;1;2;0;1;1;0
16017; 44.7 ; 223.5 ; 14.2 ;5;26;4;5;0;3;2;2;3;0;3;2
16018; 41.6 ; 457.6 ; 33.4 ;11;28;8;0;11;8;3;2;9;4;3;4
16019; 15.0 ; 59.9 ; -   ;4;31;14;4;0;4;0;3;1;4;0;0
16020; 47.2 ; 330.2 ; 24.0 ;7;41;53;0;7;3;4;3;4;2;3;2
16021; 38.1 ; 381.0 ; 24.9 ;10;23;204;0;10;1;9;2;8;3;4;3
16022; 62.1 ; 496.6 ; 34.4 ;8;46;38;0;8;5;3;2;6;3;0;5
16023; 23.2 ; 393.9 ; 13.1 ;17;26;0;0;17;5;12;9;8;11;6;0
16024; 49.0 ; 147.0 ; 53.4 ;3;144;67;0;3;2;1;2;1;1;1;1
16025; 27.2 ; 136.2 ; 3.0 ;5;103;21;0;5;1;4;1;4;3;2;0
16026; 49.4 ; 98.8 ; 5.0 ;2;85;157;0;2;1;1;1;1;0;2;0
16027; 38.8 ; 582.5 ; 18.0 ;15;15;6;0;15;11;4;15;0;5;5;5
16028; 31.9 ; 95.7 ; 2.4 ;3;61;52;0;3;1;2;2;1;1;2;0
16029; 146.0 ; 876.0 ; 46.6 ;6;55;5;0;6;1;5;3;3;0;0;6
16030; 29.4 ; 235.3 ; 18.3 ;8;52;41;0;8;7;1;4;4;5;3;0
16031; 65.9 ; 131.9 ; 11.6 ;2;245;68;0;2;0;2;2;0;0;0;2
16032; 31.8 ; 636.7 ; 11.6 ;20;11;5;0;20;0;20;19;1;7;13;0
16033; 27.8 ; 639.3 ; 14.1 ;23;14;0;0;23;13;10;13;10;15;8;0
16034; 60.6 ; 121.2 ; 19.7 ;2;2;102;2;0;2;0;1;1;0;0;2
16035; 19.0 ; 190.0 ; 6.1 ;10;5;17;7;3;8;2;10;0;10;0;0
16036; 19.9 ; 298.7 ; 5.0 ;15;14;1;0;15;3;12;11;4;15;0;0
16037; 28.1 ; 56.1 ; 13.1 ;2;23;133;0;2;1;1;2;0;1;1;0
16038; 104.6 ; 209.1 ; 31.8 ;2;24;173;0;2;0;2;2;0;0;0;2
16039; 63.6 ; 1,272.3 ; 21.8 ;20;19;15;0;20;1;19;18;2;0;0;20
16040; 24.0 ; 335.5 ; 14.1 ;14;28;5;0;14;5;9;10;4;9;5;0
16041; 50.2 ; 250.8 ; 4.4 ;5;19;206;0;5;2;3;2;3;0;5;0
16042; 61.6 ; 184.8 ; 2.5 ;3;54;5;0;3;0;3;2;1;0;0;3
16043; 31.5 ; 94.5 ; 30.3 ;3;13;105;0;3;0;3;2;1;1;1;1
16044; 41.1 ; 82.2 ; 9.5 ;2;18;84;2;0;0;2;1;1;0;2;0
16045; 63.1 ; 126.1 ; 21.5 ;2;14;124;0;2;2;0;0;2;0;0;2
16046; 20.2 ; 101.2 ; 6.4 ;5;35;25;2;3;2;3;3;2;5;0;0
16047; 25.5 ; 127.4 ; 5.7 ;5;10;116;0;5;2;3;3;2;3;2;0
16048; 37.3 ; 149.3 ; 17.0 ;4;14;53;4;0;2;2;3;1;1;3;0
16049; 26.9 ; 161.5 ; 16.7 ;6;13;130;0;6;4;2;6;0;4;2;0
16050; 36.3 ; 217.6 ; 8.9 ;6;36;83;3;3;2;4;3;3;2;4;0
16051; 61.2 ; 122.5 ; 18.8 ;2;295;41;0;2;0;2;2;0;0;0;2
16052; 32.3 ; 64.7 ; 10.9 ;2;38;110;0;2;0;2;1;1;1;1;0
16053; 51.9 ; 363.1 ; 16.7 ;7;40;101;0;7;0;7;2;5;0;5;2
16054; 111.8 ; 559.0 ; 22.3 ;5;68;53;0;5;2;3;1;4;0;0;5
16055; 55.7 ; 167.1 ; 6.5 ;3;68;176;0;3;3;0;1;2;0;0;3
16056; 38.4 ; 192.2 ; 20.9 ;5;64;53;0;5;2;3;4;1;2;1;2
16057; 39.1 ; 195.5 ; 20.7 ;5;67;115;0;5;2;3;4;1;2;1;2
16058; 39.8 ; 198.8 ; 10.8 ;5;44;76;0;5;3;2;1;4;2;3;0
16059; 67.4 ; 202.2 ; 7.6 ;3;68;160;0;3;2;1;3;0;0;0;3
16060; 49.8 ; 1,345.6 ; 8.9 ;27;13;2;0;27;9;18;16;11;0;18;9
16061; 58.4 ; 292.1 ; 32.1 ;5;70;5;0;5;0;5;3;2;2;0;3
16062; 29.4 ; 58.8 ; 4.9 ;2;60;221;0;2;1;1;1;1;1;1;0
16063; 39.6 ; 633.4 ; 10.6 ;16;28;2;0;16;11;5;14;2;5;11;0
16064; 24.3 ; 97.2 ; 4.5 ;4;112;110;0;4;2;2;2;2;4;0;0
16065; 16.5 ; 32.9 ; 0.2 ;2;10;176;0;2;1;1;2;0;2;0;0
16066; 67.3 ; 605.7 ; 6.5 ;9;41;5;0;9;0;9;1;8;0;0;9
16067; 49.0 ; 147.0 ; 13.3 ;3;13;34;0;3;2;1;2;1;0;2;1
16068; 52.2 ; 209.0 ; 8.9 ;4;59;116;0;4;1;3;3;1;0;3;1
16069; 69.1 ; 345.4 ; 22.1 ;5;16;142;0;5;0;5;5;0;0;0;5
16070; 46.8 ; 796.1 ; 20.4 ;17;14;5;0;17;3;14;10;7;6;5;6
16071; 55.0 ; 110.0 ; 5.1 ;2;257;95;0;2;0;2;1;1;0;0;2
16072; 84.8 ; 424.0 ; 12.6 ;5;38;20;0;5;0;5;5;0;0;0;5
16073; 40.6 ; 649.8 ; 5.9 ;16;19;5;0;16;5;11;9;7;0;16;0
16074; 27.7 ; 110.8 ; 16.2 ;4;3;242;0;4;2;2;2;2;3;1;0
16075; 36.9 ; 73.8 ; 10.0 ;2;116;97;0;2;1;1;0;2;1;1;0
16076; 22.7 ; 136.3 ; 14.4 ;6;52;2;2;4;4;2;5;1;4;2;0
16077; 45.3 ; 226.4 ; 5.9 ;5;103;3;0;5;1;4;2;3;0;5;0
16078; 25.0 ; 74.9 ; 9.2 ;3;142;93;0;3;1;2;1;2;2;1;0
16079; 39.2 ; 78.4 ; 13.5 ;2;24;10;2;0;0;2;2;0;1;1;0
16080; 44.3 ; 620.0 ; 13.1 ;14;18;47;0;14;2;12;11;3;0;9;5
16081; 26.3 ; 131.4 ; 7.2 ;5;15;60;0;5;4;1;3;2;3;2;0
16082; 55.4 ; 609.5 ; 7.1 ;11;33;116;0;11;1;10;10;1;0;0;11
16083; 74.7 ; 224.0 ; 40.6 ;3;20;233;0;3;1;2;3;0;0;0;3
16084; 21.5 ; 43.1 ; 5.3 ;2;18;72;0;2;2;0;0;2;2;0;0
16085; 19.6 ; 98.0 ; 9.2 ;5;29;118;0;5;4;1;1;4;5;0;0
16086; 50.1 ; 100.1 ; -   ;2;4;20;2;0;1;1;2;0;0;2;0
16087; 35.1 ; 70.2 ; 8.6 ;2;8;92;0;2;1;1;0;2;1;1;0
16088; 29.4 ; 88.2 ; 13.2 ;3;51;29;0;3;1;2;1;2;2;1;0
16089; 47.4 ; 142.1 ; 1.1 ;3;120;146;0;3;0;3;2;1;0;3;0
16090; 97.5 ; 390.2 ; 66.9 ;4;17;246;0;4;0;4;2;2;0;0;4
16091; 32.1 ; 320.9 ; 10.6 ;10;17;55;0;10;7;3;5;5;3;7;0
16092; 38.7 ; 193.5 ; 14.2 ;5;14;332;0;5;2;3;3;2;2;3;0
16093; 18.8 ; 75.1 ; 8.0 ;4;91;25;0;4;2;2;3;1;4;0;0
16094; 27.4 ; 136.9 ; 12.4 ;5;13;226;0;5;1;4;3;2;3;2;0
16095; 38.4 ; 76.9 ; 19.6 ;2;1;283;0;2;0;2;1;1;1;0;1
16096; 46.0 ; 322.3 ; 19.6 ;7;49;26;0;7;2;5;4;3;2;3;2
16097; 15.0 ; 74.9 ; -   ;5;32;3;0;5;3;2;3;2;5;0;0
16098; 41.7 ; 375.5 ; 20.9 ;9;36;58;0;9;1;8;5;4;3;3;3
16099; 48.8 ; 97.7 ; 50.7 ;2;34;131;0;2;1;1;2;0;1;0;1
16100; 35.0 ; 175.0 ; 28.1 ;5;55;26;0;5;2;3;4;1;2;1;2
16101; 18.0 ; 53.9 ; 2.7 ;3;7;336;0;3;0;3;3;0;3;0;0
16102; 22.8 ; 45.5 ; 3.4 ;2;4;272;0;2;1;1;2;0;2;0;0
16103; 50.6 ; 151.8 ; 3.5 ;3;15;120;0;3;0;3;3;0;0;3;0
16104; 68.6 ; 137.2 ; -   ;2;9;133;2;0;2;0;2;0;0;0;2
16105; 34.7 ; 104.1 ; 19.9 ;3;38;74;0;3;1;2;3;0;1;2;0
16106; 27.0 ; 1,108.6 ; 12.3 ;41;6;5;0;41;27;14;23;18;27;14;0
16107; 30.9 ; 61.7 ; 23.8 ;2;242;37;0;2;1;1;1;1;1;1;0
16108; 45.8 ; 183.1 ; 8.9 ;4;63;101;0;4;1;3;1;3;0;4;0
16109; 31.8 ; 159.2 ; 13.3 ;5;24;26;0;5;0;5;3;2;2;3;0
16110; 48.0 ; 336.1 ; 1.3 ;7;63;22;0;7;3;4;2;5;0;7;0
16111; 44.4 ; 133.2 ; 18.2 ;3;13;356;0;3;0;3;3;0;1;1;1
16112; 50.7 ; 304.1 ; 42.8 ;6;26;36;0;6;0;6;3;3;2;2;2
16113; 57.7 ; 173.2 ; 10.1 ;3;11;250;0;3;2;1;1;2;0;0;3
16114; 52.9 ; 211.7 ; 23.7 ;4;33;273;0;4;2;2;2;2;1;2;1
16115; 30.0 ; 59.9 ; 22.4 ;2;23;70;2;0;1;1;0;2;1;1;0
16116; 25.1 ; 125.3 ; -   ;5;41;101;0;5;1;4;2;3;5;0;0
16117; 44.8 ; 89.5 ; 3.8 ;2;119;320;0;2;0;2;2;0;0;2;0
16118; 29.7 ; 831.3 ; 13.8 ;28;9;5;0;28;4;24;14;14;19;9;0
16119; 54.9 ; 274.7 ; 28.6 ;5;85;101;0;5;4;1;2;3;2;1;2
16120; 85.9 ; 686.9 ; 45.6 ;8;25;26;0;8;0;8;7;1;0;0;8
16121; 45.2 ; 1,266.6 ; 11.8 ;28;13;3;0;28;3;25;28;0;0;19;9
16122; 17.7 ; 124.0 ; 5.2 ;7;35;97;0;7;0;7;1;6;7;0;0
16123; 44.7 ; 134.2 ; 26.2 ;3;110;78;2;1;0;3;2;1;1;1;1
16124; 30.0 ; 149.8 ; 10.3 ;5;71;20;2;3;3;2;3;2;3;2;0
16125; 49.2 ; 98.4 ; 28.5 ;2;233;78;0;2;0;2;2;0;1;0;1
16126; 48.2 ; 96.3 ; 2.1 ;2;39;198;0;2;1;1;1;1;0;2;0
16127; 24.6 ; 122.9 ; 7.9 ;5;20;1;0;5;1;4;2;3;3;2;0
16128; 18.1 ; 108.6 ; 6.2 ;6;24;140;0;6;4;2;2;4;6;0;0
16129; 17.3 ; 208.1 ; 4.0 ;12;11;191;0;12;5;7;8;4;12;0;0
16130; 33.5 ; 972.9 ; 7.1 ;29;8;54;0;29;14;15;19;10;10;19;0
16131; 57.2 ; 285.9 ; 17.5 ;5;29;167;0;5;0;5;5;0;0;0;5
16132; 50.7 ; 253.6 ; 14.4 ;5;22;95;0;5;3;2;3;2;0;3;2
16133; 34.4 ; 103.2 ; 7.7 ;3;87;94;0;3;1;2;2;1;1;2;0
16134; 58.2 ; 116.4 ; 18.9 ;2;70;257;0;2;0;2;2;0;0;0;2
16135; 32.1 ; 64.2 ; 6.7 ;2;5;263;0;2;0;2;0;2;1;1;0
16136; 19.6 ; 371.8 ; 15.8 ;19;14;62;1;18;1;18;16;3;13;6;0
16137; 37.4 ; 224.7 ; 13.3 ;6;58;106;0;6;4;2;2;4;2;4;0
16138; 26.5 ; 132.3 ; 12.8 ;5;19;230;0;5;2;3;2;3;3;2;0
16139; 59.9 ; 299.4 ; 18.4 ;5;13;287;0;5;5;0;1;4;0;0;5
16140; 34.1 ; 68.2 ; 28.6 ;2;50;283;0;2;0;2;2;0;1;0;1
16141; 43.1 ; 172.4 ; 8.4 ;4;97;35;0;4;2;2;2;2;0;4;0
16142; 59.3 ; 118.6 ; 18.8 ;2;14;256;0;2;1;1;1;1;0;0;2
16143; 43.0 ; 172.1 ; 4.9 ;4;125;1;0;4;2;2;2;2;0;4;0
16144; 43.6 ; 217.9 ; 19.2 ;5;36;263;0;5;2;3;4;1;2;1;2
16145; 33.2 ; 431.5 ; 12.5 ;13;25;5;0;13;3;10;2;11;4;9;0
16146; 20.8 ; 374.7 ; 7.4 ;18;27;5;0;18;10;8;5;13;18;0;0
16147; 46.8 ; 93.5 ; -   ;2;32;173;0;2;0;2;1;1;0;2;0
16148; 43.4 ; 303.5 ; 27.5 ;7;50;6;0;7;1;6;4;3;2;3;2
16149; 44.4 ; 310.9 ; 8.2 ;7;41;20;0;7;2;5;4;3;0;7;0
16150; 84.3 ; 168.6 ; 28.6 ;2;17;91;0;2;1;1;2;0;0;0;2
16151; 25.3 ; 481.1 ; 10.6 ;19;7;43;0;19;10;9;15;4;13;6;0
16152; 64.0 ; 320.1 ; 20.6 ;5;45;79;0;5;0;5;4;1;0;0;5
16153; 62.8 ; 502.6 ; 23.0 ;8;31;68;0;8;0;8;7;1;0;0;8
16154; 37.3 ; 149.3 ; 7.9 ;4;8;245;0;4;4;0;1;3;1;3;0
16155; 34.5 ; 137.9 ; 20.6 ;4;53;26;0;4;1;3;2;2;1;2;1
16156; 30.9 ; 61.7 ; 23.8 ;2;257;64;0;2;0;2;2;0;1;1;0
16157; 63.9 ; 319.6 ; 30.2 ;5;58;99;0;5;0;5;3;2;0;0;5
16158; 42.4 ; 84.8 ; 6.5 ;2;1;269;0;2;2;0;1;1;0;2;0
16159; 46.8 ; 93.5 ; -   ;2;4;322;0;2;1;1;1;1;0;2;0
16160; 133.7 ; 267.4 ; 58.0 ;2;168;41;1;1;1;1;1;1;0;0;2
16161; 36.3 ; 145.2 ; 22.9 ;4;5;153;0;4;3;1;4;0;1;2;1
16162; 78.2 ; 703.6 ; 37.2 ;9;38;38;0;9;4;5;3;6;0;0;9
16163; 70.4 ; 211.3 ; 54.1 ;3;7;256;0;3;2;1;3;0;1;0;2
16164; 65.3 ; 848.8 ; 18.9 ;13;29;31;0;13;0;13;11;2;0;0;13
16165; 21.2 ; 126.9 ; 11.2 ;6;23;47;0;6;0;6;5;1;4;2;0
16166; 52.0 ; 156.0 ; 8.9 ;3;68;68;0;3;0;3;3;0;0;2;1
16167; 27.3 ; 136.4 ; 8.9 ;5;4;65;5;0;4;1;5;0;3;2;0
16168; 48.9 ; 195.7 ; 7.6 ;4;66;204;0;4;0;4;4;0;0;3;1
16169; 24.5 ; 73.4 ; 6.2 ;3;9;73;0;3;0;3;1;2;2;1;0
16170; 51.3 ; 102.6 ; 39.3 ;2;12;257;0;2;0;2;2;0;1;0;1
16171; 25.8 ; 77.5 ; 15.8 ;3;91;215;0;3;0;3;1;2;2;1;0
16172; 60.0 ; 239.9 ; 9.5 ;4;54;47;3;1;0;4;4;0;0;0;4
16173; 34.7 ; 104.1 ; 17.7 ;3;49;23;0;3;1;2;0;3;1;2;0
16174; 78.3 ; 156.6 ; 43.0 ;2;1;272;0;2;1;1;0;2;0;0;2
16175; 48.0 ; 239.9 ; 12.7 ;5;21;240;0;5;2;3;5;0;0;3;2
16176; 17.4 ; 69.5 ; 1.1 ;4;13;233;0;4;4;0;4;0;4;0;0
16177; 58.9 ; 117.7 ; 15.3 ;2;29;222;0;2;1;1;0;2;0;0;2
16178; 15.1 ; 90.6 ; 0.3 ;6;59;66;0;6;4;2;1;5;6;0;0
16179; 19.2 ; 38.5 ; -   ;2;113;65;0;2;2;0;1;1;2;0;0
16180; 21.6 ; 474.6 ; 11.7 ;22;10;8;0;22;17;5;19;3;15;7;0
16181; 51.8 ; 207.0 ; 4.4 ;4;71;110;0;4;0;4;4;0;0;3;1
16182; 28.1 ; 140.3 ; 9.7 ;5;5;148;0;5;1;4;1;4;3;2;0
16183; 42.6 ; 85.2 ; 9.0 ;2;13;267;0;2;0;2;2;0;0;2;0
16184; 48.8 ; 146.4 ; 2.3 ;3;50;183;0;3;1;2;1;2;0;3;0
16185; 58.5 ; 175.5 ; 5.5 ;3;15;243;0;3;2;1;1;2;0;0;3
16186; 39.3 ; 353.4 ; 9.6 ;9;31;15;0;9;1;8;6;3;3;6;0
16187; 41.6 ; 124.8 ; 9.2 ;3;86;7;0;3;1;2;0;3;0;3;0
16188; 47.9 ; 95.8 ; 1.2 ;2;50;105;0;2;0;2;0;2;0;2;0
16189; 41.4 ; 124.3 ; 5.4 ;3;61;109;0;3;1;2;1;2;0;3;0
16190; 32.2 ; 96.5 ; 4.1 ;3;46;56;0;3;2;1;1;2;1;2;0
16191; 106.7 ; 213.4 ; 95.6 ;2;55;157;0;2;1;1;2;0;1;0;1
16192; 60.7 ; 303.4 ; 25.9 ;5;38;68;0;5;0;5;2;3;0;0;5
16193; 35.9 ; 71.8 ; 16.2 ;2;93;108;0;2;2;0;1;1;1;1;0
16194; 60.0 ; 119.9 ; 19.8 ;2;320;89;0;2;0;2;2;0;0;0;2
16195; 55.5 ; 665.9 ; 17.0 ;12;27;5;0;12;2;10;4;8;0;0;12
16196; 42.4 ; 211.8 ; 25.1 ;5;79;10;0;5;2;3;3;2;2;1;2
16197; 49.5 ; 198.2 ; 10.8 ;4;82;32;0;4;2;2;1;3;0;3;1
16198; 47.5 ; 94.9 ; -   ;2;7;36;0;2;0;2;1;1;0;2;0
16199; 50.7 ; 761.0 ; 20.5 ;15;16;5;0;15;3;12;10;5;0;10;5
16200; 27.4 ; 192.1 ; 7.2 ;7;6;2;0;7;2;5;7;0;5;2;0
16201; 30.9 ; 278.5 ; 11.6 ;9;23;88;0;9;5;4;7;2;3;6;0
16202; 33.3 ; 866.8 ; 16.6 ;26;16;37;0;26;1;25;21;5;9;17;0
16203; 83.7 ; 167.4 ; 41.3 ;2;196;116;0;2;0;2;2;0;0;0;2
16204; 26.5 ; 238.1 ; 12.4 ;9;20;110;0;9;2;7;4;5;6;3;0
16205; 33.5 ; 301.9 ; 11.9 ;9;6;121;0;9;3;6;2;7;3;6;0
16206; 38.1 ; 152.3 ; 21.2 ;4;86;174;0;4;0;4;3;1;1;2;1
16207; 52.5 ; 105.0 ; 6.5 ;2;95;22;2;0;1;1;1;1;0;1;1
16208; 35.6 ; 71.1 ; 8.0 ;2;32;234;0;2;2;0;1;1;1;1;0
16209; 54.4 ; 598.7 ; 12.4 ;11;16;0;0;11;3;8;9;2;0;7;4
16210; 39.4 ; 78.8 ; 13.8 ;2;78;200;1;1;1;1;0;2;1;1;0
16211; 52.3 ; 209.2 ; 11.2 ;4;23;94;0;4;1;3;3;1;0;3;1
16212; 30.6 ; 183.7 ; 18.7 ;6;9;47;0;6;0;6;1;5;2;4;0
16213; 24.8 ; 173.8 ; 4.7 ;7;40;26;0;7;0;7;5;2;7;0;0
16214; 18.6 ; 576.8 ; 6.3 ;31;14;5;0;31;12;19;15;16;31;0;0
16215; 24.6 ; 123.0 ; 8.7 ;5;46;106;0;5;4;1;1;4;3;2;0
16216; 89.2 ; 267.5 ; 72.7 ;3;4;243;0;3;3;0;2;1;1;0;2
16217; 60.3 ; 361.9 ; 25.7 ;6;51;16;0;6;5;1;4;2;0;0;6
16218; 78.4 ; 156.9 ; 39.2 ;2;11;263;0;2;0;2;1;1;0;0;2
16219; 43.7 ; 218.6 ; 8.0 ;5;98;53;0;5;1;4;3;2;0;5;0
16220; 43.9 ; 438.8 ; 10.8 ;10;29;22;0;10;4;6;5;5;0;10;0
16221; 25.1 ; 50.1 ; -   ;2;23;252;0;2;0;2;1;1;2;0;0
16222; 31.4 ; 94.1 ; 16.3 ;3;95;61;0;3;1;2;1;2;1;2;0
16223; 38.1 ; 152.2 ; 12.3 ;4;19;247;0;4;2;2;4;0;1;3;0
16224; 20.9 ; 41.8 ; 8.8 ;2;64;136;0;2;0;2;2;0;2;0;0
16225; 44.5 ; 133.5 ; 14.7 ;3;70;146;0;3;0;3;1;2;1;1;1
16226; 46.4 ; 92.8 ; 22.9 ;2;83;299;0;2;1;1;0;2;1;0;1
16227; 17.6 ; 52.9 ; 2.5 ;3;31;22;0;3;0;3;1;2;3;0;0
16228; 54.4 ; 163.1 ; 12.0 ;3;12;16;0;3;0;3;2;1;0;2;1
16229; 20.0 ; 40.1 ; 7.6 ;2;270;37;0;2;0;2;1;1;2;0;0
16230; 30.3 ; 91.0 ; 6.2 ;3;7;248;0;3;2;1;2;1;1;2;0
16231; 39.1 ; 273.8 ; 21.4 ;7;27;156;0;7;2;5;2;5;2;3;2
16232; 44.2 ; 309.2 ; 9.1 ;7;40;25;0;7;4;3;6;1;0;7;0
16233; 46.6 ; 559.7 ; 7.2 ;12;36;36;0;12;0;12;8;4;0;12;0
16234; 109.0 ; 1,090.5 ; 67.0 ;10;46;5;0;10;7;3;3;7;0;0;10
16235; 18.3 ; 55.0 ; 6.2 ;3;76;115;0;3;0;3;3;0;3;0;0
16236; 43.1 ; 172.6 ; 24.6 ;4;41;158;0;4;1;3;1;3;1;2;1
16237; 67.5 ; 405.0 ; 42.2 ;6;47;2;3;3;2;4;4;2;2;0;4
16238; 36.3 ; 72.7 ; 0.8 ;2;12;83;0;2;0;2;0;2;0;2;0
16239; 17.5 ; 34.9 ; 3.7 ;2;3;328;0;2;1;1;1;1;2;0;0
16240; 17.5 ; 279.3 ; 6.7 ;16;12;5;0;16;7;9;9;7;16;0;0
16241; 41.3 ; 165.2 ; 15.2 ;4;69;14;4;0;4;0;1;3;1;2;1
16242; 45.9 ; 137.7 ; 5.8 ;3;43;80;3;0;1;2;2;1;0;3;0
16243; 54.1 ; 162.3 ; 33.4 ;3;95;136;0;3;1;2;2;1;1;1;1
16244; 30.3 ; 60.5 ; 8.3 ;2;77;36;0;2;0;2;2;0;1;1;0
16245; 30.0 ; 59.9 ; -   ;2;7;209;2;0;1;1;0;2;2;0;0
16246; 31.1 ; 186.9 ; 28.5 ;6;52;23;0;6;3;3;5;1;2;2;2
16247; 44.8 ; 537.2 ; 20.7 ;12;14;154;0;12;7;5;2;10;4;4;4
16248; 71.8 ; 143.6 ; -   ;2;43;188;0;2;0;2;2;0;0;0;2
16249; 52.3 ; 104.6 ; 8.3 ;2;25;267;0;2;0;2;1;1;0;1;1
16250; 32.3 ; 161.5 ; 10.5 ;5;59;22;0;5;0;5;4;1;2;3;0
16251; 32.2 ; 96.6 ; 13.1 ;3;76;272;0;3;0;3;1;2;1;2;0
16252; 40.9 ; 204.3 ; 27.5 ;5;119;21;0;5;1;4;3;2;2;1;2
16253; 29.0 ; 261.2 ; 16.7 ;9;26;121;0;9;3;6;8;1;6;3;0
16254; 37.8 ; 75.6 ; 11.5 ;2;28;8;2;0;1;1;0;2;1;1;0
16255; 61.6 ; 123.1 ; 20.0 ;2;309;6;0;2;0;2;1;1;0;0;2
16256; 17.0 ; 67.9 ; 2.9 ;4;59;131;0;4;1;3;1;3;4;0;0
16257; 140.5 ; 281.1 ; 27.6 ;2;7;215;0;2;0;2;0;2;0;0;2
16258; 40.6 ; 81.1 ; 29.7 ;2;2;302;0;2;1;1;2;0;1;0;1
16259; 43.2 ; 172.8 ; 20.5 ;4;21;90;0;4;2;2;1;3;1;2;1
16260; 52.7 ; 526.7 ; 25.9 ;10;20;80;0;10;4;6;2;8;3;4;3
16261; 31.4 ; 188.4 ; 31.0 ;6;38;54;0;6;2;4;2;4;2;2;2
16262; 32.2 ; 64.4 ; 3.0 ;2;55;47;2;0;1;1;2;0;1;1;0
16263; 81.2 ; 324.8 ; 4.9 ;4;41;3;0;4;3;1;3;1;0;0;4
16264; 25.8 ; 103.2 ; 6.2 ;4;93;47;1;3;1;3;3;1;3;1;0
16265; 20.6 ; 82.4 ; 6.9 ;4;56;167;0;4;1;3;4;0;4;0;0
16266; 47.5 ; 237.4 ; 45.4 ;5;28;8;0;5;2;3;1;4;2;1;2
16267; 17.2 ; 34.4 ; 3.3 ;2;9;98;2;0;2;0;2;0;2;0;0
16268; 28.1 ; 168.4 ; 8.4 ;6;27;7;0;6;3;3;1;5;4;2;0
16269; 23.1 ; 1,546.2 ; 13.7 ;67;5;5;0;67;31;36;27;40;45;22;0
16270; 19.5 ; 58.5 ; 1.7 ;3;27;212;0;3;2;1;2;1;3;0;0
16271; 56.9 ; 227.4 ; 14.3 ;4;90;31;0;4;1;3;3;1;0;0;4
16272; 79.7 ; 159.5 ; 49.4 ;2;124;224;0;2;2;0;1;1;0;0;2
16273; 29.4 ; 235.3 ; 15.3 ;8;30;5;8;0;2;6;4;4;5;3;0
16274; 38.5 ; 115.4 ; 22.7 ;3;97;93;0;3;3;0;2;1;1;1;1
16275; 45.7 ; 548.5 ; 3.8 ;12;21;15;0;12;0;12;8;4;0;12;0
16276; 15.0 ; 74.9 ; -   ;5;19;15;5;0;0;5;4;1;5;0;0
16277; 59.6 ; 119.2 ; 19.3 ;2;9;152;0;2;1;1;2;0;0;0;2
16278; 56.7 ; 170.1 ; 9.2 ;3;79;68;1;2;1;2;1;2;0;0;3
16279; 30.2 ; 120.7 ; -   ;4;12;40;0;4;3;1;4;0;0;4;0
16280; 36.9 ; 73.8 ; 17.7 ;2;12;226;0;2;0;2;2;0;1;1;0
16281; 15.0 ; 30.0 ; -   ;2;131;44;0;2;2;0;2;0;2;0;0
16282; 40.7 ; 244.2 ; 7.4 ;6;29;124;0;6;3;3;4;2;0;6;0
16283; 32.3 ; 64.6 ; 3.2 ;2;36;93;0;2;2;0;2;0;1;1;0
16284; 15.0 ; 30.0 ; -   ;2;12;116;2;0;0;2;2;0;2;0;0
16285; 39.7 ; 158.8 ; 17.5 ;4;30;5;0;4;0;4;2;2;1;2;1
16286; 70.9 ; 354.4 ; 31.4 ;5;27;47;0;5;0;5;4;1;0;0;5
16287; 28.0 ; 644.8 ; 24.4 ;23;12;2;0;23;10;13;15;8;15;8;0
16288; 46.8 ; 93.5 ; -   ;2;78;197;0;2;1;1;2;0;0;2;0
16289; 30.8 ; 61.7 ; 8.6 ;2;19;157;0;2;0;2;2;0;1;1;0
16290; 93.5 ; 187.0 ; -   ;2;7;174;2;0;1;1;0;2;0;0;2
16291; 29.2 ; 175.0 ; 5.7 ;6;31;40;0;6;0;6;6;0;4;2;0
16292; 85.1 ; 425.6 ; 47.3 ;5;124;4;0;5;4;1;3;2;0;0;5
16293; 30.3 ; 91.0 ; 9.6 ;3;126;7;0;3;2;1;1;2;1;2;0
16294; 29.2 ; 409.1 ; 11.3 ;14;19;11;0;14;5;9;13;1;9;5;0
16295; 81.1 ; 243.2 ; 63.5 ;3;8;122;0;3;2;1;1;2;1;0;2
16296; 19.4 ; 952.1 ; 10.7 ;49;5;7;0;49;24;25;35;14;33;16;0
16297; 21.2 ; 63.5 ; 7.7 ;3;5;3;0;3;2;1;3;0;3;0;0
16298; 76.3 ; 457.7 ; 53.1 ;6;41;21;3;3;0;6;5;1;2;0;4
16299; 102.0 ; 612.2 ; 111.4 ;6;38;35;0;6;3;3;3;3;2;0;4
16300; 40.6 ; 81.2 ; 15.6 ;2;159;104;0;2;0;2;1;1;1;0;1
16301; 53.4 ; 266.9 ; 16.9 ;5;42;32;3;2;1;4;4;1;0;3;2
16302; 39.6 ; 79.2 ; 11.2 ;2;64;293;0;2;1;1;0;2;1;1;0
16303; 47.8 ; 95.7 ; 0.5 ;2;33;5;2;0;1;1;1;1;0;2;0
16304; 22.6 ; 45.2 ; 11.4 ;2;12;153;0;2;0;2;1;1;1;1;0
16305; 36.6 ; 109.8 ; -   ;3;13;95;0;3;0;3;2;1;0;3;0
16306; 21.9 ; 109.4 ; 7.9 ;5;31;4;0;5;4;1;4;1;5;0;0
16307; 36.6 ; 109.9 ; 19.9 ;3;44;5;0;3;0;3;1;2;1;1;1
16308; 41.1 ; 288.0 ; 12.7 ;7;44;69;0;7;0;7;3;4;2;5;0
16309; 54.9 ; 164.6 ; 3.0 ;3;86;68;3;0;1;2;3;0;0;2;1
16310; 27.0 ; 108.0 ; 9.6 ;4;32;11;4;0;2;2;3;1;3;1;0
16311; 23.1 ; 46.2 ; 3.0 ;2;19;26;0;2;0;2;2;0;2;0;0
16312; 18.3 ; 55.0 ; 6.2 ;3;2;178;0;3;1;2;0;3;3;0;0
16313; 26.1 ; 313.0 ; 8.1 ;12;10;56;3;9;9;3;8;4;8;4;0
16314; 33.9 ; 101.6 ; 6.8 ;3;7;362;0;3;1;2;1;2;1;2;0
16315; 46.8 ; 140.3 ; -   ;3;6;267;0;3;0;3;2;1;0;3;0
16316; 36.3 ; 72.5 ; 16.8 ;2;76;63;0;2;0;2;0;2;1;1;0
16317; 25.1 ; 75.2 ; -   ;3;26;137;0;3;2;1;0;3;3;0;0
16318; 46.9 ; 93.9 ; 4.6 ;2;13;5;0;2;0;2;1;1;0;2;0
16319; 63.5 ; 571.8 ; 60.1 ;9;21;15;0;9;0;9;9;0;3;0;6
16320; 88.0 ; 176.1 ; 66.8 ;2;257;71;0;2;1;1;1;1;1;0;1
16321; 30.8 ; 61.7 ; 8.6 ;2;17;236;0;2;1;1;1;1;1;1;0
16322; 42.1 ; 168.5 ; 20.0 ;4;42;0;0;4;1;3;1;3;1;2;1
16323; 15.0 ; 30.0 ; -   ;2;75;33;1;1;2;0;2;0;2;0;0
16324; 29.1 ; 174.7 ; 8.9 ;6;36;65;0;6;4;2;0;6;4;2;0
16325; 28.3 ; 226.0 ; 15.5 ;8;21;12;0;8;2;6;8;0;5;3;0
16326; 24.7 ; 49.5 ; 8.1 ;2;33;114;0;2;1;1;1;1;1;1;0
16327; 71.5 ; 286.1 ; 22.8 ;4;86;163;0;4;1;3;1;3;0;0;4
16328; 36.9 ; 73.8 ; 1.7 ;2;62;42;0;2;0;2;1;1;0;2;0
16329; 50.4 ; 100.7 ; 4.3 ;2;27;80;0;2;2;0;0;2;0;2;0
16330; 38.6 ; 77.1 ; 15.0 ;2;173;110;0;2;1;1;1;1;1;1;0
16331; 20.5 ; 368.7 ; 7.4 ;18;12;7;0;18;6;12;11;7;18;0;0
16332; 29.5 ; 58.9 ; 6.8 ;2;10;270;0;2;1;1;0;2;1;1;0
16333; 100.1 ; 400.3 ; 26.4 ;4;101;11;0;4;0;4;3;1;0;0;4
16334; 51.7 ; 155.2 ; 9.1 ;3;120;194;0;3;0;3;2;1;0;2;1
16335; 38.5 ; 76.9 ; 12.4 ;2;7;183;2;0;0;2;2;0;1;1;0
16336; 38.7 ; 232.2 ; 22.7 ;6;68;7;0;6;2;4;4;2;2;2;2
16337; 33.4 ; 66.8 ; 4.8 ;2;1;37;0;2;0;2;0;2;1;1;0
16338; 28.4 ; 56.8 ; 12.6 ;2;163;42;1;1;0;2;1;1;1;1;0
16339; 104.7 ; 523.3 ; 128.5 ;5;4;247;0;5;4;1;5;0;2;0;3
16340; 78.9 ; 1,183.7 ; 41.8 ;15;21;5;0;15;0;15;6;9;0;0;15
16341; 17.5 ; 87.4 ; 6.5 ;5;20;1;0;5;1;4;3;2;5;0;0
16342; 16.2 ; 97.0 ; 1.2 ;6;8;188;0;6;1;5;6;0;6;0;0
16343; 45.2 ; 90.3 ; 2.4 ;2;109;40;0;2;1;1;2;0;0;2;0
16344; 98.6 ; 591.5 ; 6.7 ;6;36;30;0;6;3;3;1;5;0;0;6
16345; 51.4 ; 154.1 ; 21.7 ;3;44;167;0;3;2;1;1;2;1;1;1
16346; 18.7 ; 93.6 ; 4.4 ;5;11;32;0;5;1;4;3;2;5;0;0
16347; 29.5 ; 147.3 ; 2.3 ;5;93;5;0;5;2;3;2;3;3;2;0
16348; 25.9 ; 103.5 ; 0.6 ;4;14;311;0;4;1;3;2;2;4;0;0
16349; 61.5 ; 184.5 ; 30.7 ;3;53;47;0;3;0;3;3;0;0;0;3
16350; 67.5 ; 472.4 ; 40.1 ;7;38;47;0;7;0;7;5;2;2;0;5
16351; 28.2 ; 394.8 ; 10.1 ;14;28;17;0;14;8;6;5;9;9;5;0
16352; 82.7 ; 165.4 ; 6.1 ;2;13;314;0;2;0;2;2;0;0;0;2
16353; 37.3 ; 708.7 ; 12.5 ;19;12;10;0;19;5;14;6;13;6;13;0
16354; 101.0 ; 201.9 ; 80.6 ;2;12;116;0;2;0;2;1;1;1;0;1
16355; 49.0 ; 196.1 ; 19.4 ;4;50;26;0;4;0;4;4;0;1;2;1
16356; 40.0 ; 80.0 ; 22.4 ;2;173;132;0;2;1;1;1;1;1;0;1
16357; 90.8 ; 272.5 ; 2.3 ;3;94;110;0;3;0;3;3;0;0;0;3
16358; 18.6 ; 74.3 ; -   ;4;101;36;0;4;0;4;3;1;4;0;0
16359; 39.9 ; 119.6 ; 9.3 ;3;76;79;1;2;0;3;1;2;0;3;0
16360; 91.8 ; 183.7 ; 22.8 ;2;77;93;0;2;1;1;1;1;0;0;2
16361; 30.0 ; 89.9 ; -   ;3;135;44;0;3;2;1;1;2;3;0;0
16362; 38.3 ; 153.4 ; 10.6 ;4;23;89;0;4;1;3;1;3;1;3;0
16363; 57.9 ; 347.2 ; 29.9 ;6;51;24;0;6;2;4;4;2;2;0;4
16364; 47.3 ; 236.5 ; 26.9 ;5;46;11;0;5;2;3;2;3;2;1;2
16365; 17.3 ; 86.3 ; 4.3 ;5;8;319;0;5;2;3;1;4;5;0;0
16366; 23.0 ; 46.0 ; 0.1 ;2;29;255;0;2;1;1;1;1;2;0;0
16367; 32.0 ; 64.0 ; 3.2 ;2;6;398;0;2;0;2;0;2;1;1;0
16368; 20.2 ; 282.3 ; 8.0 ;14;11;17;0;14;1;13;6;8;14;0;0
16369; 59.9 ; 179.6 ; 20.3 ;3;41;110;0;3;0;3;3;0;0;0;3
16370; 33.1 ; 595.0 ; 11.9 ;18;15;5;0;18;0;18;10;8;6;12;0
16371; 43.3 ; 129.9 ; 8.2 ;3;52;206;0;3;1;2;1;2;0;3;0
16372; 31.5 ; 157.6 ; 11.8 ;5;7;179;0;5;0;5;3;2;2;3;0
16373; 22.4 ; 44.9 ; 11.2 ;2;5;417;0;2;2;0;0;2;1;1;0
16374; 25.6 ; 179.5 ; 8.4 ;7;72;11;0;7;0;7;2;5;5;2;0
16375; 18.6 ; 55.7 ; -   ;3;38;61;3;0;3;0;3;0;3;0;0
16376; 33.0 ; 892.3 ; 16.6 ;27;12;1;0;27;0;27;14;13;9;18;0
16377; 34.5 ; 103.4 ; 17.2 ;3;148;47;0;3;0;3;1;2;1;2;0
16378; 41.4 ; 372.5 ; 6.5 ;9;21;40;0;9;1;8;8;1;0;9;0
16379; 15.0 ; 30.0 ; -   ;2;41;243;0;2;2;0;2;0;2;0;0
16380; 44.9 ; 89.8 ; 16.2 ;2;23;259;0;2;1;1;0;2;1;0;1
16381; 35.2 ; 493.1 ; 25.4 ;14;30;6;0;14;4;10;5;9;5;4;5
16382; 56.8 ; 227.3 ; 7.6 ;4;51;35;0;4;3;1;4;0;0;0;4
16383; 61.1 ; 488.9 ; 41.0 ;8;20;170;0;8;1;7;8;0;3;0;5
16384; 40.6 ; 243.6 ; 35.5 ;6;22;39;0;6;4;2;1;5;2;2;2
16385; 15.0 ; 30.0 ; -   ;2;143;20;0;2;1;1;0;2;2;0;0
16386; 30.4 ; 121.4 ; 9.8 ;4;28;182;0;4;3;1;3;1;1;3;0
16387; 27.9 ; 111.8 ; 6.1 ;4;82;54;0;4;3;1;2;2;3;1;0
16388; 48.9 ; 195.6 ; 25.5 ;4;66;68;0;4;2;2;4;0;1;2;1
16389; 46.2 ; 323.3 ; 24.8 ;7;27;43;0;7;2;5;1;6;2;3;2
16390; 18.3 ; 36.6 ; 5.0 ;2;120;148;0;2;0;2;1;1;2;0;0
16391; 33.0 ; 66.0 ; 11.9 ;2;2;321;0;2;1;1;1;1;1;1;0
16392; 18.1 ; 180.9 ; 5.9 ;10;22;11;0;10;1;9;8;2;10;0;0
16393; 47.7 ; 95.4 ; 1.4 ;2;137;179;0;2;0;2;2;0;0;2;0
16394; 20.5 ; 1,023.4 ; 4.7 ;50;7;60;0;50;27;23;48;2;50;0;0
16395; 29.9 ; 89.8 ; 4.4 ;3;2;97;0;3;1;2;1;2;2;1;0
16396; 57.6 ; 172.7 ; 8.3 ;3;90;85;0;3;0;3;3;0;0;0;3
16397; 46.8 ; 93.5 ; -   ;2;10;269;0;2;0;2;1;1;0;2;0
16398; 75.0 ; 299.9 ; 51.2 ;4;81;65;0;4;2;2;2;2;1;0;3
16399; 27.3 ; 272.8 ; 20.5 ;10;15;89;0;10;3;7;3;7;7;3;0
16400; 62.3 ; 186.8 ; 15.3 ;3;27;1;0;3;0;3;1;2;0;0;3
16401; 58.4 ; 934.5 ; 26.4 ;16;13;89;0;16;3;13;12;4;0;0;16
16402; 38.5 ; 76.9 ; 12.4 ;2;6;178;2;0;0;2;0;2;1;1;0
16403; 34.6 ; 103.7 ; 5.1 ;3;9;258;0;3;0;3;1;2;1;2;0
16404; 16.6 ; 166.3 ; 4.8 ;10;18;10;0;10;0;10;8;2;10;0;0
16405; 20.0 ; 80.1 ; 6.2 ;4;50;10;0;4;1;3;1;3;4;0;0
16406; 36.2 ; 108.6 ; 9.7 ;3;69;5;0;3;0;3;3;0;1;2;0
16407; 21.6 ; 302.5 ; 10.8 ;14;11;232;0;14;11;3;9;5;9;5;0
16408; 16.0 ; 175.6 ; 1.9 ;11;31;15;0;11;5;6;3;8;11;0;0
16409; 31.6 ; 63.2 ; 24.9 ;2;1;1;0;2;1;1;0;2;1;0;1
16410; 70.8 ; 141.7 ; 36.1 ;2;173;47;0;2;1;1;1;1;0;0;2
16411; 49.8 ; 149.4 ; 15.6 ;3;47;173;1;2;0;3;2;1;0;2;1
16412; 53.8 ; 107.7 ; 3.2 ;2;12;28;2;0;2;0;0;2;0;1;1
16413; 19.4 ; 310.8 ; 6.5 ;16;28;3;0;16;10;6;11;5;16;0;0
16414; 29.4 ; 234.8 ; 11.6 ;8;30;15;0;8;3;5;6;2;5;3;0
16415; 32.2 ; 64.5 ; 6.5 ;2;50;168;0;2;0;2;1;1;1;1;0
16416; 15.0 ; 30.0 ; -   ;2;59;350;0;2;1;1;0;2;2;0;0
16417; 44.8 ; 223.9 ; 9.9 ;5;103;47;1;4;0;5;4;1;0;5;0
16418; 44.4 ; 310.6 ; 16.5 ;7;20;32;0;7;4;3;5;2;2;3;2
16419; 17.7 ; 88.4 ; 4.6 ;5;4;248;0;5;2;3;1;4;5;0;0
16420; 47.5 ; 189.9 ; 0.6 ;4;49;5;0;4;1;3;1;3;0;4;0
16421; 15.6 ; 249.0 ; 1.7 ;16;23;26;0;16;0;16;16;0;16;0;0
16422; 36.1 ; 252.9 ; 16.7 ;7;59;23;0;7;0;7;4;3;2;5;0
16423; 24.7 ; 98.6 ; 4.8 ;4;88;48;0;4;0;4;2;2;4;0;0
16424; 20.3 ; 81.2 ; 0.6 ;4;22;93;0;4;1;3;3;1;4;0;0
16425; 57.3 ; 458.1 ; 20.4 ;8;59;1;0;8;0;8;8;0;0;0;8
16426; 43.0 ; 688.7 ; 16.5 ;16;13;1;0;16;0;16;14;2;5;6;5
16427; 15.7 ; 78.5 ; 1.8 ;5;72;93;0;5;1;4;2;3;5;0;0
16428; 99.5 ; 298.5 ; 19.1 ;3;107;47;0;3;0;3;2;1;0;0;3
16429; 85.1 ; 255.4 ; 25.8 ;3;122;145;0;3;3;0;1;2;0;0;3
16430; 15.0 ; 45.0 ; -   ;3;6;261;0;3;3;0;0;3;3;0;0
16431; 38.2 ; 191.0 ; 17.1 ;5;55;32;0;5;3;2;3;2;2;1;2
16432; 16.5 ; 314.1 ; 3.7 ;19;20;5;0;19;6;13;7;12;19;0;0
16433; 24.1 ; 264.9 ; 8.6 ;11;39;37;2;9;3;8;3;8;7;4;0
16434; 30.2 ; 60.4 ; -   ;2;35;169;0;2;0;2;2;0;0;2;0
16435; 57.3 ; 114.6 ; 0.7 ;2;12;57;2;0;0;2;2;0;0;0;2
16436; 38.5 ; 192.7 ; 16.0 ;5;41;16;0;5;1;4;3;2;2;3;0
16437; 46.8 ; 140.3 ; -   ;3;106;120;0;3;0;3;3;0;0;3;0
16438; 63.8 ; 318.8 ; 26.0 ;5;50;53;0;5;4;1;2;3;0;0;5
16439; 154.6 ; 309.2 ; 138.0 ;2;107;2;1;1;2;0;1;1;1;0;1
16440; 51.9 ; 675.2 ; 14.9 ;13;23;41;0;13;2;11;9;4;0;9;4
16441; 15.3 ; 305.8 ; 1.2 ;20;13;68;0;20;5;15;13;7;20;0;0
16442; 30.2 ; 60.4 ; -   ;2;31;56;2;0;2;0;0;2;0;2;0
16443; 61.3 ; 306.6 ; 14.2 ;5;35;15;0;5;0;5;5;0;0;0;5
16444; 25.0 ; 74.9 ; 5.6 ;3;59;215;0;3;0;3;3;0;2;1;0
16445; 15.0 ; 45.0 ; -   ;3;110;63;0;3;1;2;1;2;3;0;0
16446; 21.4 ; 85.7 ; 8.1 ;4;32;41;0;4;4;0;4;0;4;0;0
16447; 23.6 ; 259.9 ; 10.2 ;11;23;44;0;11;7;4;4;7;7;4;0
16448; 32.1 ; 64.1 ; 10.5 ;2;39;267;0;2;0;2;2;0;1;1;0
16449; 42.2 ; 929.0 ; 13.3 ;22;14;5;0;22;4;18;19;3;7;8;7
16450; 36.9 ; 73.8 ; 17.7 ;2;5;2;0;2;1;1;2;0;1;1;0
16451; 33.2 ; 166.0 ; 8.0 ;5;3;245;0;5;5;0;1;4;2;3;0
16452; 60.9 ; 304.7 ; 24.1 ;5;25;5;1;4;3;2;2;3;0;0;5
16453; 22.6 ; 226.4 ; 13.5 ;10;25;15;0;10;1;9;3;7;7;3;0
16454; 23.8 ; 118.9 ; 8.7 ;5;18;296;0;5;1;4;3;2;3;2;0
16455; 30.1 ; 150.5 ; 12.1 ;5;8;265;0;5;4;1;2;3;2;3;0
16456; 31.1 ; 310.8 ; 14.1 ;10;27;20;0;10;2;8;3;7;3;7;0
16457; 20.6 ; 123.7 ; 14.5 ;6;32;188;0;6;1;5;4;2;4;2;0
16458; 24.2 ; 120.8 ; 11.7 ;5;17;192;0;5;1;4;3;2;3;2;0
16459; 35.5 ; 746.5 ; 25.7 ;21;14;18;0;21;12;9;19;2;7;7;7
16460; 66.4 ; 132.8 ; 12.5 ;2;59;167;2;0;1;1;1;1;0;0;2
16461; 46.8 ; 93.5 ; -   ;2;6;188;1;1;0;2;2;0;0;2;0
16462; 35.6 ; 71.1 ; 8.0 ;2;225;63;1;1;0;2;2;0;1;1;0
16463; 39.1 ; 78.2 ; 36.1 ;2;366;16;0;2;0;2;2;0;1;0;1
16464; 19.6 ; 39.2 ; 0.5 ;2;33;14;0;2;1;1;1;1;2;0;0
16465; 59.0 ; 413.2 ; 11.4 ;7;24;4;0;7;2;5;6;1;0;0;7
16466; 46.8 ; 140.3 ; -   ;3;23;116;0;3;2;1;3;0;0;3;0
16467; 46.0 ; 138.0 ; 28.4 ;3;9;278;0;3;0;3;3;0;1;1;1
16468; 23.5 ; 117.5 ; 19.1 ;5;10;2;0;5;4;1;5;0;3;2;0
16469; 60.0 ; 120.0 ; 47.8 ;2;107;78;0;2;0;2;2;0;1;0;1
16470; 29.9 ; 149.3 ; 16.8 ;5;62;7;0;5;2;3;2;3;3;2;0
16471; 30.2 ; 60.4 ; -   ;2;7;179;0;2;0;2;2;0;0;2;0
16472; 57.8 ; 115.7 ; 1.5 ;2;23;89;0;2;1;1;2;0;0;0;2
16473; 16.8 ; 67.2 ; 2.2 ;4;14;20;0;4;3;1;0;4;4;0;0
16474; 39.5 ; 118.4 ; 12.6 ;3;117;2;1;2;2;1;1;2;1;2;0
16475; 28.9 ; 231.5 ; 12.6 ;8;23;17;0;8;0;8;1;7;5;3;0
16476; 80.1 ; 160.2 ; 11.3 ;2;56;22;2;0;0;2;2;0;0;0;2
16477; 29.9 ; 209.4 ; 6.1 ;7;18;302;0;7;3;4;3;4;5;2;0
16478; 36.3 ; 72.5 ; 16.8 ;2;6;94;2;0;0;2;2;0;1;1;0
16479; 27.1 ; 54.2 ; 18.1 ;2;37;221;0;2;0;2;2;0;1;1;0
16480; 27.9 ; 55.9 ; 12.9 ;2;196;52;0;2;0;2;1;1;1;1;0
16481; 31.1 ; 93.4 ; -   ;3;9;29;0;3;3;0;1;2;0;3;0
16482; 26.1 ; 156.8 ; 14.2 ;6;23;92;0;6;3;3;3;3;4;2;0
16483; 35.8 ; 143.2 ; 20.6 ;4;6;68;0;4;1;3;2;2;1;2;1
16484; 41.6 ; 208.0 ; 6.2 ;5;14;225;0;5;0;5;0;5;0;5;0
16485; 27.4 ; 328.2 ; 9.7 ;12;23;52;0;12;5;7;9;3;8;4;0
16486; 53.9 ; 107.8 ; 34.5 ;2;176;1;2;0;1;1;0;2;1;0;1
16487; 35.1 ; 140.4 ; 17.5 ;4;124;20;0;4;1;3;1;3;1;3;0
16488; 31.6 ; 94.8 ; 15.6 ;3;63;293;0;3;1;2;1;2;1;2;0
16489; 41.5 ; 1,702.1 ; 15.4 ;41;7;3;0;41;10;31;24;17;14;13;14
16490; 24.1 ; 192.5 ; 10.9 ;8;32;93;0;8;5;3;6;2;5;3;0
16491; 51.0 ; 561.4 ; 17.4 ;11;32;48;0;11;2;9;7;4;0;7;4
16492; 28.6 ; 57.2 ; 5.3 ;2;35;208;0;2;2;0;0;2;1;1;0
16493; 58.4 ; 291.8 ; 23.0 ;5;54;15;0;5;0;5;5;0;0;0;5
16494; 15.0 ; 30.0 ; -   ;2;23;82;0;2;2;0;1;1;2;0;0
16495; 59.5 ; 178.5 ; 6.7 ;3;67;30;3;0;1;2;1;2;0;0;3
16496; 86.4 ; 259.3 ; 45.2 ;3;90;69;0;3;0;3;3;0;0;0;3
16497; 34.2 ; 239.4 ; 12.6 ;7;17;180;0;7;1;6;6;1;2;5;0
16498; 25.8 ; 206.4 ; 9.9 ;8;22;28;0;8;2;6;4;4;5;3;0
16499; 24.4 ; 48.7 ; 9.5 ;2;86;139;0;2;1;1;1;1;1;1;0
16500; 34.1 ; 443.0 ; 19.9 ;13;14;62;1;12;4;9;8;5;4;9;0
16501; 46.1 ; 323.0 ; 10.0 ;7;18;20;6;1;0;7;6;1;0;5;2
16502; 22.1 ; 176.5 ; 5.6 ;8;32;181;0;8;4;4;3;5;8;0;0
16503; 26.1 ; 52.3 ; 7.6 ;2;5;127;0;2;0;2;1;1;1;1;0
16504; 35.6 ; 178.0 ; 19.5 ;5;15;5;5;0;2;3;3;2;2;1;2
16505; 15.0 ; 30.0 ; -   ;2;35;19;0;2;2;0;2;0;2;0;0
16506; 50.5 ; 707.6 ; 55.3 ;14;15;5;0;14;0;14;9;5;5;4;5
16507; 50.6 ; 151.9 ; 16.8 ;3;133;7;0;3;2;1;1;2;0;2;1
16508; 27.3 ; 136.4 ; 13.8 ;5;16;2;0;5;4;1;3;2;3;2;0
16509; 29.1 ; 58.3 ; 16.3 ;2;5;11;0;2;0;2;0;2;1;1;0
16510; 71.7 ; 716.6 ; 58.4 ;10;41;6;0;10;5;5;5;5;3;0;7
16511; 55.7 ; 167.1 ; 6.9 ;3;47;238;0;3;1;2;1;2;0;0;3
16512; 60.1 ; 180.2 ; 13.6 ;3;9;256;0;3;3;0;1;2;0;0;3
16513; 32.5 ; 1,007.9 ; 15.3 ;31;6;65;1;30;27;4;31;0;10;21;0
16514; 23.2 ; 208.5 ; 3.6 ;9;11;132;9;0;7;2;9;0;9;0;0
16515; 46.5 ; 790.6 ; 20.9 ;17;18;18;0;17;8;9;6;11;6;5;6
16516; 42.0 ; 293.8 ; 26.2 ;7;27;116;0;7;2;5;7;0;2;3;2
16517; 47.5 ; 94.9 ; -   ;2;11;31;2;0;1;1;2;0;0;2;0
16518; 52.5 ; 210.1 ; 17.8 ;4;37;168;0;4;1;3;3;1;0;3;1
16519; 25.5 ; 127.4 ; 7.6 ;5;5;14;0;5;5;0;5;0;3;2;0
16520; 53.1 ; 689.7 ; 27.4 ;13;21;47;0;13;3;10;11;2;4;5;4
16521; 59.7 ; 238.6 ; 26.1 ;4;45;19;0;4;2;2;2;2;0;0;4
16522; 34.4 ; 68.9 ; -   ;2;32;57;0;2;0;2;2;0;0;2;0
16523; 49.8 ; 149.5 ; 22.6 ;3;16;127;0;3;2;1;3;0;1;1;1
16524; 17.6 ; 88.0 ; 4.6 ;5;32;44;0;5;4;1;5;0;5;0;0
16525; 66.6 ; 133.3 ; 27.3 ;2;6;225;0;2;0;2;2;0;0;0;2
16526; 43.2 ; 86.3 ; 19.4 ;2;7;142;0;2;0;2;1;1;1;0;1
16527; 34.6 ; 414.7 ; 26.2 ;12;11;0;0;12;5;7;10;2;4;4;4
16528; 51.5 ; 308.8 ; 10.3 ;6;59;16;0;6;1;5;6;0;0;4;2
16529; 28.1 ; 168.6 ; 18.7 ;6;8;278;0;6;3;3;1;5;4;2;0
16530; 51.8 ; 103.7 ; 7.6 ;2;131;146;0;2;1;1;2;0;0;1;1
16531; 64.3 ; 128.6 ; 19.9 ;2;6;267;0;2;0;2;2;0;0;0;2
16532; 31.3 ; 281.9 ; 11.8 ;9;23;52;0;9;2;7;6;3;3;6;0
16533; 37.0 ; 74.0 ; 5.1 ;2;219;122;0;2;0;2;0;2;0;2;0
16534; 40.5 ; 162.1 ; 8.3 ;4;30;251;0;4;1;3;4;0;0;4;0
16535; 31.0 ; 92.9 ; 19.8 ;3;84;133;0;3;1;2;2;1;1;2;0
16536; 34.1 ; 136.4 ; 9.8 ;4;29;152;0;4;3;1;2;2;1;3;0
16537; 17.8 ; 53.4 ; 2.6 ;3;22;142;3;0;1;2;2;1;3;0;0
16538; 24.2 ; 193.5 ; 7.9 ;8;39;36;0;8;7;1;1;7;5;3;0
16539; 67.4 ; 134.8 ; 63.4 ;2;12;162;0;2;0;2;2;0;1;0;1
16540; 86.7 ; 2,080.2 ; 17.7 ;24;16;7;0;24;11;13;23;1;0;0;24
16541; 27.9 ; 111.8 ; 6.1 ;4;68;35;0;4;1;3;4;0;3;1;0
16542; 42.0 ; 336.3 ; 11.1 ;8;28;79;0;8;0;8;6;2;0;8;0
16543; 30.0 ; 300.1 ; 18.4 ;10;30;20;0;10;5;5;2;8;3;7;0
16544; 31.7 ; 443.8 ; 17.3 ;14;11;16;0;14;3;11;8;6;5;9;0
16545; 19.6 ; 39.1 ; 6.8 ;2;12;32;0;2;0;2;2;0;2;0;0
16546; 53.4 ; 160.3 ; 34.5 ;3;95;99;0;3;0;3;2;1;1;1;1
16547; 42.4 ; 211.9 ; 28.3 ;5;52;32;0;5;0;5;2;3;2;1;2
16548; 30.2 ; 60.4 ; -   ;2;147;135;1;1;1;1;0;2;0;2;0
16549; 53.2 ; 319.2 ; 20.4 ;6;16;217;0;6;1;5;3;3;0;4;2
16550; 64.8 ; 388.9 ; 14.3 ;6;23;11;0;6;1;5;4;2;0;0;6
16551; 42.8 ; 256.8 ; 14.0 ;6;44;40;0;6;1;5;2;4;2;2;2
16552; 41.4 ; 165.6 ; 39.9 ;4;86;40;0;4;2;2;3;1;1;2;1
16553; 60.9 ; 243.6 ; 57.6 ;4;17;7;0;4;3;1;1;3;1;0;3
16554; 35.9 ; 71.8 ; 16.2 ;2;245;61;0;2;2;0;0;2;1;1;0
16555; 71.7 ; 286.6 ; 56.9 ;4;73;131;0;4;0;4;4;0;1;0;3
16556; 57.5 ; 115.0 ; 7.0 ;2;7;110;0;2;0;2;2;0;0;0;2
16557; 42.8 ; 213.9 ; 15.3 ;5;61;5;0;5;0;5;2;3;2;1;2
16558; 27.9 ; 83.6 ; 11.8 ;3;2;126;0;3;2;1;3;0;2;1;0
16559; 30.4 ; 242.9 ; 13.8 ;8;23;20;0;8;0;8;7;1;3;5;0
16560; 56.8 ; 283.8 ; 29.0 ;5;33;157;0;5;2;3;2;3;2;0;3
16561; 36.3 ; 435.8 ; 30.6 ;12;28;16;0;12;2;10;6;6;4;4;4
16562; 35.9 ; 71.8 ; 16.2 ;2;64;306;0;2;2;0;2;0;1;1;0
16563; 64.8 ; 323.9 ; 65.6 ;5;14;99;5;0;2;3;5;0;2;0;3
16564; 48.2 ; 96.4 ; -   ;2;18;0;0;2;0;2;2;0;0;2;0
16565; 71.5 ; 214.5 ; 13.1 ;3;81;110;0;3;1;2;2;1;0;0;3
16566; 23.1 ; 1,155.2 ; 12.0 ;50;7;1;0;50;38;12;40;10;33;17;0
16567; 15.0 ; 30.0 ; -   ;2;239;73;0;2;0;2;2;0;2;0;0
16568; 43.1 ; 86.2 ; 9.7 ;2;41;173;2;0;1;1;1;1;0;2;0
16569; 55.7 ; 222.9 ; 5.8 ;4;42;56;0;4;1;3;1;3;0;0;4
16570; 39.2 ; 156.9 ; 24.8 ;4;69;59;0;4;2;2;1;3;1;2;1
16571; 16.8 ; 33.6 ; 2.7 ;2;11;209;0;2;1;1;1;1;2;0;0
16572; 61.6 ; 246.5 ; 18.1 ;4;33;178;0;4;0;4;4;0;0;0;4
16573; 43.5 ; 217.3 ; 6.7 ;5;50;5;0;5;0;5;5;0;0;5;0
16574; 47.2 ; 141.7 ; 0.4 ;3;68;36;1;2;1;2;3;0;0;3;0
16575; 123.7 ; 247.4 ; 24.8 ;2;139;21;0;2;0;2;2;0;0;0;2
16576; 24.0 ; 119.9 ; 11.1 ;5;48;40;0;5;2;3;4;1;3;2;0
16577; 24.3 ; 48.6 ; 13.9 ;2;199;76;0;2;1;1;2;0;1;1;0
16578; 25.2 ; 151.3 ; 18.9 ;6;52;0;0;6;4;2;3;3;4;2;0
16579; 58.3 ; 349.6 ; 9.9 ;6;50;76;0;6;0;6;6;0;0;0;6
16580; 42.3 ; 253.9 ; 2.7 ;6;38;22;6;0;0;6;4;2;0;6;0
16581; 55.0 ; 109.9 ; 27.5 ;2;220;216;0;2;0;2;1;1;1;0;1
16582; 81.6 ; 1,223.6 ; 31.2 ;15;19;5;0;15;0;15;3;12;0;0;15
16583; 83.4 ; 416.9 ; 46.7 ;5;46;110;0;5;0;5;2;3;0;0;5
16584; 50.6 ; 253.0 ; 18.9 ;5;53;19;0;5;1;4;3;2;0;3;2
16585; 68.3 ; 341.4 ; 25.7 ;5;23;92;0;5;1;4;5;0;0;0;5
16586; 39.1 ; 547.8 ; 20.5 ;14;18;0;0;14;8;6;3;11;5;4;5
16587; 45.5 ; 91.1 ; 2.9 ;2;23;73;0;2;1;1;2;0;0;2;0
16588; 22.6 ; 45.2 ; 11.4 ;2;31;47;0;2;0;2;1;1;1;1;0
16589; 35.5 ; 141.8 ; 11.5 ;4;15;60;4;0;1;3;1;3;1;3;0
16590; 25.1 ; 50.1 ; -   ;2;6;425;0;2;0;2;2;0;2;0;0
16591; 42.7 ; 1,366.5 ; 15.5 ;32;10;2;0;32;8;24;18;14;11;10;11
16592; 35.9 ; 143.4 ; 9.3 ;4;83;64;0;4;3;1;2;2;1;3;0
16593; 54.3 ; 271.5 ; 45.5 ;5;87;41;0;5;1;4;2;3;2;1;2
16594; 18.4 ; 92.0 ; 2.9 ;5;16;192;0;5;4;1;5;0;5;0;0
16595; 15.0 ; 30.0 ; -   ;2;4;267;0;2;1;1;0;2;2;0;0
16596; 52.5 ; 105.0 ; -   ;2;107;183;0;2;0;2;2;0;0;2;0
16597; 48.5 ; 727.9 ; 15.8 ;15;27;5;0;15;1;14;5;10;0;10;5
16598; 52.8 ; 105.7 ; 9.1 ;2;31;106;2;0;0;2;0;2;0;1;1
16599; 28.2 ; 56.3 ; 3.0 ;2;77;206;0;2;2;0;0;2;1;1;0
16600; 83.6 ; 167.3 ; 14.8 ;2;30;168;0;2;0;2;2;0;0;0;2
16601; 26.7 ; 53.4 ; 8.4 ;2;50;26;0;2;0;2;2;0;1;1;0
16602; 55.1 ; 220.2 ; 33.7 ;4;17;266;0;4;1;3;2;2;1;0;3
16603; 63.2 ; 126.4 ; 16.0 ;2;11;112;0;2;1;1;1;1;0;0;2
16604; 49.3 ; 197.3 ; 7.5 ;4;13;111;0;4;0;4;2;2;0;3;1
16605; 38.5 ; 192.7 ; 14.5 ;5;14;49;0;5;3;2;0;5;2;3;0
16606; 29.6 ; 236.9 ; 20.7 ;8;36;31;0;8;2;6;3;5;5;3;0
16607; 70.1 ; 140.3 ; 35.0 ;2;6;172;0;2;2;0;0;2;0;0;2
16608; 44.8 ; 89.6 ; 2.9 ;2;190;115;0;2;0;2;2;0;0;2;0
16609; 34.4 ; 137.7 ; 6.8 ;4;10;254;0;4;1;3;2;2;1;3;0
16610; 43.4 ; 130.1 ; 6.2 ;3;9;157;0;3;0;3;1;2;0;3;0
16611; 67.3 ; 202.0 ; 5.3 ;3;41;200;0;3;0;3;3;0;0;0;3
16612; 29.5 ; 59.0 ; 12.6 ;2;217;87;0;2;1;1;0;2;1;1;0
16613; 30.4 ; 273.6 ; 16.0 ;9;30;1;0;9;2;7;3;6;3;6;0
16614; 34.5 ; 345.2 ; 17.4 ;10;21;20;0;10;2;8;2;8;3;7;0
16615; 15.0 ; 30.0 ; -   ;2;1;385;0;2;2;0;2;0;2;0;0
16616; 18.6 ; 37.2 ; -   ;2;32;42;0;2;1;1;2;0;2;0;0
16617; 51.7 ; 465.0 ; 13.5 ;9;12;5;6;3;0;9;8;1;0;6;3
16618; 39.0 ; 117.0 ; 8.4 ;3;43;136;0;3;0;3;2;1;0;3;0
16619; 74.9 ; 224.8 ; 55.0 ;3;143;63;0;3;1;2;3;0;1;0;2
16620; 49.8 ; 697.5 ; 17.2 ;14;21;5;0;14;0;14;14;0;0;9;5
16621; 60.1 ; 180.2 ; 26.5 ;3;16;93;0;3;1;2;2;1;0;0;3
16622; 51.3 ; 256.7 ; 11.2 ;5;25;158;0;5;2;3;5;0;0;3;2
16623; 46.2 ; 692.3 ; 22.1 ;15;27;22;0;15;3;12;5;10;5;5;5
16624; 62.4 ; 124.8 ; 1.3 ;2;6;152;0;2;0;2;2;0;0;0;2
16625; 41.1 ; 616.0 ; 10.6 ;15;26;17;0;15;8;7;10;5;0;15;0
16626; 47.8 ; 95.7 ; 0.5 ;2;88;3;2;0;2;0;2;0;0;2;0
16627; 54.1 ; 432.5 ; 8.0 ;8;34;52;0;8;2;6;7;1;0;5;3
16628; 61.3 ; 1,349.2 ; 24.1 ;22;9;72;0;22;17;5;18;4;0;0;22
16629; 20.5 ; 40.9 ; 6.9 ;2;52;53;0;2;1;1;1;1;2;0;0
16630; 50.0 ; 100.1 ; 17.5 ;2;2;245;0;2;1;1;1;1;0;1;1
16631; 33.3 ; 499.0 ; 11.8 ;15;12;4;0;15;9;6;9;6;5;10;0
16632; 54.9 ; 274.5 ; 11.9 ;5;23;115;0;5;0;5;5;0;0;3;2
16633; 47.1 ; 94.2 ; 0.5 ;2;216;84;1;1;1;1;0;2;0;2;0
16634; 62.5 ; 374.9 ; 30.5 ;6;31;14;0;6;2;4;2;4;0;0;6
16635; 38.6 ; 115.8 ; 13.8 ;3;18;5;0;3;0;3;1;2;1;2;0
16636; 57.6 ; 288.1 ; 19.7 ;5;59;17;0;5;3;2;4;1;0;0;5
16637; 15.0 ; 30.0 ; -   ;2;43;31;2;0;0;2;1;1;2;0;0
16638; 51.7 ; 1,086.2 ; 19.5 ;21;14;58;0;21;5;16;18;3;0;14;7
16639; 54.9 ; 219.8 ; 32.4 ;4;117;68;0;4;0;4;2;2;1;2;1
16640; 22.8 ; 296.3 ; 17.4 ;13;14;5;0;13;0;13;7;6;9;4;0
16641; 55.2 ; 110.4 ; 12.6 ;2;1;115;0;2;0;2;1;1;0;0;2
16642; 47.0 ; 94.0 ; 2.5 ;2;122;124;0;2;1;1;1;1;0;2;0
16643; 33.8 ; 406.2 ; 17.2 ;12;11;22;0;12;0;12;8;4;4;8;0
16644; 59.5 ; 297.6 ; 20.2 ;5;19;79;0;5;2;3;2;3;0;0;5
16645; 22.9 ; 45.7 ; 3.2 ;2;23;207;0;2;1;1;2;0;2;0;0
16646; 21.1 ; 42.2 ; 5.9 ;2;37;252;0;2;0;2;1;1;2;0;0
16647; 27.1 ; 54.2 ; 2.2 ;2;2;163;2;0;1;1;1;1;2;0;0
16648; 53.4 ; 106.8 ; 10.0 ;2;41;98;0;2;1;1;0;2;0;1;1
16649; 56.9 ; 113.7 ; 0.1 ;2;225;47;0;2;0;2;2;0;0;0;2
16650; 32.9 ; 131.4 ; 12.6 ;4;106;8;0;4;2;2;2;2;1;3;0
16651; 32.8 ; 65.6 ; 14.8 ;2;311;11;0;2;1;1;0;2;1;1;0
16652; 18.7 ; 74.9 ; 0.9 ;4;25;36;0;4;1;3;4;0;4;0;0
16653; 66.9 ; 133.8 ; 8.0 ;2;24;113;0;2;2;0;0;2;0;0;2
16654; 48.6 ; 145.9 ; -   ;3;32;167;0;3;0;3;3;0;0;3;0
16655; 16.4 ; 98.4 ; 2.2 ;6;47;104;0;6;6;0;2;4;6;0;0
16656; 20.7 ; 41.5 ; -   ;2;3;308;0;2;1;1;0;2;2;0;0
16657; 65.3 ; 130.5 ; 49.6 ;2;4;146;0;2;1;1;0;2;1;0;1
16658; 70.9 ; 141.8 ; 6.3 ;2;3;57;2;0;1;1;2;0;0;0;2
16659; 15.0 ; 45.0 ; -   ;3;9;253;0;3;0;3;2;1;3;0;0
16660; 116.5 ; 233.0 ; 36.8 ;2;15;246;0;2;1;1;0;2;0;0;2
16661; 53.9 ; 1,723.7 ; 14.6 ;32;14;0;20;12;13;19;13;19;0;21;11
16662; 20.5 ; 41.1 ; 1.6 ;2;26;115;0;2;0;2;0;2;2;0;0
16663; 30.1 ; 90.3 ; 0.1 ;3;58;37;0;3;1;2;1;2;1;2;0
16664; 48.7 ; 146.1 ; -   ;3;50;163;0;3;0;3;2;1;0;3;0
16665; 30.5 ; 183.2 ; 7.3 ;6;50;31;0;6;5;1;2;4;2;4;0
16666; 47.2 ; 613.8 ; 10.1 ;13;26;22;0;13;3;10;8;5;0;9;4
16667; 20.1 ; 300.8 ; 12.5 ;15;15;10;0;15;5;10;5;10;10;5;0
16668; 40.8 ; 122.4 ; 10.1 ;3;42;87;0;3;2;1;1;2;0;3;0
16669; 32.1 ; 128.3 ; 12.9 ;4;98;24;0;4;3;1;1;3;1;3;0
16670; 47.7 ; 95.4 ; 1.4 ;2;19;268;0;2;0;2;2;0;0;2;0
16671; 22.6 ; 45.2 ; 11.4 ;2;50;40;1;1;2;0;1;1;1;1;0
16672; 87.1 ; 261.3 ; 12.8 ;3;28;0;0;3;0;3;3;0;0;0;3
16673; 30.7 ; 337.3 ; 12.8 ;11;8;4;1;10;8;3;8;3;4;7;0
16674; 59.0 ; 117.9 ; 7.5 ;2;50;10;0;2;0;2;2;0;0;0;2
16675; 37.0 ; 111.0 ; 14.9 ;3;21;57;0;3;2;1;2;1;1;2;0
16676; 32.6 ; 652.3 ; 25.1 ;20;11;2;20;0;15;5;2;18;7;6;7
16677; 53.2 ; 159.7 ; 0.8 ;3;119;15;0;3;0;3;3;0;0;3;0
16678; 42.8 ; 128.5 ; 11.4 ;3;27;222;0;3;1;2;2;1;0;3;0
16679; 52.3 ; 104.6 ; 8.3 ;2;18;178;0;2;0;2;1;1;0;1;1
16680; 26.5 ; 53.0 ; 2.1 ;2;11;187;0;2;2;0;0;2;2;0;0
16681; 49.4 ; 148.2 ; 3.3 ;3;47;122;0;3;1;2;2;1;0;3;0
16682; 19.9 ; 278.1 ; 4.6 ;14;22;6;0;14;4;10;9;5;14;0;0
16683; 25.1 ; 100.3 ; -   ;4;54;96;0;4;1;3;4;0;4;0;0
16684; 39.0 ; 77.9 ; 11.7 ;2;56;212;0;2;2;0;0;2;1;1;0
16685; 17.1 ; 34.2 ; 3.2 ;2;31;138;0;2;1;1;2;0;2;0;0
16686; 46.8 ; 140.3 ; -   ;3;17;194;3;0;1;2;3;0;0;3;0
16687; 30.6 ; 397.2 ; 12.6 ;13;25;6;0;13;11;2;12;1;4;9;0
16688; 39.7 ; 198.7 ; 19.1 ;5;48;145;0;5;1;4;4;1;2;1;2
16689; 54.2 ; 433.7 ; 3.2 ;8;47;37;0;8;0;8;6;2;0;5;3
16690; 61.8 ; 370.8 ; 22.2 ;6;41;113;0;6;4;2;1;5;0;0;6
16691; 18.7 ; 74.9 ; 2.0 ;4;11;56;0;4;1;3;3;1;4;0;0
16692; 43.7 ; 87.3 ; 6.8 ;2;452;5;1;1;1;1;2;0;0;2;0
16693; 118.9 ; 356.8 ; 58.5 ;3;99;68;0;3;2;1;3;0;0;0;3
16694; 24.3 ; 121.7 ; 13.5 ;5;5;41;0;5;2;3;2;3;3;2;0
16695; 34.8 ; 69.7 ; 7.0 ;2;17;260;0;2;2;0;1;1;1;1;0
16696; 48.2 ; 193.0 ; 12.9 ;4;99;6;0;4;3;1;1;3;0;3;1
16697; 36.8 ; 884.3 ; 20.2 ;24;16;16;1;23;11;13;9;15;8;8;8
16698; 42.3 ; 169.0 ; 4.4 ;4;34;204;1;3;0;4;4;0;0;4;0
16699; 88.5 ; 176.9 ; 22.0 ;2;56;152;0;2;0;2;1;1;0;0;2
16700; 47.0 ; 235.1 ; 17.5 ;5;59;79;0;5;1;4;2;3;2;1;2
16701; 55.6 ; 111.2 ; 20.9 ;2;176;14;2;0;2;0;2;0;0;0;2
16702; 78.5 ; 392.7 ; 20.9 ;5;55;10;0;5;0;5;5;0;0;0;5
16703; 104.3 ; 208.5 ; 2.1 ;2;167;29;0;2;2;0;2;0;0;0;2
16704; 25.1 ; 75.2 ; -   ;3;16;325;0;3;1;2;2;1;3;0;0
16705; 47.4 ; 237.2 ; 1.0 ;5;69;15;0;5;2;3;2;3;0;5;0
16706; 35.9 ; 71.8 ; 16.2 ;2;5;126;0;2;0;2;0;2;1;1;0
16707; 41.2 ; 123.7 ; 10.1 ;3;25;167;3;0;1;2;1;2;0;3;0
16708; 56.3 ; 168.8 ; 7.8 ;3;45;1;0;3;2;1;1;2;0;0;3
16709; 28.1 ; 420.8 ; 8.5 ;15;12;11;0;15;5;10;15;0;10;5;0
16710; 20.4 ; 81.5 ; 2.9 ;4;22;95;0;4;3;1;2;2;4;0;0
16711; 49.2 ; 688.3 ; 38.3 ;14;20;40;0;14;5;9;14;0;5;4;5
16712; 47.8 ; 1,004.2 ; 27.6 ;21;20;11;0;21;10;11;9;12;7;7;7
16713; 20.0 ; 59.9 ; 9.2 ;3;101;5;0;3;0;3;2;1;3;0;0
16714; 46.4 ; 185.7 ; 2.2 ;4;29;84;0;4;0;4;4;0;0;4;0
16715; 75.3 ; 2,409.1 ; 35.6 ;32;13;1;0;32;13;19;21;11;0;0;32
16716; 56.8 ; 113.7 ; -   ;2;26;62;0;2;0;2;1;1;0;0;2
16717; 65.3 ; 2,089.8 ; 28.4 ;32;11;0;0;32;3;29;29;3;0;0;32
16718; 30.6 ; 91.9 ; 6.1 ;3;32;225;0;3;0;3;1;2;1;2;0
16719; 35.9 ; 107.8 ; 22.6 ;3;105;95;0;3;1;2;2;1;1;1;1
16720; 28.5 ; 171.3 ; 8.4 ;6;11;112;0;6;4;2;4;2;4;2;0
16721; 18.3 ; 55.0 ; 6.2 ;3;35;233;0;3;3;0;2;1;3;0;0
16722; 48.7 ; 341.1 ; 9.4 ;7;45;16;0;7;1;6;3;4;0;5;2
16723; 24.5 ; 49.1 ; 0.8 ;2;11;4;0;2;2;0;2;0;2;0;0
16724; 15.0 ; 45.0 ; -   ;3;30;45;0;3;2;1;1;2;3;0;0
16725; 62.2 ; 310.9 ; 22.1 ;5;36;93;0;5;1;4;2;3;0;0;5
16726; 34.8 ; 69.5 ; 29.6 ;2;12;0;1;1;0;2;1;1;1;0;1
16727; 33.2 ; 165.8 ; 27.0 ;5;40;2;0;5;2;3;3;2;2;1;2
16728; 33.8 ; 67.5 ; 28.1 ;2;79;128;1;1;1;1;2;0;1;0;1
16729; 30.2 ; 90.6 ; -   ;3;34;27;0;3;0;3;3;0;0;3;0
16730; 33.1 ; 165.3 ; 14.5 ;5;25;26;5;0;2;3;2;3;2;3;0
16731; 71.0 ; 425.9 ; 35.3 ;6;49;55;0;6;1;5;6;0;0;0;6
16732; 39.9 ; 119.8 ; 18.9 ;3;71;170;0;3;2;1;3;0;1;1;1
16733; 54.0 ; 378.0 ; 27.3 ;7;46;73;0;7;1;6;7;0;2;3;2
16734; 37.3 ; 596.5 ; 18.7 ;16;19;2;0;16;10;6;6;10;5;6;5
16735; 57.1 ; 285.6 ; 5.9 ;5;50;184;0;5;0;5;4;1;0;0;5
16736; 57.0 ; 170.9 ; 13.8 ;3;19;351;0;3;0;3;1;2;0;0;3
16737; 16.4 ; 114.6 ; 2.1 ;7;42;13;0;7;6;1;4;3;7;0;0
16738; 63.1 ; 946.9 ; 18.3 ;15;27;11;0;15;0;15;14;1;0;0;15
16739; 82.5 ; 659.9 ; 48.8 ;8;36;6;1;7;2;6;8;0;0;0;8
16740; 54.2 ; 108.4 ; 11.2 ;2;24;141;0;2;0;2;0;2;0;1;1
16741; 43.8 ; 87.6 ; 10.8 ;2;132;99;1;1;0;2;2;0;0;2;0
16742; 51.7 ; 206.8 ; 19.3 ;4;37;122;0;4;0;4;2;2;0;3;1
16743; 36.9 ; 147.7 ; 10.9 ;4;82;41;1;3;0;4;4;0;1;3;0
16744; 22.5 ; 44.9 ; 11.2 ;2;75;15;2;0;0;2;1;1;1;1;0
16745; 30.9 ; 61.7 ; 23.8 ;2;24;288;0;2;0;2;2;0;1;1;0
16746; 47.7 ; 95.4 ; 1.4 ;2;49;233;0;2;1;1;0;2;0;2;0
16747; 49.7 ; 99.4 ; 29.2 ;2;265;89;1;1;0;2;2;0;1;0;1
16748; 20.0 ; 40.1 ; 7.6 ;2;5;206;0;2;0;2;2;0;2;0;0
16749; 33.8 ; 168.9 ; 22.5 ;5;31;130;0;5;3;2;2;3;2;1;2
16750; 17.5 ; 87.4 ; 6.5 ;5;19;5;0;5;0;5;2;3;5;0;0
16751; 29.9 ; 89.7 ; 16.1 ;3;4;88;0;3;1;2;0;3;2;1;0
16752; 45.1 ; 315.6 ; 21.4 ;7;36;23;0;7;2;5;2;5;2;3;2
16753; 25.6 ; 76.7 ; 11.4 ;3;47;95;0;3;0;3;1;2;2;1;0
16754; 60.2 ; 120.4 ; 6.1 ;2;31;110;0;2;0;2;1;1;0;0;2
16755; 34.9 ; 907.0 ; 15.9 ;26;11;5;0;26;0;26;23;3;9;17;0
16756; 15.0 ; 30.0 ; -   ;2;14;196;2;0;2;0;2;0;2;0;0
16757; 46.3 ; 185.3 ; 23.1 ;4;104;5;0;4;0;4;2;2;1;2;1
16758; 24.4 ; 342.1 ; 2.7 ;14;14;9;0;14;3;11;11;3;14;0;0
16759; 38.3 ; 115.0 ; 6.8 ;3;20;279;0;3;1;2;3;0;0;3;0
16760; 59.6 ; 1,071.9 ; 27.4 ;18;21;26;0;18;0;18;13;5;0;0;18
16761; 62.6 ; 125.3 ; 21.0 ;2;4;266;0;2;2;0;1;1;0;0;2
16762; 25.1 ; 50.1 ; -   ;2;105;310;0;2;0;2;1;1;2;0;0
16763; 21.6 ; 432.1 ; 7.2 ;20;11;16;0;20;5;15;9;11;20;0;0
16764; 23.1 ; 276.9 ; 11.6 ;12;13;140;0;12;9;3;6;6;8;4;0
16765; 60.4 ; 181.2 ; 41.2 ;3;2;2;0;3;1;2;1;2;1;0;2
16766; 79.1 ; 474.7 ; 12.0 ;6;32;11;0;6;1;5;6;0;0;0;6
16767; 54.1 ; 108.1 ; 35.8 ;2;100;173;0;2;0;2;2;0;1;0;1
16768; 32.6 ; 65.1 ; 11.2 ;2;8;11;0;2;1;1;0;2;1;1;0
16769; 50.7 ; 101.4 ; 3.8 ;2;75;5;0;2;0;2;1;1;0;2;0
16770; 35.9 ; 502.8 ; 13.6 ;14;28;22;0;14;4;10;12;2;5;9;0
16771; 27.3 ; 546.7 ; 14.0 ;20;21;17;0;20;9;11;4;16;13;7;0
16772; 44.6 ; 1,426.6 ; 7.4 ;32;10;81;0;32;9;23;4;28;0;32;0
16773; 35.1 ; 105.3 ; 5.4 ;3;44;0;3;0;1;2;1;2;1;2;0
16774; 20.2 ; 343.5 ; 9.2 ;17;16;22;0;17;3;14;5;12;17;0;0
16775; 19.9 ; 59.7 ; 5.3 ;3;2;233;0;3;2;1;3;0;3;0;0
16776; 46.8 ; 93.5 ; -   ;2;26;235;0;2;1;1;0;2;0;2;0
16777; 22.3 ; 111.6 ; 9.8 ;5;35;145;0;5;3;2;3;2;3;2;0
16778; 34.6 ; 415.5 ; 18.5 ;12;11;146;0;12;4;8;8;4;4;8;0
16779; 25.1 ; 1,005.7 ; 9.3 ;40;5;40;0;40;18;22;14;26;27;13;0
16780; 48.7 ; 97.4 ; -   ;2;50;68;0;2;0;2;2;0;0;2;0
16781; 18.8 ; 752.4 ; 8.3 ;40;10;2;0;40;0;40;28;12;40;0;0
16782; 35.2 ; 70.4 ; 7.8 ;2;94;69;0;2;0;2;2;0;1;1;0
16783; 66.5 ; 199.6 ; 10.1 ;3;173;10;0;3;0;3;3;0;0;0;3
16784; 25.8 ; 103.1 ; 6.9 ;4;25;157;0;4;0;4;4;0;3;1;0
16785; 27.6 ; 248.2 ; 10.8 ;9;31;3;0;9;6;3;2;7;6;3;0
16786; 42.0 ; 420.0 ; 20.1 ;10;29;27;0;10;4;6;4;6;3;4;3
16787; 35.8 ; 429.8 ; 12.5 ;12;27;6;0;12;3;9;5;7;4;8;0
16788; 44.7 ; 357.6 ; 16.1 ;8;18;69;0;8;0;8;6;2;3;2;3
16789; 180.5 ; 361.0 ; 79.8 ;2;147;38;2;0;2;0;1;1;0;0;2
16790; 52.3 ; 104.6 ; -   ;2;132;137;0;2;0;2;2;0;0;2;0
16791; 44.3 ; 177.3 ; 14.0 ;4;58;40;0;4;1;3;2;2;0;3;1
16792; 49.0 ; 147.1 ; 2.7 ;3;133;34;0;3;2;1;3;0;0;3;0
16793; 31.6 ; 63.3 ; 22.1 ;2;14;131;2;0;0;2;1;1;1;1;0
16794; 18.8 ; 56.5 ; 3.5 ;3;5;42;0;3;2;1;1;2;3;0;0
16795; 20.9 ; 293.1 ; 1.7 ;14;13;0;0;14;9;5;1;13;14;0;0
16796; 28.8 ; 230.7 ; 8.4 ;8;33;26;0;8;4;4;8;0;5;3;0
16797; 36.8 ; 73.7 ; 17.6 ;2;127;242;0;2;0;2;2;0;1;1;0
16798; 22.7 ; 113.4 ; 7.2 ;5;30;137;0;5;0;5;1;4;5;0;0
16799; 31.0 ; 155.0 ; 17.9 ;5;9;7;0;5;2;3;3;2;2;3;0
16800; 77.5 ; 310.1 ; 14.9 ;4;61;99;0;4;0;4;3;1;0;0;4
16801; 47.5 ; 285.3 ; 30.4 ;6;32;60;6;0;3;3;6;0;2;2;2
16802; 27.5 ; 384.4 ; 8.9 ;14;19;73;0;14;3;11;8;6;9;5;0
16803; 22.2 ; 44.3 ; 1.6 ;2;1;212;2;0;2;0;0;2;2;0;0
16804; 35.3 ; 494.2 ; 21.0 ;14;21;0;0;14;4;10;10;4;5;4;5
16805; 42.4 ; 509.2 ; 6.1 ;12;24;39;0;12;9;3;1;11;0;12;0
16806; 43.0 ; 129.0 ; 6.9 ;3;59;80;0;3;0;3;1;2;0;3;0
16807; 72.7 ; 145.4 ; 27.5 ;2;76;36;0;2;0;2;2;0;0;0;2
16808; 66.8 ; 267.3 ; 6.8 ;4;14;160;0;4;2;2;4;0;0;0;4
16809; 28.1 ; 56.1 ; 2.9 ;2;50;20;0;2;0;2;1;1;1;1;0
16810; 47.1 ; 94.2 ; 0.5 ;2;10;101;0;2;1;1;1;1;0;2;0
16811; 48.7 ; 97.4 ; -   ;2;50;126;0;2;0;2;1;1;0;2;0
16812; 67.5 ; 472.5 ; 7.7 ;7;38;4;0;7;2;5;3;4;0;0;7
16813; 18.7 ; 93.6 ; 1.6 ;5;5;361;0;5;4;1;0;5;5;0;0
16814; 64.8 ; 259.3 ; 54.2 ;4;29;75;4;0;2;2;2;2;1;0;3
16815; 40.9 ; 204.3 ; 15.6 ;5;57;136;0;5;1;4;5;0;2;1;2
16816; 50.2 ; 100.4 ; 5.1 ;2;286;89;0;2;1;1;2;0;0;1;1
16817; 71.8 ; 358.8 ; 18.0 ;5;15;40;0;5;1;4;4;1;0;0;5
16818; 19.6 ; 78.6 ; 4.4 ;4;10;264;0;4;3;1;2;2;4;0;0
16819; 17.1 ; 51.3 ; 0.6 ;3;54;1;3;0;2;1;1;2;3;0;0
16820; 17.8 ; 142.3 ; 1.7 ;8;10;39;8;0;5;3;7;1;8;0;0
16821; 31.9 ; 382.3 ; 17.9 ;12;4;19;0;12;3;9;8;4;4;8;0
16822; 90.6 ; 181.2 ; 80.8 ;2;253;0;1;1;0;2;0;2;1;0;1
16823; 27.8 ; 83.4 ; 10.6 ;3;4;59;0;3;1;2;2;1;2;1;0
16824; 41.1 ; 205.4 ; 21.7 ;5;23;271;0;5;2;3;1;4;2;1;2
16825; 20.0 ; 220.3 ; 3.9 ;11;27;6;0;11;7;4;1;10;11;0;0
16826; 45.3 ; 362.5 ; 19.5 ;8;50;0;0;8;3;5;3;5;3;2;3
16827; 50.9 ; 305.4 ; 17.5 ;6;32;188;0;6;3;3;0;6;0;4;2
16828; 21.3 ; 85.2 ; 8.0 ;4;57;120;0;4;1;3;3;1;4;0;0
16829; 22.6 ; 248.3 ; 5.4 ;11;22;63;0;11;3;8;7;4;11;0;0
16830; 36.6 ; 329.3 ; -   ;9;25;2;0;9;1;8;6;3;0;9;0
16831; 26.0 ; 182.1 ; 9.2 ;7;29;119;0;7;5;2;5;2;5;2;0
16832; 36.6 ; 73.2 ; -   ;2;39;291;0;2;2;0;1;1;0;2;0
16833; 22.8 ; 387.1 ; 5.7 ;17;22;103;0;17;16;1;2;15;17;0;0
16834; 50.6 ; 101.2 ; 2.9 ;2;44;225;0;2;0;2;2;0;0;2;0
16835; 19.3 ; 57.8 ; 5.5 ;3;60;132;0;3;1;2;1;2;3;0;0
16836; 36.4 ; 181.8 ; 28.6 ;5;5;0;0;5;1;4;3;2;2;1;2
16837; 58.9 ; 412.2 ; 14.7 ;7;50;0;0;7;0;7;7;0;0;0;7
16838; 49.3 ; 197.4 ; 3.2 ;4;60;58;0;4;0;4;2;2;0;4;0
16839; 26.6 ; 106.3 ; 3.2 ;4;31;22;0;4;1;3;2;2;4;0;0
16840; 42.6 ; 298.4 ; 23.6 ;7;23;12;0;7;4;3;1;6;2;3;2
16841; 24.8 ; 198.3 ; 5.3 ;8;36;5;0;8;0;8;4;4;5;3;0
16842; 79.0 ; 868.6 ; 44.7 ;11;36;60;0;11;4;7;11;0;0;0;11
16843; 32.3 ; 161.4 ; 10.3 ;5;81;38;0;5;2;3;3;2;2;3;0
16844; 19.9 ; 119.6 ; 7.5 ;6;25;149;0;6;3;3;5;1;6;0;0
16845; 25.0 ; 75.1 ; 9.2 ;3;14;78;0;3;2;1;1;2;2;1;0
16846; 48.3 ; 241.7 ; 25.6 ;5;56;40;0;5;1;4;4;1;2;1;2
16847; 36.7 ; 881.3 ; 9.6 ;24;16;5;0;24;4;20;15;9;8;16;0
16848; 58.2 ; 116.3 ; 14.6 ;2;19;37;0;2;0;2;0;2;0;0;2
16849; 74.1 ; 2,001.7 ; 29.4 ;27;12;0;0;27;0;27;26;1;0;0;27
16850; 23.1 ; 46.1 ; 7.6 ;2;18;32;0;2;0;2;2;0;1;1;0
16851; 15.0 ; 45.0 ; -   ;3;2;102;0;3;2;1;0;3;3;0;0
16852; 49.5 ; 594.5 ; 29.9 ;12;20;191;0;12;5;7;5;7;4;4;4
16853; 27.2 ; 271.7 ; 10.3 ;10;25;102;0;10;6;4;7;3;7;3;0
16854; 49.1 ; 343.4 ; 2.8 ;7;23;15;1;6;0;7;7;0;0;7;0
16855; 52.3 ; 418.3 ; 48.8 ;8;23;16;0;8;3;5;5;3;3;2;3
16856; 59.7 ; 119.4 ; 5.3 ;2;6;303;0;2;2;0;0;2;0;0;2
16857; 19.4 ; 193.5 ; 6.7 ;10;41;3;0;10;7;3;9;1;10;0;0
16858; 78.3 ; 391.5 ; 37.8 ;5;85;115;0;5;0;5;4;1;0;0;5
16859; 41.6 ; 124.8 ; 30.3 ;3;7;260;0;3;2;1;1;2;1;1;1
16860; 25.3 ; 227.5 ; 12.5 ;9;17;46;0;9;7;2;7;2;6;3;0
16861; 26.6 ; 132.9 ; 9.1 ;5;53;23;0;5;2;3;3;2;3;2;0
16862; 17.3 ; 34.7 ; 3.5 ;2;5;263;0;2;0;2;0;2;2;0;0
16863; 23.5 ; 563.4 ; 15.9 ;24;10;5;0;24;5;19;12;12;16;8;0
16864; 78.2 ; 469.3 ; 29.3 ;6;44;52;0;6;0;6;5;1;0;0;6
16865; 66.3 ; 530.5 ; 50.7 ;8;31;32;0;8;2;6;4;4;3;0;5
16866; 18.0 ; 36.0 ; -   ;2;9;32;0;2;1;1;1;1;2;0;0
16867; 23.8 ; 71.5 ; 12.0 ;3;36;198;0;3;2;1;2;1;2;1;0
16868; 42.0 ; 84.1 ; 8.1 ;2;228;71;0;2;1;1;1;1;0;2;0
16869; 24.5 ; 171.8 ; 16.6 ;7;19;166;0;7;5;2;6;1;5;2;0
16870; 51.0 ; 102.0 ; 38.8 ;2;145;53;0;2;0;2;0;2;1;0;1
16871; 46.5 ; 372.2 ; 1.8 ;8;13;26;8;0;0;8;6;2;0;8;0
16872; 41.1 ; 451.7 ; 24.2 ;11;26;47;0;11;3;8;5;6;4;3;4
16873; 74.6 ; 223.7 ; 67.2 ;3;98;60;1;2;2;1;2;1;1;0;2
16874; 99.5 ; 497.4 ; 42.0 ;5;52;152;0;5;2;3;3;2;0;0;5
16875; 30.2 ; 60.4 ; -   ;2;65;146;0;2;1;1;2;0;0;2;0
16876; 41.9 ; 503.0 ; 10.6 ;12;13;22;0;12;3;9;8;4;0;12;0
16877; 48.4 ; 193.4 ; 2.4 ;4;22;52;1;3;1;3;2;2;0;4;0
16878; 18.7 ; 74.9 ; 7.9 ;4;17;131;0;4;1;3;4;0;4;0;0
16879; 35.3 ; 176.5 ; 17.0 ;5;26;152;0;5;1;4;2;3;2;3;0
16880; 60.7 ; 121.3 ; 30.8 ;2;12;279;0;2;0;2;1;1;1;0;1
16881; 34.1 ; 375.5 ; 15.5 ;11;14;86;0;11;2;9;7;4;4;7;0
16882; 28.2 ; 225.2 ; 7.7 ;8;16;69;0;8;1;7;2;6;5;3;0
16883; 48.5 ; 242.3 ; 0.6 ;5;32;73;0;5;0;5;5;0;0;5;0
16884; 50.5 ; 302.9 ; 18.0 ;6;42;33;0;6;5;1;4;2;0;4;2
16885; 25.8 ; 51.7 ; 16.2 ;2;109;294;0;2;1;1;0;2;1;1;0
16886; 29.7 ; 59.4 ; 15.5 ;2;7;68;0;2;0;2;1;1;1;1;0
16887; 104.9 ; 314.6 ; 69.2 ;3;29;41;0;3;0;3;3;0;0;0;3
16888; 54.5 ; 490.6 ; 22.7 ;9;28;78;0;9;0;9;2;7;0;6;3
16889; 42.0 ; 168.1 ; 14.3 ;4;5;43;0;4;0;4;2;2;1;2;1
16890; 35.9 ; 71.8 ; 16.2 ;2;64;212;0;2;2;0;0;2;1;1;0
16891; 36.0 ; 359.8 ; 8.2 ;10;21;2;1;9;6;4;8;2;3;7;0
16892; 42.3 ; 211.3 ; 10.5 ;5;62;9;0;5;2;3;2;3;0;5;0
16893; 60.9 ; 1,034.5 ; 28.8 ;17;20;89;0;17;6;11;15;2;0;0;17
16894; 21.4 ; 42.9 ; 5.4 ;2;69;209;0;2;1;1;1;1;2;0;0
16895; 15.0 ; 45.0 ; -   ;3;30;259;0;3;1;2;3;0;3;0;0
16896; 28.3 ; 113.3 ; 4.0 ;4;29;44;0;4;2;2;4;0;3;1;0
16897; 80.7 ; 161.4 ; 19.1 ;2;258;141;0;2;0;2;1;1;0;0;2
16898; 39.4 ; 78.9 ; 13.9 ;2;227;89;0;2;0;2;2;0;1;1;0
16899; 17.2 ; 34.4 ; 3.8 ;2;70;2;0;2;2;0;1;1;2;0;0
16900; 36.6 ; 73.2 ; -   ;2;5;257;0;2;0;2;2;0;0;2;0
16901; 39.0 ; 117.0 ; 22.0 ;3;23;121;0;3;1;2;1;2;1;1;1
16902; 20.0 ; 80.1 ; 6.2 ;4;33;4;0;4;3;1;1;3;4;0;0
16903; 19.1 ; 95.3 ; 4.9 ;5;51;50;0;5;5;0;5;0;5;0;0
16904; 50.0 ; 150.0 ; 22.9 ;3;53;284;0;3;1;2;0;3;1;1;1
16905; 33.2 ; 132.8 ; 13.9 ;4;43;74;0;4;2;2;1;3;1;3;0
16906; 55.9 ; 167.7 ; 6.9 ;3;32;196;0;3;2;1;1;2;0;0;3
16907; 72.7 ; 218.0 ; 49.0 ;3;25;160;0;3;2;1;2;1;1;0;2
16908; 25.9 ; 129.7 ; 10.9 ;5;16;91;0;5;3;2;2;3;3;2;0
16909; 30.5 ; 122.1 ; 13.7 ;4;22;264;0;4;4;0;4;0;1;3;0
16910; 44.8 ; 89.6 ; 44.7 ;2;263;157;0;2;1;1;1;1;1;0;1
16911; 22.5 ; 180.2 ; 11.9 ;8;30;2;0;8;3;5;3;5;5;3;0
16912; 68.0 ; 340.1 ; 35.2 ;5;36;99;0;5;3;2;2;3;0;0;5
16913; 44.6 ; 222.8 ; 8.6 ;5;26;163;0;5;2;3;3;2;0;5;0
16914; 52.1 ; 104.2 ; 8.0 ;2;19;257;0;2;0;2;2;0;0;1;1
16915; 48.5 ; 291.0 ; 10.5 ;6;53;1;0;6;0;6;2;4;0;4;2
16916; 24.9 ; 49.8 ; 9.4 ;2;6;212;0;2;2;0;1;1;1;1;0
16917; 50.7 ; 355.2 ; 2.4 ;7;23;26;0;7;0;7;7;0;0;7;0
16918; 28.7 ; 86.2 ; 3.4 ;3;47;22;0;3;0;3;1;2;2;1;0
16919; 25.9 ; 77.7 ; 7.4 ;3;27;218;0;3;3;0;2;1;2;1;0
16920; 28.0 ; 643.4 ; 23.2 ;23;12;37;0;23;6;17;8;15;15;8;0
16921; 20.0 ; 79.8 ; 7.6 ;4;41;15;0;4;1;3;3;1;4;0;0
16922; 19.4 ; 368.2 ; 7.2 ;19;18;0;0;19;12;7;13;6;19;0;0
16923; 45.6 ; 182.3 ; 29.6 ;4;4;242;0;4;1;3;3;1;1;2;1
16924; 51.7 ; 413.7 ; 16.2 ;8;37;5;0;8;2;6;7;1;0;5;3
16925; 28.9 ; 317.9 ; 17.7 ;11;30;20;0;11;4;7;3;8;7;4;0
16926; 46.8 ; 93.5 ; -   ;2;34;314;0;2;2;0;1;1;0;2;0
16927; 68.3 ; 341.4 ; 33.0 ;5;57;26;0;5;0;5;5;0;0;0;5
16928; 59.3 ; 118.5 ; 18.7 ;2;57;232;0;2;0;2;0;2;0;0;2
16929; 40.4 ; 80.9 ; 3.2 ;2;2;259;0;2;2;0;0;2;0;2;0
16930; 40.9 ; 122.7 ; 13.2 ;3;88;43;0;3;0;3;1;2;1;2;0
16931; 32.8 ; 1,343.5 ; 21.3 ;41;5;7;0;41;31;10;36;5;14;27;0
16932; 21.9 ; 153.0 ; 3.7 ;7;14;180;0;7;7;0;7;0;7;0;0
16933; 23.8 ; 119.2 ; 10.4 ;5;41;10;0;5;1;4;4;1;3;2;0
16934; 22.4 ; 67.3 ; 2.4 ;3;32;141;0;3;0;3;1;2;3;0;0
16935; 54.2 ; 108.5 ; 4.9 ;2;37;231;0;2;0;2;0;2;0;1;1
16936; 18.0 ; 72.2 ; 5.1 ;4;58;121;0;4;2;2;1;3;4;0;0
16937; 94.0 ; 188.0 ; 31.4 ;2;43;124;0;2;2;0;2;0;0;0;2
16938; 16.2 ; 80.9 ; 2.0 ;5;32;138;0;5;2;3;3;2;5;0;0
16939; 20.7 ; 41.5 ; -   ;2;74;9;0;2;2;0;0;2;2;0;0
16940; 34.8 ; 1,425.4 ; 16.6 ;41;10;23;0;41;17;24;30;11;14;27;0
16941; 16.8 ; 33.6 ; 2.7 ;2;3;140;0;2;2;0;1;1;2;0;0
16942; 49.2 ; 147.5 ; 2.2 ;3;57;35;0;3;3;0;1;2;0;3;0
16943; 28.9 ; 57.9 ; 20.9 ;2;43;315;0;2;0;2;2;0;1;1;0
16944; 54.6 ; 109.2 ; 11.8 ;2;119;26;0;2;0;2;2;0;0;1;1
16945; 38.3 ; 114.8 ; 17.4 ;3;22;110;0;3;0;3;3;0;1;1;1
16946; 45.9 ; 229.4 ; 18.9 ;5;67;76;0;5;3;2;4;1;2;1;2
16947; 39.0 ; 663.4 ; 29.4 ;17;18;6;0;17;10;7;12;5;6;5;6
16948; 20.0 ; 40.1 ; 7.6 ;2;99;71;1;1;2;0;0;2;2;0;0
16949; 22.9 ; 45.8 ; 10.9 ;2;7;204;0;2;0;2;2;0;1;1;0
16950; 37.1 ; 222.8 ; 22.0 ;6;33;0;0;6;1;5;5;1;2;2;2
16951; 88.3 ; 530.0 ; 25.1 ;6;19;17;6;0;6;0;0;6;0;0;6
16952; 32.2 ; 419.2 ; 10.0 ;13;29;53;0;13;4;9;5;8;4;9;0
16953; 16.6 ; 231.9 ; 4.7 ;14;13;2;4;10;8;6;10;4;14;0;0
16954; 87.1 ; 261.3 ; 3.8 ;3;59;167;0;3;0;3;3;0;0;0;3
16955; 34.2 ; 342.1 ; 10.3 ;10;23;32;0;10;0;10;8;2;3;7;0
16956; 17.6 ; 52.8 ; 1.8 ;3;36;206;0;3;2;1;3;0;3;0;0
16957; 19.4 ; 349.3 ; 6.2 ;18;15;107;1;17;8;10;5;13;18;0;0
16958; 90.0 ; 270.1 ; 52.6 ;3;3;197;0;3;2;1;2;1;0;0;3
16959; 94.0 ; 281.9 ; 0.9 ;3;54;95;3;0;2;1;3;0;0;0;3
16960; 20.0 ; 319.3 ; 6.2 ;16;8;17;0;16;5;11;8;8;16;0;0
16961; 57.0 ; 570.4 ; 16.3 ;10;42;1;0;10;1;9;3;7;0;0;10
16962; 46.2 ; 647.1 ; 4.7 ;14;13;5;14;0;0;14;12;2;0;14;0
16963; 38.5 ; 76.9 ; 12.4 ;2;32;197;0;2;2;0;1;1;1;1;0
16964; 15.0 ; 30.0 ; -   ;2;2;88;0;2;1;1;1;1;2;0;0
16965; 16.6 ; 33.2 ; 2.4 ;2;13;5;2;0;0;2;1;1;2;0;0
16966; 20.1 ; 80.2 ; 3.9 ;4;44;9;1;3;3;1;1;3;4;0;0
16967; 29.2 ; 58.4 ; 4.6 ;2;3;243;0;2;2;0;0;2;1;1;0
16968; 37.8 ; 113.3 ; 9.0 ;3;68;147;0;3;0;3;2;1;1;2;0
16969; 57.3 ; 458.6 ; 24.0 ;8;43;5;0;8;3;5;6;2;0;0;8
16970; 43.8 ; 87.6 ; 10.8 ;2;22;142;0;2;1;1;1;1;0;2;0
16971; 41.5 ; 207.6 ; 22.8 ;5;14;13;0;5;4;1;0;5;2;1;2
16972; 40.4 ; 161.5 ; 16.4 ;4;12;5;0;4;1;3;4;0;1;2;1
16973; 30.2 ; 60.4 ; -   ;2;19;116;1;1;0;2;1;1;0;2;0
16974; 39.9 ; 478.9 ; 13.9 ;12;22;52;0;12;2;10;10;2;4;8;0
16975; 19.0 ; 95.1 ; 5.9 ;5;23;25;0;5;4;1;5;0;5;0;0
16976; 17.9 ; 125.4 ; 1.4 ;7;13;128;0;7;6;1;7;0;7;0;0
16977; 47.4 ; 142.2 ; 21.6 ;3;119;54;0;3;2;1;1;2;1;1;1
16978; 60.0 ; 780.6 ; 25.8 ;13;19;53;0;13;2;11;7;6;0;0;13
16979; 21.7 ; 65.1 ; 6.2 ;3;14;81;0;3;2;1;0;3;3;0;0
16980; 42.9 ; 85.7 ; -   ;2;21;217;0;2;2;0;0;2;0;2;0
16981; 16.7 ; 33.4 ; 1.6 ;2;8;186;0;2;1;1;2;0;2;0;0
16982; 29.4 ; 58.7 ; 3.7 ;2;53;348;0;2;1;1;2;0;1;1;0
16983; 34.3 ; 68.6 ; 13.9 ;2;269;53;0;2;0;2;0;2;1;1;0
16984; 22.4 ; 112.1 ; 3.2 ;5;28;68;0;5;2;3;4;1;5;0;0
16985; 19.2 ; 76.7 ; 4.9 ;4;94;35;0;4;4;0;4;0;4;0;0
16986; 33.8 ; 169.2 ; 16.6 ;5;70;27;0;5;1;4;3;2;2;3;0
16987; 96.3 ; 192.6 ; 1.4 ;2;140;226;0;2;1;1;1;1;0;0;2
16988; 35.4 ; 283.0 ; 18.9 ;8;21;74;1;7;5;3;5;3;3;5;0
16989; 34.5 ; 276.2 ; 10.5 ;8;23;38;0;8;4;4;3;5;3;5;0
16990; 57.5 ; 115.0 ; 48.5 ;2;83;161;0;2;1;1;2;0;1;0;1
16991; 29.6 ; 148.1 ; 16.4 ;5;7;247;0;5;2;3;3;2;3;2;0
16992; 15.0 ; 30.0 ; -   ;2;1;131;0;2;1;1;0;2;2;0;0
16993; 46.7 ; 186.7 ; 20.1 ;4;53;115;0;4;0;4;3;1;1;2;1
16994; 38.1 ; 190.5 ; 11.5 ;5;58;80;0;5;4;1;4;1;2;3;0
16995; 30.2 ; 60.4 ; -   ;2;6;161;0;2;2;0;0;2;0;2;0
16996; 40.5 ; 81.0 ; 38.2 ;2;18;115;0;2;0;2;1;1;1;0;1
16997; 37.8 ; 226.9 ; 44.8 ;6;34;0;0;6;0;6;4;2;2;2;2
16998; 45.4 ; 363.1 ; 6.1 ;8;25;15;0;8;2;6;6;2;0;8;0
16999; 17.7 ; 247.5 ; 9.8 ;14;24;44;0;14;12;2;14;0;14;0;0
17000; 30.9 ; 61.7 ; 23.8 ;2;20;302;0;2;2;0;0;2;1;1;0
17001; 28.7 ; 574.1 ; 12.8 ;20;14;12;0;20;8;12;13;7;13;7;0
17002; 25.7 ; 77.1 ; 9.9 ;3;82;101;0;3;2;1;2;1;2;1;0
17003; 19.2 ; 38.5 ; -   ;2;11;254;0;2;1;1;2;0;2;0;0
17004; 39.6 ; 356.8 ; 9.2 ;9;29;36;0;9;2;7;8;1;0;9;0
17005; 33.3 ; 266.0 ; 13.9 ;8;42;93;0;8;1;7;4;4;3;5;0
17006; 49.5 ; 495.5 ; 25.0 ;10;23;13;0;10;3;7;10;0;3;4;3
17007; 30.5 ; 91.5 ; 16.5 ;3;175;20;0;3;1;2;0;3;1;2;0
17008; 42.2 ; 126.6 ; 14.6 ;3;60;110;0;3;1;2;1;2;1;1;1
17009; 52.4 ; 157.1 ; 1.6 ;3;64;40;3;0;1;2;3;0;0;3;0
17010; 41.0 ; 205.2 ; 10.5 ;5;29;38;0;5;0;5;3;2;0;5;0
17011; 15.0 ; 30.0 ; -   ;2;142;26;0;2;1;1;1;1;2;0;0
17012; 22.9 ; 389.0 ; 11.8 ;17;19;1;0;17;5;12;13;4;11;6;0
17013; 75.4 ; 527.5 ; 40.6 ;7;22;73;0;7;0;7;5;2;0;0;7
17014; 46.8 ; 93.5 ; -   ;2;95;200;0;2;1;1;1;1;0;2;0
17015; 22.5 ; 44.9 ; 11.2 ;2;114;179;0;2;1;1;2;0;1;1;0
17016; 28.3 ; 85.0 ; 3.0 ;3;88;21;0;3;0;3;2;1;2;1;0
17017; 38.0 ; 76.1 ; 19.4 ;2;10;215;0;2;1;1;1;1;1;0;1
17018; 36.6 ; 73.2 ; -   ;2;13;121;2;0;0;2;2;0;0;2;0
17019; 53.4 ; 160.3 ; 6.1 ;3;59;110;0;3;0;3;3;0;0;2;1
17020; 16.4 ; 32.9 ; 2.2 ;2;322;0;0;2;0;2;1;1;2;0;0
17021; 15.0 ; 30.0 ; -   ;2;3;255;0;2;1;1;2;0;2;0;0
17022; 27.6 ; 55.3 ; 3.8 ;2;24;23;2;0;1;1;0;2;1;1;0
17023; 25.9 ; 518.7 ; 11.3 ;20;22;5;0;20;9;11;8;12;13;7;0
17024; 24.7 ; 98.9 ; 10.5 ;4;151;35;0;4;3;1;2;2;3;1;0
17025; 25.6 ; 307.2 ; 13.3 ;12;14;136;0;12;4;8;9;3;8;4;0
17026; 29.1 ; 58.3 ; 1.6 ;2;212;62;0;2;1;1;0;2;1;1;0
17027; 29.0 ; 58.1 ; 1.7 ;2;79;184;0;2;1;1;1;1;1;1;0
17028; 59.5 ; 356.8 ; 22.8 ;6;47;110;0;6;1;5;5;1;0;0;6
17029; 44.1 ; 132.3 ; 5.6 ;3;22;79;0;3;1;2;2;1;0;3;0
17030; 24.8 ; 49.6 ; 7.7 ;2;306;92;0;2;1;1;0;2;1;1;0
17031; 34.8 ; 313.1 ; 12.7 ;9;42;38;0;9;0;9;7;2;3;6;0
17032; 30.8 ; 61.7 ; 8.6 ;2;79;194;1;1;1;1;1;1;1;1;0
17033; 37.2 ; 74.3 ; 1.6 ;2;194;41;0;2;1;1;1;1;0;2;0
17034; 35.6 ; 391.9 ; 20.3 ;11;32;1;0;11;4;7;10;1;4;3;4
17035; 49.2 ; 246.1 ; 16.4 ;5;27;10;0;5;0;5;5;0;0;3;2
17036; 15.0 ; 30.0 ; -   ;2;51;230;0;2;0;2;1;1;2;0;0
17037; 29.0 ; 116.2 ; 11.4 ;4;11;136;0;4;2;2;3;1;3;1;0
17038; 52.6 ; 210.3 ; 72.6 ;4;79;70;0;4;3;1;4;0;1;2;1
17039; 47.0 ; 141.0 ; 0.4 ;3;137;40;0;3;1;2;2;1;0;3;0
17040; 56.8 ; 227.1 ; 6.1 ;4;36;246;0;4;0;4;4;0;0;0;4
17041; 59.9 ; 838.6 ; 20.8 ;14;14;3;0;14;8;6;4;10;0;0;14
17042; 47.7 ; 190.6 ; 18.0 ;4;101;13;0;4;2;2;1;3;1;2;1
17043; 20.1 ; 60.2 ; 9.3 ;3;25;231;0;3;0;3;1;2;3;0;0
17044; 34.3 ; 480.9 ; 17.8 ;14;16;5;0;14;6;8;7;7;5;9;0
17045; 42.8 ; 213.8 ; 28.0 ;5;32;44;5;0;0;5;4;1;2;1;2
17046; 49.7 ; 99.3 ; 4.4 ;2;141;272;0;2;1;1;1;1;0;2;0
17047; 59.5 ; 178.5 ; 7.9 ;3;87;205;0;3;0;3;3;0;0;0;3
17048; 27.0 ; 81.0 ; 3.6 ;3;33;2;0;3;1;2;3;0;2;1;0
17049; 19.6 ; 39.2 ; 0.5 ;2;2;214;1;1;1;1;2;0;2;0;0
17050; 77.8 ; 155.6 ; 9.1 ;2;31;246;0;2;0;2;2;0;0;0;2
17051; 45.7 ; 182.7 ; 6.4 ;4;23;146;0;4;1;3;3;1;0;4;0
17052; 20.1 ; 321.6 ; 5.0 ;16;9;6;0;16;11;5;15;1;16;0;0
17053; 19.7 ; 39.3 ; 1.6 ;2;86;48;0;2;0;2;2;0;2;0;0
17054; 16.8 ; 33.6 ; 2.7 ;2;167;167;1;1;1;1;2;0;2;0;0
17055; 53.7 ; 107.5 ; 9.4 ;2;175;100;0;2;0;2;1;1;0;1;1
17056; 38.8 ; 543.8 ; 8.3 ;14;19;5;0;14;0;14;12;2;0;14;0
17057; 19.1 ; 57.2 ; 5.5 ;3;50;14;0;3;2;1;2;1;3;0;0
17058; 27.4 ; 410.4 ; 15.7 ;15;19;33;0;15;7;8;6;9;10;5;0
17059; 18.6 ; 111.5 ; 4.7 ;6;19;57;0;6;0;6;2;4;6;0;0
17060; 30.9 ; 61.8 ; -   ;2;14;10;2;0;0;2;2;0;0;2;0
17061; 29.8 ; 59.5 ; 0.6 ;2;81;57;0;2;1;1;0;2;1;1;0
17062; 60.6 ; 242.5 ; 7.0 ;4;117;50;0;4;2;2;3;1;0;0;4
17063; 22.5 ; 44.9 ; 11.2 ;2;56;181;0;2;2;0;1;1;1;1;0
17064; 44.6 ; 89.1 ; 11.9 ;2;23;222;0;2;1;1;0;2;0;1;1
17065; 57.2 ; 228.7 ; 25.4 ;4;109;37;0;4;0;4;1;3;0;0;4
17066; 24.4 ; 48.8 ; 8.7 ;2;11;252;0;2;1;1;1;1;1;1;0
17067; 40.0 ; 560.0 ; 6.0 ;14;19;62;0;14;4;10;8;6;0;14;0
17068; 54.2 ; 216.8 ; 7.0 ;4;31;187;0;4;3;1;3;1;0;3;1
17069; 55.7 ; 111.4 ; 10.5 ;2;13;199;0;2;0;2;1;1;0;0;2
17070; 44.1 ; 88.2 ; 11.2 ;2;3;247;0;2;1;1;2;0;0;1;1
17071; 24.5 ; 220.9 ; 15.9 ;9;37;104;0;9;2;7;7;2;6;3;0
17072; 32.4 ; 258.9 ; 4.4 ;8;46;5;0;8;0;8;7;1;3;5;0
17073; 20.7 ; 41.5 ; 8.6 ;2;18;62;0;2;0;2;2;0;2;0;0
17074; 80.4 ; 241.3 ; 17.6 ;3;25;225;0;3;0;3;1;2;0;0;3
17075; 66.0 ; 593.9 ; 14.6 ;9;39;50;0;9;3;6;9;0;0;0;9
17076; 17.8 ; 160.0 ; 2.8 ;9;7;0;1;8;0;9;8;1;9;0;0
17077; 26.5 ; 370.3 ; 14.9 ;14;13;31;0;14;9;5;3;11;9;5;0
17078; 28.8 ; 201.8 ; 8.4 ;7;32;53;0;7;3;4;5;2;5;2;0
17079; 22.2 ; 378.0 ; 9.8 ;17;16;9;0;17;8;9;7;10;11;6;0
17080; 25.1 ; 75.4 ; 2.6 ;3;63;209;0;3;1;2;3;0;3;0;0
17081; 56.3 ; 169.0 ; 10.6 ;3;63;62;3;0;0;3;3;0;0;0;3
17082; 22.0 ; 87.8 ; 7.2 ;4;23;133;2;2;4;0;3;1;4;0;0
17083; 55.5 ; 111.0 ; 9.2 ;2;14;68;2;0;0;2;2;0;0;0;2
17084; 22.2 ; 44.4 ; 1.6 ;2;50;210;0;2;0;2;2;0;2;0;0
17085; 22.6 ; 45.2 ; 11.4 ;2;9;97;2;0;1;1;1;1;1;1;0
17086; 41.0 ; 491.9 ; 10.6 ;12;16;30;0;12;5;7;5;7;0;12;0
17087; 30.5 ; 61.1 ; 0.5 ;2;37;5;1;1;0;2;2;0;0;2;0
17088; 45.3 ; 678.9 ; 21.5 ;15;20;1;0;15;8;7;7;8;5;5;5
17089; 30.8 ; 61.7 ; 8.6 ;2;56;110;2;0;0;2;2;0;1;1;0
17090; 42.1 ; 126.3 ; 13.2 ;3;10;276;0;3;2;1;1;2;1;1;1
17091; 59.0 ; 177.1 ; 23.0 ;3;61;152;0;3;1;2;2;1;0;0;3
17092; 78.7 ; 157.3 ; -   ;2;3;126;0;2;1;1;1;1;0;0;2
17093; 54.0 ; 323.9 ; 17.1 ;6;40;10;0;6;3;3;2;4;0;4;2
17094; 28.6 ; 114.3 ; 14.0 ;4;87;97;0;4;1;3;1;3;3;1;0
17095; 32.0 ; 127.8 ; 10.8 ;4;103;8;1;3;3;1;2;2;1;3;0
17096; 26.4 ; 289.9 ; 2.4 ;11;14;32;0;11;5;6;9;2;11;0;0
17097; 27.6 ; 165.9 ; 14.7 ;6;41;79;3;3;1;5;4;2;4;2;0
17098; 15.0 ; 119.9 ; -   ;8;40;21;0;8;0;8;6;2;8;0;0
17099; 19.0 ; 152.3 ; 4.6 ;8;13;50;0;8;4;4;4;4;8;0;0
17100; 44.6 ; 535.3 ; 4.9 ;12;32;32;0;12;1;11;2;10;0;12;0
17101; 70.8 ; 141.7 ; 33.9 ;2;293;22;0;2;0;2;2;0;0;0;2
17102; 63.6 ; 190.7 ; 12.2 ;3;9;233;0;3;1;2;1;2;0;0;3
17103; 52.5 ; 472.5 ; 10.2 ;9;34;15;0;9;2;7;7;2;0;6;3
17104; 19.1 ; 95.6 ; 10.3 ;5;29;254;0;5;2;3;4;1;5;0;0
17105; 120.2 ; 360.7 ; 29.7 ;3;90;42;0;3;1;2;1;2;0;0;3
17106; 35.4 ; 141.6 ; 9.5 ;4;5;0;1;3;2;2;2;2;1;3;0
17107; 38.7 ; 116.1 ; 3.8 ;3;13;168;0;3;0;3;1;2;0;3;0
17108; 41.3 ; 165.2 ; 15.5 ;4;17;236;0;4;0;4;4;0;1;2;1
17109; 46.0 ; 229.8 ; 12.4 ;5;40;47;0;5;0;5;5;0;0;3;2
17110; 20.4 ; 244.9 ; 2.3 ;12;23;55;0;12;11;1;3;9;12;0;0
17111; 15.0 ; 59.9 ; -   ;4;14;312;0;4;3;1;2;2;4;0;0
17112; 55.5 ; 332.9 ; 7.3 ;6;49;39;0;6;3;3;3;3;0;0;6
17113; 23.6 ; 283.5 ; 8.4 ;12;18;20;0;12;1;11;8;4;8;4;0
17114; 51.7 ; 620.3 ; 12.0 ;12;32;0;0;12;0;12;11;1;0;8;4
17115; 58.9 ; 176.8 ; 28.1 ;3;44;36;3;0;0;3;2;1;0;0;3
17116; 29.8 ; 119.3 ; 17.9 ;4;53;8;0;4;1;3;3;1;3;1;0
17117; 71.1 ; 142.2 ; 11.8 ;2;13;99;0;2;0;2;2;0;0;0;2
17118; 37.2 ; 446.9 ; 14.6 ;12;17;42;0;12;4;8;11;1;4;8;0
17119; 16.5 ; 66.1 ; 2.3 ;4;43;8;0;4;2;2;4;0;4;0;0
17120; 39.4 ; 78.9 ; 21.5 ;2;48;129;0;2;1;1;1;1;1;0;1
17121; 32.0 ; 160.0 ; 10.1 ;5;43;4;0;5;3;2;3;2;2;3;0
17122; 21.8 ; 65.3 ; 7.7 ;3;52;122;0;3;0;3;2;1;3;0;0
17123; 61.5 ; 184.6 ; 9.8 ;3;34;205;0;3;0;3;3;0;0;0;3
17124; 33.7 ; 101.2 ; 8.3 ;3;58;77;0;3;2;1;1;2;1;2;0
17125; 20.9 ; 375.3 ; 7.8 ;18;17;66;0;18;4;14;14;4;18;0;0
17126; 35.0 ; 174.9 ; 1.3 ;5;32;137;0;5;1;4;5;0;0;5;0
17127; 24.5 ; 318.1 ; 10.9 ;13;35;15;0;13;2;11;9;4;9;4;0
17128; 50.6 ; 253.1 ; 18.8 ;5;18;20;0;5;0;5;4;1;0;3;2
17129; 47.3 ; 94.7 ; 48.4 ;2;91;197;0;2;1;1;2;0;1;0;1
17130; 98.8 ; 395.3 ; 71.4 ;4;64;87;0;4;3;1;2;2;1;0;3
17131; 49.2 ; 147.6 ; 21.0 ;3;14;188;3;0;3;0;1;2;1;1;1
17132; 56.5 ; 1,016.2 ; 16.8 ;18;23;22;0;18;0;18;14;4;0;0;18
17133; 249.9 ; 499.9 ; 209.0 ;2;9;96;0;2;1;1;2;0;0;0;2
17134; 44.7 ; 134.0 ; 27.3 ;3;65;227;0;3;1;2;3;0;1;1;1
17135; 46.8 ; 280.8 ; 11.1 ;6;18;190;0;6;2;4;2;4;0;4;2
17136; 56.2 ; 112.4 ; 11.2 ;2;144;62;0;2;0;2;1;1;0;0;2
17137; 51.8 ; 466.3 ; 19.5 ;9;24;110;0;9;0;9;5;4;0;6;3
17138; 56.0 ; 224.0 ; 63.2 ;4;8;147;0;4;1;3;2;2;1;0;3
17139; 44.8 ; 627.4 ; 17.8 ;14;5;142;0;14;0;14;10;4;5;4;5
17140; 29.6 ; 148.1 ; 12.0 ;5;32;142;0;5;1;4;1;4;3;2;0
17141; 84.0 ; 167.9 ; 20.1 ;2;6;210;0;2;0;2;0;2;0;0;2
17142; 58.6 ; 117.2 ; 10.5 ;2;41;211;0;2;1;1;2;0;0;0;2
17143; 32.0 ; 287.9 ; 11.6 ;9;27;1;0;9;6;3;4;5;3;6;0
17144; 15.0 ; 104.9 ; -   ;7;30;8;0;7;4;3;6;1;7;0;0
17145; 38.3 ; 536.8 ; 29.3 ;14;22;2;0;14;6;8;10;4;5;4;5
17146; 33.2 ; 497.4 ; 14.8 ;15;28;1;0;15;3;12;4;11;5;10;0
17147; 77.0 ; 539.0 ; 32.9 ;7;13;118;0;7;2;5;4;3;0;0;7
17148; 20.5 ; 286.3 ; 9.0 ;14;22;26;0;14;4;10;3;11;14;0;0
17149; 32.8 ; 98.5 ; 15.5 ;3;43;221;0;3;0;3;3;0;1;2;0
17150; 46.9 ; 562.8 ; 5.5 ;12;24;26;0;12;1;11;10;2;0;12;0
17151; 46.8 ; 140.3 ; -   ;3;58;112;0;3;2;1;1;2;0;3;0
17152; 21.3 ; 106.5 ; 8.9 ;5;17;93;0;5;2;3;4;1;3;2;0
17153; 41.2 ; 164.8 ; 39.5 ;4;10;43;0;4;0;4;3;1;1;2;1
17154; 27.7 ; 55.5 ; 4.0 ;2;8;21;0;2;1;1;0;2;1;1;0
17155; 54.3 ; 108.6 ; 36.7 ;2;28;197;0;2;1;1;1;1;1;0;1
17156; 49.0 ; 98.0 ; 0.5 ;2;175;59;0;2;0;2;1;1;0;2;0
17157; 41.9 ; 795.5 ; 11.9 ;19;18;17;0;19;9;10;17;2;6;13;0
17158; 42.1 ; 84.1 ; 25.5 ;2;87;318;0;2;2;0;0;2;1;0;1
17159; 25.1 ; 250.7 ; -   ;10;13;55;0;10;10;0;1;9;10;0;0
17160; 40.1 ; 160.5 ; 5.5 ;4;41;94;0;4;1;3;3;1;0;4;0
17161; 16.4 ; 98.5 ; 4.0 ;6;36;2;0;6;5;1;1;5;6;0;0
17162; 45.7 ; 91.5 ; 16.9 ;2;59;146;0;2;1;1;0;2;1;0;1
17163; 30.8 ; 61.7 ; 8.6 ;2;69;121;0;2;0;2;0;2;1;1;0
17164; 61.5 ; 123.0 ; -   ;2;91;146;0;2;2;0;0;2;0;0;2
17165; 49.9 ; 99.8 ; 26.9 ;2;1;107;0;2;2;0;0;2;1;0;1
17166; 36.3 ; 72.5 ; 16.8 ;2;23;98;0;2;1;1;1;1;1;1;0
17167; 38.2 ; 114.7 ; 7.7 ;3;130;50;0;3;2;1;3;0;0;3;0
17168; 49.7 ; 645.7 ; 14.2 ;13;25;17;0;13;3;10;5;8;0;9;4
17169; 19.9 ; 199.3 ; 12.0 ;10;26;85;0;10;8;2;10;0;7;3;0
17170; 26.1 ; 104.2 ; 5.8 ;4;1;121;0;4;2;2;1;3;3;1;0
17171; 20.0 ; 40.1 ; 7.6 ;2;3;246;0;2;1;1;2;0;2;0;0
17172; 44.7 ; 89.3 ; 20.3 ;2;12;204;0;2;0;2;2;0;1;0;1
17173; 15.0 ; 45.0 ; -   ;3;18;98;0;3;3;0;3;0;3;0;0
17174; 18.1 ; 415.2 ; 4.4 ;23;8;5;0;23;14;9;11;12;23;0;0
17175; 47.8 ; 95.7 ; 0.5 ;2;26;17;0;2;2;0;0;2;0;2;0
17176; 35.6 ; 71.1 ; 30.8 ;2;14;125;0;2;1;1;1;1;1;0;1
17177; 29.1 ; 320.0 ; 10.8 ;11;14;5;0;11;5;6;3;8;7;4;0
17178; 38.3 ; 115.0 ; 22.8 ;3;1;20;3;0;2;1;1;2;1;1;1
17179; 31.7 ; 95.2 ; 15.4 ;3;49;32;0;3;0;3;1;2;1;2;0
17180; 61.9 ; 123.8 ; 0.5 ;2;105;69;2;0;0;2;2;0;0;0;2
17181; 54.4 ; 816.1 ; 24.7 ;15;22;110;0;15;3;12;3;12;5;5;5
17182; 18.3 ; 55.0 ; 6.2 ;3;7;230;0;3;1;2;3;0;3;0;0
17183; 22.7 ; 45.5 ; 3.5 ;2;17;278;0;2;1;1;2;0;2;0;0
17184; 41.7 ; 83.4 ; 7.6 ;2;20;255;0;2;1;1;0;2;0;2;0
17185; 47.4 ; 94.8 ; 11.9 ;2;1;173;0;2;1;1;1;1;0;1;1
17186; 56.6 ; 282.9 ; 29.3 ;5;79;36;0;5;0;5;3;2;2;0;3
17187; 61.6 ; 308.1 ; 40.6 ;5;55;126;0;5;0;5;4;1;2;0;3
17188; 47.5 ; 94.9 ; 1.1 ;2;203;20;1;1;0;2;1;1;0;2;0
17189; 41.3 ; 124.0 ; 15.3 ;3;22;158;0;3;1;2;1;2;1;1;1
17190; 50.9 ; 203.5 ; 22.2 ;4;20;218;0;4;1;3;2;2;1;2;1
17191; 34.3 ; 171.4 ; 12.5 ;5;30;61;0;5;3;2;5;0;2;3;0
17192; 54.9 ; 494.5 ; 16.0 ;9;43;31;0;9;6;3;2;7;0;6;3
17193; 78.2 ; 156.3 ; 5.1 ;2;131;73;0;2;0;2;1;1;0;0;2
17194; 20.0 ; 239.6 ; 7.2 ;12;21;17;0;12;5;7;2;10;12;0;0
17195; 41.5 ; 166.1 ; 26.6 ;4;67;15;0;4;2;2;2;2;1;2;1
17196; 20.1 ; 601.8 ; 11.4 ;30;13;16;0;30;12;18;16;14;20;10;0
17197; 47.8 ; 95.7 ; 0.5 ;2;11;21;2;0;0;2;1;1;0;2;0
17198; 46.8 ; 93.5 ; -   ;2;51;221;0;2;0;2;1;1;0;2;0
17199; 33.2 ; 132.7 ; 6.8 ;4;9;158;0;4;3;1;1;3;1;3;0
17200; 50.9 ; 203.4 ; 7.7 ;4;75;86;3;1;2;2;3;1;0;3;1
17201; 54.0 ; 161.9 ; 30.0 ;3;47;58;0;3;0;3;1;2;1;1;1
17202; 51.8 ; 103.6 ; 6.5 ;2;176;41;1;1;0;2;2;0;0;1;1
17203; 15.0 ; 30.0 ; -   ;2;45;5;0;2;0;2;2;0;2;0;0
17204; 72.4 ; 289.7 ; 38.8 ;4;18;101;4;0;0;4;2;2;0;0;4
17205; 41.8 ; 125.3 ; 1.7 ;3;4;41;0;3;0;3;2;1;0;3;0
17206; 62.3 ; 249.2 ; 28.0 ;4;53;245;0;4;1;3;3;1;0;0;4
17207; 52.4 ; 314.3 ; 15.4 ;6;40;8;0;6;1;5;2;4;0;4;2
17208; 33.4 ; 66.7 ; 23.0 ;2;296;32;0;2;0;2;2;0;1;0;1
17209; 41.7 ; 208.4 ; 5.9 ;5;44;78;0;5;0;5;5;0;0;5;0
17210; 15.0 ; 30.0 ; -   ;2;16;235;0;2;2;0;2;0;2;0;0
17211; 37.9 ; 265.3 ; 13.3 ;7;45;16;0;7;2;5;4;3;2;5;0
17212; 46.6 ; 93.3 ; 32.3 ;2;25;26;0;2;0;2;0;2;1;0;1
17213; 34.3 ; 68.6 ; 19.7 ;2;252;62;0;2;0;2;1;1;1;1;0
17214; 15.5 ; 61.8 ; 1.0 ;4;16;220;0;4;2;2;3;1;4;0;0
17215; 28.4 ; 539.1 ; 14.9 ;19;14;5;1;18;5;14;7;12;13;6;0
17216; 35.4 ; 531.7 ; 11.1 ;15;20;0;0;15;5;10;5;10;5;10;0
17217; 38.1 ; 152.6 ; 16.5 ;4;25;2;4;0;2;2;4;0;1;3;0
17218; 35.6 ; 71.1 ; 8.0 ;2;43;242;0;2;0;2;1;1;1;1;0
17219; 33.4 ; 167.2 ; 25.7 ;5;16;257;0;5;1;4;4;1;2;1;2
17220; 27.8 ; 139.0 ; 12.3 ;5;23;184;0;5;1;4;1;4;3;2;0
17221; 40.0 ; 120.0 ; 13.7 ;3;31;27;3;0;1;2;2;1;1;2;0
17222; 31.0 ; 154.8 ; 13.0 ;5;34;256;0;5;2;3;3;2;2;3;0
17223; 19.4 ; 116.7 ; 7.9 ;6;17;272;0;6;1;5;4;2;6;0;0
17224; 47.7 ; 95.4 ; 1.4 ;2;22;241;0;2;1;1;2;0;0;2;0
17225; 40.6 ; 527.6 ; 16.4 ;13;20;7;0;13;10;3;2;11;4;5;4
17226; 15.0 ; 254.8 ; -   ;17;11;0;0;17;8;9;7;10;17;0;0
17227; 53.9 ; 107.8 ; 43.1 ;2;1;146;0;2;1;1;0;2;1;0;1
17228; 79.4 ; 158.9 ; 8.6 ;2;5;200;0;2;0;2;1;1;0;0;2
17229; 18.9 ; 227.0 ; 8.0 ;12;13;146;0;12;7;5;5;7;12;0;0
17230; 21.7 ; 260.1 ; 10.1 ;12;22;57;0;12;2;10;5;7;8;4;0
17231; 55.0 ; 275.2 ; 20.0 ;5;42;48;0;5;1;4;1;4;0;0;5
17232; 46.5 ; 232.4 ; 11.5 ;5;53;19;0;5;2;3;2;3;0;3;2
17233; 41.3 ; 165.1 ; 17.2 ;4;98;86;0;4;2;2;4;0;1;2;1
17234; 17.2 ; 103.1 ; 3.0 ;6;12;3;0;6;0;6;4;2;6;0;0
17235; 32.5 ; 195.1 ; 9.7 ;6;9;51;0;6;4;2;2;4;2;4;0
17236; 21.8 ; 43.7 ; 4.9 ;2;6;16;0;2;0;2;1;1;2;0;0
17237; 25.0 ; 225.3 ; 12.8 ;9;23;68;0;9;2;7;6;3;6;3;0
17238; 21.1 ; 147.7 ; 15.9 ;7;23;24;0;7;4;3;3;4;5;2;0
17239; 30.2 ; 392.4 ; 11.4 ;13;12;137;0;13;5;8;11;2;4;9;0
17240; 25.4 ; 76.3 ; 0.7 ;3;5;242;0;3;0;3;1;2;3;0;0
17241; 47.0 ; 375.9 ; 10.2 ;8;11;3;0;8;6;2;1;7;0;5;3
17242; 37.5 ; 112.5 ; 28.6 ;3;89;92;0;3;2;1;3;0;1;1;1
17243; 35.6 ; 1,247.1 ; 27.5 ;35;9;30;0;35;18;17;23;12;12;11;12
17244; 42.1 ; 126.2 ; 5.4 ;3;23;172;0;3;2;1;1;2;0;3;0
17245; 24.1 ; 96.5 ; 5.2 ;4;19;116;0;4;2;2;4;0;4;0;0
17246; 58.8 ; 176.4 ; 36.2 ;3;47;183;0;3;0;3;3;0;1;0;2
17247; 46.9 ; 140.7 ; 0.5 ;3;184;93;1;2;1;2;1;2;0;3;0
17248; 27.1 ; 81.3 ; 3.7 ;3;8;194;3;0;2;1;3;0;2;1;0
17249; 48.9 ; 195.7 ; 3.1 ;4;11;72;0;4;2;2;2;2;0;4;0
17250; 24.5 ; 73.5 ; 6.3 ;3;2;89;0;3;2;1;1;2;2;1;0
17251; 30.1 ; 60.2 ; 22.6 ;2;114;56;1;1;1;1;2;0;1;1;0
17252; 49.9 ; 149.8 ; 45.6 ;3;122;59;0;3;1;2;1;2;1;1;1
17253; 46.8 ; 93.5 ; -   ;2;38;129;0;2;2;0;2;0;0;2;0
17254; 52.0 ; 260.1 ; 58.1 ;5;19;171;0;5;4;1;3;2;2;1;2
17255; 48.0 ; 528.4 ; 22.7 ;11;32;10;0;11;0;11;8;3;4;3;4
17256; 55.1 ; 936.5 ; 21.7 ;17;17;5;0;17;0;17;14;3;0;0;17
17257; 42.6 ; 85.3 ; 9.1 ;2;32;288;0;2;0;2;1;1;0;2;0
17258; 22.5 ; 360.7 ; 10.4 ;16;18;11;0;16;10;6;2;14;11;5;0
17259; 41.6 ; 249.6 ; 10.0 ;6;43;128;0;6;4;2;0;6;0;6;0
17260; 37.0 ; 148.0 ; 13.5 ;4;93;20;0;4;2;2;1;3;1;3;0
17261; 29.1 ; 320.1 ; 18.3 ;11;6;43;0;11;4;7;7;4;7;4;0
17262; 26.9 ; 107.6 ; 15.8 ;4;13;278;0;4;2;2;4;0;3;1;0
17263; 26.0 ; 77.9 ; 7.3 ;3;9;100;0;3;0;3;0;3;2;1;0
17264; 50.1 ; 200.6 ; 1.8 ;4;55;137;0;4;2;2;2;2;0;4;0
17265; 48.4 ; 145.1 ; 15.8 ;3;88;109;0;3;1;2;2;1;0;2;1
17266; 29.6 ; 88.7 ; 18.3 ;3;34;186;0;3;1;2;0;3;2;1;0
17267; 20.6 ; 41.1 ; 3.0 ;2;74;134;0;2;2;0;2;0;2;0;0
17268; 53.2 ; 106.5 ; -   ;2;69;26;0;2;0;2;2;0;0;2;0
17269; 31.4 ; 62.9 ; 3.2 ;2;232;37;0;2;0;2;1;1;1;1;0
17270; 38.8 ; 155.3 ; 17.9 ;4;35;98;0;4;2;2;2;2;1;2;1
17271; 46.9 ; 328.5 ; 0.4 ;7;10;86;0;7;2;5;4;3;0;7;0
17272; 23.5 ; 70.5 ; 12.9 ;3;90;83;0;3;1;2;3;0;2;1;0
17273; 22.5 ; 765.9 ; 10.1 ;34;5;0;0;34;10;24;16;18;23;11;0
17274; 32.1 ; 739.2 ; 15.0 ;23;19;20;0;23;3;20;8;15;8;15;0
17275; 52.8 ; 105.7 ; 31.3 ;2;11;38;0;2;0;2;1;1;1;0;1
17276; 61.2 ; 244.9 ; 10.9 ;4;40;104;0;4;0;4;2;2;0;0;4
17277; 25.5 ; 408.5 ; 12.4 ;16;12;8;3;13;6;10;8;8;11;5;0
17278; 48.8 ; 244.2 ; 11.8 ;5;35;31;0;5;0;5;3;2;0;3;2
17279; 46.8 ; 93.5 ; -   ;2;29;342;0;2;0;2;0;2;0;2;0
17280; 42.6 ; 85.3 ; 9.1 ;2;100;89;2;0;0;2;0;2;0;2;0
17281; 48.3 ; 386.6 ; 15.5 ;8;28;93;0;8;2;6;3;5;0;5;3
17282; 46.8 ; 280.5 ; 1.4 ;6;28;23;1;5;3;3;1;5;0;6;0
17283; 27.6 ; 137.9 ; 7.8 ;5;39;89;0;5;2;3;3;2;3;2;0
17284; 18.0 ; 36.1 ; 4.6 ;2;158;5;0;2;0;2;2;0;2;0;0
17285; 21.5 ; 43.0 ; 0.2 ;2;118;128;0;2;1;1;2;0;2;0;0
17286; 43.7 ; 218.5 ; 0.2 ;5;22;0;0;5;0;5;5;0;0;5;0
17287; 22.1 ; 110.5 ; 11.4 ;5;14;245;0;5;3;2;3;2;3;2;0
17288; 25.4 ; 152.6 ; 12.5 ;6;18;63;0;6;2;4;1;5;4;2;0
17289; 50.2 ; 150.6 ; 25.6 ;3;67;267;0;3;0;3;3;0;1;1;1
17290; 17.3 ; 415.8 ; 3.2 ;24;14;11;0;24;12;12;10;14;24;0;0
17291; 39.4 ; 78.8 ; 13.8 ;2;113;36;1;1;0;2;0;2;1;1;0
17292; 21.2 ; 42.4 ; 2.3 ;2;68;161;0;2;2;0;0;2;2;0;0
17293; 20.0 ; 40.1 ; 7.6 ;2;24;146;0;2;2;0;0;2;2;0;0
17294; 15.0 ; 45.0 ; -   ;3;122;9;0;3;2;1;1;2;3;0;0
17295; 33.7 ; 101.1 ; 14.4 ;3;86;188;0;3;1;2;2;1;1;2;0
17296; 41.7 ; 83.4 ; 7.6 ;2;7;356;0;2;0;2;0;2;0;2;0
17297; 51.2 ; 256.1 ; 15.1 ;5;14;117;0;5;1;4;3;2;0;3;2
17298; 24.6 ; 73.8 ; 6.2 ;3;9;84;0;3;1;2;2;1;2;1;0
17299; 95.0 ; 190.0 ; 59.9 ;2;101;38;0;2;0;2;0;2;0;0;2
17300; 53.6 ; 107.1 ; 35.0 ;2;32;195;0;2;1;1;2;0;1;0;1
17301; 28.2 ; 169.4 ; 12.5 ;6;55;44;0;6;5;1;4;2;4;2;0
17302; 18.6 ; 37.2 ; -   ;2;28;207;1;1;1;1;1;1;2;0;0
17303; 68.0 ; 951.8 ; 29.8 ;14;28;32;0;14;0;14;14;0;0;0;14
17304; 30.8 ; 61.7 ; 8.6 ;2;6;269;0;2;2;0;1;1;1;1;0
17305; 39.3 ; 78.7 ; 14.0 ;2;68;30;0;2;2;0;1;1;1;1;0
17306; 34.4 ; 275.5 ; 11.5 ;8;25;95;0;8;6;2;8;0;3;5;0
17307; 63.4 ; 443.7 ; 27.2 ;7;59;37;0;7;0;7;7;0;0;0;7
17308; 48.7 ; 97.4 ; -   ;2;109;171;0;2;1;1;1;1;0;2;0
17309; 36.6 ; 73.2 ; -   ;2;48;161;0;2;1;1;0;2;0;2;0
17310; 35.6 ; 213.7 ; 20.3 ;6;14;186;0;6;6;0;0;6;2;2;2
17311; 15.0 ; 74.9 ; -   ;5;20;95;0;5;0;5;1;4;5;0;0
17312; 80.8 ; 404.2 ; 13.6 ;5;57;31;0;5;0;5;4;1;0;0;5
17313; 19.2 ; 38.5 ; 6.4 ;2;11;30;0;2;2;0;0;2;2;0;0
17314; 42.2 ; 126.6 ; 15.7 ;3;76;24;0;3;1;2;0;3;1;1;1
17315; 30.2 ; 60.4 ; 16.3 ;2;5;3;0;2;2;0;2;0;1;1;0
17316; 43.8 ; 218.9 ; 19.1 ;5;51;11;0;5;0;5;5;0;2;1;2
17317; 38.5 ; 76.9 ; 12.4 ;2;38;141;0;2;0;2;2;0;1;1;0
17318; 44.2 ; 132.5 ; 2.4 ;3;54;126;2;1;1;2;2;1;0;3;0
17319; 19.7 ; 39.5 ; -   ;2;47;230;0;2;1;1;2;0;2;0;0
17320; 15.0 ; 30.0 ; -   ;2;13;299;0;2;0;2;2;0;2;0;0
17321; 30.9 ; 123.5 ; 14.9 ;4;101;47;0;4;1;3;4;0;1;3;0
17322; 30.9 ; 61.7 ; 23.8 ;2;1;121;0;2;1;1;0;2;1;1;0
17323; 44.8 ; 627.4 ; 14.1 ;14;13;8;0;14;2;12;3;11;0;9;5
17324; 21.9 ; 1,027.9 ; 11.7 ;47;5;16;0;47;9;38;21;26;31;16;0
17325; 100.9 ; 201.8 ; 107.1 ;2;149;232;0;2;1;1;1;1;1;0;1
17326; 58.0 ; 290.1 ; 24.8 ;5;50;82;0;5;0;5;3;2;0;0;5
17327; 37.7 ; 188.3 ; 7.5 ;5;45;79;0;5;0;5;4;1;0;5;0
17328; 41.0 ; 81.9 ; 32.2 ;2;14;83;0;2;1;1;2;0;1;0;1
17329; 42.5 ; 169.9 ; 26.9 ;4;17;52;0;4;0;4;3;1;1;2;1
17330; 39.1 ; 352.2 ; 41.1 ;9;27;62;0;9;2;7;6;3;3;3;3
17331; 15.8 ; 362.5 ; 2.9 ;23;13;8;0;23;12;11;12;11;23;0;0
17332; 24.6 ; 98.6 ; 9.7 ;4;59;95;0;4;1;3;1;3;3;1;0
17333; 28.2 ; 479.0 ; 10.3 ;17;14;2;0;17;14;3;15;2;11;6;0
17334; 25.8 ; 154.5 ; 23.9 ;6;26;7;6;0;2;4;6;0;4;2;0
17335; 33.2 ; 365.2 ; 4.5 ;11;31;37;0;11;2;9;11;0;4;7;0
17336; 39.9 ; 478.3 ; 6.7 ;12;24;0;0;12;10;2;2;10;0;12;0
17337; 35.6 ; 71.1 ; 8.0 ;2;149;33;1;1;1;1;0;2;1;1;0
17338; 37.9 ; 113.8 ; 17.4 ;3;24;216;0;3;1;2;1;2;1;1;1
17339; 28.3 ; 368.5 ; 17.6 ;13;32;2;0;13;7;6;10;3;9;4;0
17340; 25.1 ; 75.2 ; -   ;3;68;35;0;3;3;0;1;2;3;0;0
17341; 32.7 ; 98.1 ; 9.7 ;3;55;55;0;3;1;2;2;1;1;2;0
17342; 47.7 ; 143.1 ; 0.4 ;3;31;10;0;3;0;3;3;0;0;3;0
17343; 26.5 ; 79.5 ; 4.8 ;3;41;99;0;3;0;3;2;1;2;1;0
17344; 62.3 ; 498.6 ; 29.2 ;8;38;10;0;8;3;5;5;3;0;0;8
17345; 30.3 ; 151.5 ; 16.6 ;5;39;13;0;5;4;1;5;0;2;3;0
17346; 44.8 ; 89.6 ; 2.9 ;2;64;104;2;0;0;2;2;0;0;2;0
17347; 37.6 ; 525.7 ; 20.7 ;14;18;78;0;14;2;12;7;7;5;4;5
17348; 30.7 ; 61.4 ; 1.1 ;2;13;59;0;2;1;1;0;2;1;1;0
17349; 27.2 ; 54.5 ; 11.2 ;2;58;117;0;2;2;0;1;1;1;1;0
17350; 68.8 ; 206.4 ; 35.2 ;3;21;44;0;3;1;2;2;1;0;0;3
17351; 22.4 ; 112.0 ; 9.7 ;5;38;5;0;5;0;5;4;1;3;2;0
17352; 35.2 ; 140.8 ; 16.5 ;4;6;17;0;4;3;1;4;0;1;3;0
17353; 41.5 ; 207.3 ; 13.7 ;5;18;111;0;5;1;4;4;1;2;1;2
17354; 52.1 ; 104.2 ; 8.0 ;2;7;267;0;2;0;2;2;0;0;1;1
17355; 39.7 ; 714.1 ; 16.9 ;18;11;8;0;18;5;13;9;9;6;6;6
17356; 45.6 ; 228.1 ; 5.4 ;5;69;36;0;5;3;2;5;0;0;5;0
17357; 81.0 ; 162.1 ; 20.8 ;2;109;1;0;2;1;1;1;1;0;0;2
17358; 126.1 ; 252.2 ; 99.6 ;2;1;215;0;2;0;2;1;1;1;0;1
17359; 32.4 ; 64.8 ; 10.9 ;2;8;35;0;2;1;1;2;0;1;1;0
17360; 57.4 ; 114.8 ; 8.7 ;2;21;152;0;2;1;1;1;1;0;0;2
17361; 41.0 ; 492.5 ; 12.3 ;12;25;5;0;12;5;7;4;8;4;8;0
17362; 38.5 ; 76.9 ; 15.5 ;2;12;58;0;2;0;2;1;1;1;1;0
17363; 33.3 ; 199.8 ; 6.0 ;6;11;239;0;6;4;2;1;5;2;4;0
17364; 32.8 ; 98.3 ; 7.0 ;3;14;252;0;3;2;1;1;2;1;2;0
17365; 22.2 ; 110.8 ; 14.3 ;5;22;99;0;5;1;4;0;5;3;2;0
17366; 25.6 ; 102.2 ; 15.2 ;4;9;249;0;4;3;1;1;3;3;1;0
17367; 39.1 ; 1,837.7 ; 27.1 ;47;5;7;0;47;24;23;25;22;16;15;16
17368; 27.0 ; 107.9 ; 15.3 ;4;18;217;0;4;1;3;1;3;3;1;0
17369; 63.5 ; 1,270.6 ; 19.8 ;20;17;0;0;20;6;14;4;16;0;0;20
17370; 56.5 ; 339.2 ; 10.9 ;6;52;40;0;6;0;6;6;0;0;0;6
17371; 30.0 ; 60.0 ; 6.6 ;2;20;249;0;2;2;0;0;2;1;1;0
17372; 59.9 ; 119.7 ; 0.6 ;2;107;162;0;2;0;2;2;0;0;0;2
17373; 70.3 ; 422.0 ; 27.7 ;6;65;12;0;6;1;5;4;2;0;0;6
17374; 32.8 ; 65.7 ; 23.6 ;2;8;172;2;0;1;1;2;0;1;0;1
17375; 43.0 ; 129.1 ; 12.5 ;3;27;269;0;3;2;1;0;3;0;2;1
17376; 39.2 ; 117.5 ; 12.3 ;3;66;14;3;0;3;0;1;2;1;2;0
17377; 17.8 ; 53.4 ; 2.6 ;3;12;259;0;3;2;1;1;2;3;0;0
17378; 46.3 ; 92.7 ; 1.7 ;2;7;26;0;2;0;2;1;1;0;2;0
17379; 31.2 ; 156.2 ; 19.3 ;5;38;149;0;5;1;4;2;3;2;3;0
17380; 56.3 ; 394.0 ; 12.2 ;7;26;5;0;7;5;2;4;3;0;0;7
17381; 61.7 ; 123.5 ; 47.6 ;2;68;263;0;2;0;2;1;1;1;0;1
17382; 42.8 ; 214.2 ; 10.5 ;5;38;11;0;5;0;5;5;0;0;5;0
17383; 25.2 ; 125.8 ; 10.1 ;5;9;102;0;5;3;2;3;2;3;2;0
17384; 56.4 ; 620.4 ; 13.9 ;11;37;52;0;11;1;10;11;0;0;0;11
17385; 41.1 ; 617.2 ; 14.9 ;15;16;5;0;15;2;13;8;7;5;5;5
17386; 56.7 ; 510.3 ; 8.3 ;9;36;121;0;9;0;9;3;6;0;0;9
17387; 47.5 ; 95.1 ; 11.2 ;2;205;150;0;2;2;0;0;2;0;1;1
17388; 18.6 ; 55.7 ; -   ;3;10;78;0;3;0;3;3;0;3;0;0
17389; 30.3 ; 151.6 ; 14.9 ;5;5;272;0;5;2;3;1;4;2;3;0
17390; 41.2 ; 123.7 ; 10.1 ;3;26;192;0;3;2;1;3;0;0;3;0
17391; 18.7 ; 37.5 ; 1.1 ;2;215;53;0;2;1;1;2;0;2;0;0
17392; 80.1 ; 160.1 ; 18.1 ;2;76;183;0;2;0;2;2;0;0;0;2
17393; 48.6 ; 97.2 ; -   ;2;3;262;0;2;1;1;0;2;0;2;0
17394; 22.8 ; 45.7 ; 11.8 ;2;157;84;0;2;0;2;1;1;1;1;0
17395; 33.7 ; 303.4 ; 18.6 ;9;46;55;0;9;4;5;5;4;3;6;0
17396; 20.4 ; 61.1 ; 4.3 ;3;21;5;0;3;1;2;2;1;3;0;0
17397; 18.3 ; 36.5 ; 2.1 ;2;69;93;0;2;1;1;1;1;2;0;0
17398; 59.6 ; 119.2 ; 19.2 ;2;120;115;1;1;0;2;1;1;0;0;2
17399; 22.7 ; 181.7 ; 4.8 ;8;35;28;0;8;4;4;6;2;8;0;0
17400; 23.3 ; 186.3 ; 13.2 ;8;24;231;0;8;7;1;6;2;5;3;0
17401; 41.7 ; 83.4 ; 16.2 ;2;409;11;0;2;0;2;1;1;1;0;1
17402; 46.8 ; 140.3 ; -   ;3;14;236;0;3;1;2;1;2;0;3;0
17403; 37.6 ; 187.8 ; 13.4 ;5;64;20;0;5;0;5;4;1;2;3;0
17404; 17.2 ; 68.9 ; 2.7 ;4;7;269;0;4;4;0;3;1;4;0;0
17405; 40.5 ; 121.5 ; 18.9 ;3;98;95;0;3;2;1;1;2;1;1;1
17406; 47.3 ; 284.0 ; 13.9 ;6;26;68;0;6;2;4;5;1;0;4;2
17407; 26.2 ; 288.1 ; 5.6 ;11;24;36;0;11;3;8;7;4;7;4;0
17408; 25.9 ; 103.6 ; 8.5 ;4;10;327;0;4;1;3;1;3;3;1;0
17409; 41.9 ; 83.7 ; 17.8 ;2;195;108;0;2;2;0;0;2;1;0;1
17410; 41.0 ; 615.4 ; 14.4 ;15;22;22;0;15;1;14;15;0;5;5;5
17411; 15.0 ; 30.0 ; -   ;2;196;115;0;2;0;2;1;1;2;0;0
17412; 20.5 ; 40.9 ; -   ;2;8;258;0;2;1;1;2;0;2;0;0
17413; 95.3 ; 190.7 ; 18.9 ;2;125;157;0;2;0;2;2;0;0;0;2
17414; 29.9 ; 59.8 ; 6.8 ;2;57;221;0;2;1;1;0;2;1;1;0
17415; 25.7 ; 128.3 ; 15.9 ;5;50;105;0;5;2;3;1;4;3;2;0
17416; 38.7 ; 116.1 ; 17.4 ;3;9;4;0;3;3;0;3;0;1;1;1
17417; 31.3 ; 94.0 ; 17.8 ;3;2;46;0;3;1;2;1;2;1;2;0
17418; 123.6 ; 1,112.5 ; 24.9 ;9;35;90;0;9;0;9;9;0;0;0;9
17419; 29.0 ; 260.6 ; 19.1 ;9;18;290;0;9;2;7;3;6;6;3;0
17420; 55.0 ; 275.0 ; 11.9 ;5;41;40;0;5;1;4;4;1;0;0;5
17421; 60.0 ; 120.0 ; 11.2 ;2;2;329;0;2;1;1;0;2;0;0;2
17422; 15.0 ; 45.0 ; -   ;3;45;117;1;2;3;0;3;0;3;0;0
17423; 55.5 ; 665.7 ; 19.1 ;12;34;5;3;9;1;11;12;0;0;0;12
17424; 36.5 ; 803.4 ; 22.2 ;22;19;15;0;22;4;18;17;5;7;8;7
17425; 50.7 ; 1,369.4 ; 3.7 ;27;11;5;0;27;15;12;10;17;0;27;0
17426; 54.0 ; 324.1 ; 14.6 ;6;31;69;0;6;1;5;6;0;0;4;2
17427; 34.1 ; 102.2 ; 3.7 ;3;53;68;0;3;0;3;1;2;0;3;0
17428; 34.3 ; 240.0 ; 16.8 ;7;41;141;0;7;2;5;2;5;2;5;0
17429; 61.9 ; 309.6 ; 27.3 ;5;54;83;0;5;1;4;5;0;0;0;5
17430; 40.1 ; 80.2 ; 32.3 ;2;9;269;0;2;1;1;0;2;1;0;1
17431; 53.7 ; 429.5 ; 16.8 ;8;47;68;0;8;0;8;7;1;0;5;3
17432; 50.9 ; 407.1 ; 11.4 ;8;23;44;8;0;2;6;5;3;0;5;3
17433; 18.5 ; 55.4 ; 0.2 ;3;46;22;3;0;0;3;3;0;3;0;0
17434; 15.0 ; 45.0 ; -   ;3;16;56;3;0;3;0;1;2;3;0;0
17435; 29.4 ; 117.6 ; 3.1 ;4;28;27;0;4;3;1;3;1;3;1;0
17436; 39.4 ; 197.2 ; 28.0 ;5;26;16;0;5;1;4;0;5;2;1;2
17437; 25.5 ; 51.1 ; 6.6 ;2;47;51;0;2;2;0;1;1;1;1;0
17438; 53.4 ; 641.0 ; 9.3 ;12;29;20;0;12;5;7;9;3;0;8;4
17439; 67.1 ; 268.6 ; 40.5 ;4;10;173;0;4;1;3;3;1;1;0;3
17440; 17.1 ; 102.8 ; 6.0 ;6;44;173;0;6;0;6;5;1;6;0;0
17441; 98.5 ; 295.6 ; 38.7 ;3;48;99;0;3;0;3;2;1;0;0;3
17442; 35.7 ; 392.5 ; 14.4 ;11;27;21;0;11;3;8;4;7;4;7;0
17443; 24.8 ; 123.8 ; 8.8 ;5;41;63;0;5;2;3;1;4;3;2;0
17444; 37.0 ; 332.9 ; 7.4 ;9;17;0;0;9;1;8;7;2;3;6;0
17445; 44.4 ; 88.8 ; 44.0 ;2;12;99;0;2;0;2;0;2;1;0;1
17446; 24.7 ; 346.4 ; 7.1 ;14;15;0;0;14;2;12;13;1;9;5;0
17447; 57.4 ; 344.6 ; 10.6 ;6;59;5;0;6;0;6;6;0;0;0;6
17448; 42.6 ; 425.8 ; 59.5 ;10;41;27;0;10;7;3;10;0;3;4;3
17449; 71.1 ; 142.2 ; 33.5 ;2;1;275;0;2;2;0;2;0;0;0;2
17450; 58.9 ; 117.8 ; -   ;2;31;204;0;2;0;2;1;1;0;0;2
17451; 23.2 ; 115.8 ; 11.9 ;5;15;75;0;5;4;1;5;0;3;2;0
17452; 47.1 ; 235.6 ; 0.9 ;5;25;220;0;5;3;2;2;3;0;5;0
17453; 21.8 ; 43.7 ; 4.9 ;2;9;244;0;2;1;1;1;1;2;0;0
17454; 39.7 ; 79.5 ; 4.7 ;2;11;131;1;1;0;2;1;1;0;2;0
17455; 53.6 ; 482.0 ; 38.3 ;9;27;84;0;9;1;8;7;2;3;3;3
17456; 43.9 ; 131.8 ; 5.2 ;3;107;92;0;3;3;0;2;1;0;3;0
17457; 27.9 ; 307.0 ; 7.9 ;11;32;11;0;11;4;7;3;8;7;4;0
17458; 26.4 ; 52.9 ; 5.6 ;2;18;40;0;2;2;0;2;0;1;1;0
17459; 30.0 ; 59.9 ; 22.4 ;2;50;137;2;0;0;2;1;1;1;1;0
17460; 64.4 ; 450.9 ; 23.2 ;7;23;63;0;7;0;7;5;2;0;0;7
17461; 55.9 ; 503.0 ; 41.0 ;9;38;8;0;9;2;7;5;4;3;0;6
17462; 45.6 ; 273.5 ; 7.7 ;6;38;57;0;6;0;6;1;5;0;6;0
17463; 26.2 ; 78.5 ; 10.4 ;3;33;336;0;3;1;2;1;2;2;1;0
17464; 33.2 ; 66.4 ; 5.1 ;2;50;288;0;2;0;2;2;0;1;1;0
17465; 62.8 ; 251.1 ; 24.5 ;4;26;194;0;4;2;2;2;2;0;0;4
17466; 75.7 ; 1,362.6 ; 22.1 ;18;18;4;0;18;11;7;5;13;0;0;18
17467; 16.5 ; 49.6 ; 2.9 ;3;19;239;0;3;3;0;2;1;3;0;0
17468; 25.1 ; 50.1 ; -   ;2;103;82;2;0;1;1;0;2;2;0;0
17469; 37.3 ; 74.6 ; 18.3 ;2;156;247;0;2;0;2;2;0;1;0;1
17470; 40.2 ; 120.7 ; 6.7 ;3;27;92;3;0;3;0;2;1;0;3;0
17471; 52.7 ; 1,738.0 ; 0.4 ;33;13;11;0;33;14;19;15;18;0;33;0
17472; 71.8 ; 430.8 ; 14.5 ;6;60;74;0;6;2;4;5;1;0;0;6
17473; 25.1 ; 125.3 ; -   ;5;68;38;0;5;3;2;5;0;5;0;0
17474; 20.0 ; 59.9 ; 9.2 ;3;81;15;0;3;0;3;1;2;3;0;0
17475; 88.8 ; 177.6 ; 48.1 ;2;1;263;0;2;0;2;2;0;0;0;2
17476; 25.9 ; 259.4 ; 8.4 ;10;17;62;0;10;3;7;8;2;7;3;0
17477; 25.5 ; 407.5 ; 17.3 ;16;20;0;0;16;4;12;4;12;11;5;0
17478; 35.8 ; 286.4 ; 14.5 ;8;47;89;0;8;1;7;2;6;3;5;0
17479; 57.7 ; 115.4 ; 11.4 ;2;6;11;0;2;0;2;1;1;0;0;2
17480; 38.4 ; 76.9 ; 1.9 ;2;15;262;0;2;1;1;1;1;0;2;0
17481; 21.9 ; 109.4 ; 16.3 ;5;62;41;2;3;4;1;5;0;3;2;0
17482; 61.7 ; 308.6 ; 27.2 ;5;19;60;0;5;3;2;2;3;0;0;5
17483; 49.0 ; 98.0 ; 0.5 ;2;86;95;2;0;0;2;2;0;0;2;0
17484; 64.5 ; 580.7 ; 20.8 ;9;35;5;2;7;1;8;9;0;0;0;9
17485; 83.7 ; 167.5 ; 3.8 ;2;12;289;0;2;0;2;1;1;0;0;2
17486; 49.5 ; 99.1 ; 3.1 ;2;1;77;0;2;1;1;0;2;0;2;0
17487; 22.8 ; 137.0 ; 14.0 ;6;45;80;3;3;3;3;4;2;4;2;0
17488; 20.0 ; 240.3 ; 8.6 ;12;9;12;0;12;6;6;3;9;12;0;0
17489; 21.7 ; 238.8 ; 5.3 ;11;7;82;0;11;6;5;3;8;11;0;0
17490; 47.8 ; 95.7 ; 0.5 ;2;62;10;0;2;0;2;2;0;0;2;0
17491; 25.4 ; 76.3 ; 4.8 ;3;83;22;0;3;1;2;1;2;2;1;0
17492; 31.9 ; 255.2 ; 13.8 ;8;15;106;0;8;4;4;7;1;3;5;0
17493; 50.5 ; 101.0 ; 1.4 ;2;24;210;0;2;0;2;1;1;0;2;0
17494; 21.3 ; 42.5 ; 2.3 ;2;8;41;0;2;1;1;1;1;2;0;0
17495; 36.9 ; 775.9 ; 14.6 ;21;17;23;0;21;5;16;4;17;7;14;0
17496; 49.4 ; 148.3 ; 4.9 ;3;12;316;0;3;0;3;3;0;0;3;0
17497; 19.9 ; 278.1 ; 8.6 ;14;7;185;0;14;7;7;2;12;14;0;0
17498; 52.1 ; 989.3 ; 23.9 ;19;22;15;0;19;5;14;7;12;6;7;6
17499; 50.8 ; 101.5 ; 33.9 ;2;46;131;0;2;1;1;2;0;1;0;1
17500; 85.5 ; 171.0 ; 38.2 ;2;108;12;0;2;2;0;0;2;0;0;2
17501; 62.2 ; 124.5 ; 42.9 ;2;73;126;0;2;1;1;0;2;1;0;1
17502; 32.2 ; 451.4 ; 25.6 ;14;15;79;0;14;6;8;3;11;5;4;5
17503; 22.4 ; 515.5 ; 11.5 ;23;14;0;0;23;13;10;5;18;15;8;0
17504; 53.3 ; 1,598.3 ; 33.5 ;30;11;7;0;30;24;6;20;10;10;10;10
17505; 28.6 ; 114.4 ; 13.2 ;4;42;164;0;4;2;2;2;2;3;1;0
17506; 26.5 ; 132.6 ; 12.1 ;5;76;20;0;5;0;5;5;0;3;2;0
17507; 51.2 ; 102.4 ; -   ;2;8;277;0;2;1;1;0;2;0;2;0
17508; 31.8 ; 190.7 ; 14.5 ;6;16;79;0;6;3;3;2;4;2;4;0
17509; 37.1 ; 222.8 ; 9.7 ;6;52;16;0;6;1;5;3;3;2;4;0
17510; 34.1 ; 136.4 ; 8.5 ;4;65;188;0;4;3;1;2;2;1;3;0
17511; 60.9 ; 182.7 ; 22.4 ;3;20;89;0;3;0;3;3;0;0;0;3
17512; 21.1 ; 294.8 ; 9.4 ;14;16;102;0;14;6;8;7;7;9;5;0
17513; 23.9 ; 215.3 ; 13.1 ;9;16;40;0;9;2;7;2;7;6;3;0
17514; 36.6 ; 219.9 ; 17.2 ;6;45;5;0;6;0;6;6;0;2;4;0
17515; 61.8 ; 309.1 ; 32.8 ;5;39;10;0;5;1;4;4;1;2;0;3
17516; 38.5 ; 115.6 ; 15.4 ;3;13;215;0;3;0;3;2;1;1;2;0
17517; 46.1 ; 92.1 ; 14.2 ;2;12;268;0;2;0;2;0;2;0;1;1
17518; 39.2 ; 78.4 ; 13.5 ;2;138;15;0;2;0;2;2;0;1;1;0
17519; 36.5 ; 218.7 ; 12.5 ;6;41;20;0;6;3;3;3;3;2;4;0
17520; 64.9 ; 194.6 ; 20.4 ;3;101;99;0;3;0;3;1;2;0;0;3
17521; 46.8 ; 93.5 ; -   ;2;12;121;0;2;0;2;2;0;0;2;0
17522; 47.1 ; 235.5 ; 0.6 ;5;56;0;0;5;0;5;4;1;0;5;0
17523; 17.4 ; 86.9 ; 2.4 ;5;79;34;0;5;4;1;4;1;5;0;0
17524; 39.0 ; 194.8 ; 13.3 ;5;23;217;0;5;3;2;2;3;2;3;0
17525; 24.7 ; 123.3 ; 11.2 ;5;87;14;3;2;3;2;2;3;3;2;0
17526; 41.6 ; 124.9 ; 18.6 ;3;164;38;0;3;1;2;3;0;1;1;1
17527; 73.2 ; 219.6 ; -   ;3;25;10;0;3;0;3;1;2;0;0;3
17528; 52.5 ; 105.0 ; -   ;2;9;186;0;2;1;1;0;2;0;2;0
17529; 24.4 ; 97.5 ; 9.3 ;4;98;20;0;4;2;2;2;2;3;1;0
17530; 66.0 ; 330.1 ; 45.3 ;5;68;86;0;5;2;3;3;2;2;0;3
17531; 23.1 ; 92.4 ; 17.2 ;4;103;21;0;4;1;3;2;2;3;1;0
17532; 44.2 ; 88.4 ; 6.8 ;2;1;125;0;2;1;1;1;1;0;2;0
17533; 63.4 ; 507.4 ; 9.8 ;8;39;20;0;8;1;7;7;1;0;0;8
17534; 50.2 ; 100.4 ; 5.1 ;2;2;234;0;2;1;1;1;1;0;1;1
17535; 66.4 ; 265.7 ; 25.1 ;4;52;47;0;4;0;4;4;0;0;0;4
17536; 46.6 ; 652.5 ; 7.2 ;14;22;79;0;14;2;12;12;2;0;14;0
17537; 64.8 ; 129.6 ; 43.0 ;2;65;108;0;2;1;1;1;1;1;0;1
17538; 74.5 ; 521.4 ; 38.1 ;7;12;21;0;7;1;6;2;5;0;0;7
17539; 62.7 ; 250.7 ; 57.3 ;4;8;56;0;4;3;1;2;2;1;0;3
17540; 15.0 ; 104.9 ; -   ;7;14;183;0;7;3;4;2;5;7;0;0
17541; 36.6 ; 73.2 ; -   ;2;17;106;0;2;0;2;1;1;0;2;0
17542; 43.8 ; 87.7 ; 20.4 ;2;32;278;0;2;0;2;2;0;1;0;1
17543; 67.5 ; 1,417.6 ; 32.6 ;21;13;37;0;21;9;12;7;14;0;0;21
17544; 41.9 ; 1,046.4 ; 11.4 ;25;8;254;0;25;8;17;7;18;0;25;0
17545; 25.7 ; 77.1 ; 4.8 ;3;10;158;0;3;1;2;0;3;2;1;0
17546; 32.9 ; 98.8 ; 14.4 ;3;121;68;1;2;1;2;2;1;1;2;0
17547; 31.2 ; 468.4 ; 11.6 ;15;6;282;0;15;7;8;10;5;5;10;0
17548; 29.1 ; 87.2 ; 8.0 ;3;22;158;3;0;0;3;3;0;2;1;0
17549; 93.9 ; 657.5 ; 21.9 ;7;29;220;0;7;0;7;7;0;0;0;7
17550; 32.5 ; 227.7 ; 17.2 ;7;24;0;0;7;3;4;1;6;2;5;0
17551; 78.3 ; 313.1 ; 25.0 ;4;34;41;0;4;1;3;2;2;0;0;4
17552; 20.3 ; 142.3 ; 4.6 ;7;20;46;1;6;6;1;6;1;7;0;0
17553; 44.0 ; 132.1 ; 5.5 ;3;43;196;0;3;3;0;1;2;0;3;0
17554; 26.5 ; 159.1 ; 9.6 ;6;55;21;0;6;2;4;3;3;4;2;0
17555; 68.1 ; 272.5 ; 27.5 ;4;3;198;4;0;1;3;3;1;0;0;4
17556; 26.6 ; 186.2 ; 3.0 ;7;17;32;1;6;1;6;2;5;7;0;0
17557; 30.7 ; 61.4 ; 12.0 ;2;272;39;0;2;2;0;0;2;1;1;0
17558; 32.5 ; 195.3 ; 6.6 ;6;28;65;0;6;1;5;3;3;2;4;0
17559; 64.9 ; 259.5 ; 36.4 ;4;104;8;0;4;2;2;2;2;1;0;3
17560; 57.6 ; 115.3 ; 13.4 ;2;33;250;0;2;1;1;1;1;0;0;2
17561; 30.9 ; 61.7 ; 23.8 ;2;232;71;0;2;2;0;1;1;1;1;0
17562; 40.0 ; 919.6 ; 17.0 ;23;18;36;0;23;18;5;21;2;8;7;8
17563; 18.3 ; 55.0 ; 6.2 ;3;122;23;0;3;3;0;3;0;3;0;0
17564; 72.4 ; 217.1 ; 22.3 ;3;56;5;0;3;1;2;3;0;0;0;3
17565; 47.0 ; 141.0 ; 0.4 ;3;202;47;0;3;1;2;3;0;0;3;0
17566; 26.8 ; 187.8 ; 14.3 ;7;40;68;0;7;0;7;6;1;5;2;0
17567; 23.6 ; 70.7 ; 15.7 ;3;76;57;0;3;0;3;3;0;2;1;0
17568; 49.4 ; 197.6 ; 3.1 ;4;59;77;0;4;3;1;2;2;0;4;0
17569; 69.5 ; 139.0 ; 24.3 ;2;49;79;0;2;0;2;2;0;0;0;2
17570; 54.1 ; 216.2 ; 21.5 ;4;16;107;0;4;3;1;1;3;0;3;1
17571; 42.1 ; 210.5 ; 9.5 ;5;23;26;0;5;3;2;2;3;0;5;0
17572; 43.6 ; 87.2 ; 13.4 ;2;78;110;0;2;1;1;2;0;0;1;1
17573; 27.9 ; 279.1 ; 14.9 ;10;7;242;0;10;1;9;10;0;7;3;0
17574; 39.5 ; 158.0 ; 6.1 ;4;82;20;0;4;0;4;4;0;0;4;0
17575; 15.0 ; 59.9 ; -   ;4;68;36;0;4;1;3;4;0;4;0;0
17576; 51.3 ; 153.9 ; 7.0 ;3;66;21;0;3;0;3;3;0;0;2;1
17577; 30.2 ; 60.4 ; -   ;2;9;40;0;2;1;1;0;2;0;2;0
17578; 29.4 ; 58.9 ; 21.6 ;2;112;20;0;2;1;1;1;1;1;1;0
17579; 33.7 ; 101.2 ; 8.2 ;3;6;194;0;3;1;2;3;0;1;2;0
17580; 78.2 ; 234.7 ; 19.1 ;3;4;255;0;3;2;1;2;1;0;0;3
17581; 43.2 ; 129.7 ; 6.9 ;3;115;71;0;3;1;2;1;2;0;3;0
17582; 30.8 ; 61.7 ; 8.6 ;2;34;113;1;1;1;1;1;1;1;1;0
17583; 41.0 ; 164.1 ; 7.5 ;4;69;10;0;4;0;4;4;0;0;4;0
17584; 30.9 ; 154.6 ; 11.2 ;5;53;20;0;5;4;1;2;3;2;3;0
17585; 40.1 ; 120.2 ; -   ;3;21;229;0;3;3;0;1;2;0;3;0
17586; 35.6 ; 178.1 ; 4.8 ;5;67;2;0;5;0;5;3;2;0;5;0
17587; 46.3 ; 185.3 ; 7.1 ;4;58;40;0;4;3;1;2;2;0;4;0
17588; 53.2 ; 106.5 ; -   ;2;5;80;0;2;1;1;0;2;0;2;0
17589; 52.1 ; 260.7 ; 5.5 ;5;53;15;0;5;1;4;3;2;0;3;2
17590; 77.9 ; 155.9 ; 61.9 ;2;115;93;0;2;1;1;1;1;1;0;1
17591; 15.0 ; 30.0 ; -   ;2;12;263;0;2;0;2;1;1;2;0;0
17592; 32.6 ; 162.8 ; 13.6 ;5;17;17;0;5;0;5;0;5;2;3;0
17593; 77.6 ; 310.5 ; 30.1 ;4;29;17;0;4;1;3;3;1;0;0;4
17594; 48.7 ; 243.7 ; 20.0 ;5;50;56;0;5;3;2;5;0;2;1;2
17595; 22.6 ; 45.2 ; 11.4 ;2;20;364;0;2;2;0;1;1;1;1;0
17596; 35.6 ; 213.7 ; 23.5 ;6;32;26;0;6;1;5;3;3;2;2;2
17597; 31.8 ; 190.6 ; 12.2 ;6;38;58;0;6;3;3;4;2;2;4;0
17598; 34.1 ; 68.2 ; 19.4 ;2;50;236;0;2;0;2;2;0;1;1;0
17599; 106.1 ; 212.3 ; 2.4 ;2;32;125;0;2;0;2;2;0;0;0;2
17600; 38.7 ; 77.4 ; 3.2 ;2;34;153;0;2;1;1;0;2;0;2;0
17601; 43.3 ; 259.9 ; 15.0 ;6;43;13;0;6;2;4;5;1;2;2;2
17602; 25.7 ; 179.7 ; 8.2 ;7;26;13;0;7;4;3;5;2;5;2;0
17603; 45.8 ; 91.6 ; 4.4 ;2;25;353;0;2;0;2;2;0;0;2;0
17604; 55.7 ; 389.8 ; 23.0 ;7;36;19;0;7;4;3;3;4;0;0;7
17605; 55.4 ; 110.7 ; 11.8 ;2;50;64;1;1;0;2;0;2;0;0;2
17606; 57.6 ; 172.8 ; 33.9 ;3;90;221;0;3;0;3;1;2;1;0;2
17607; 82.5 ; 165.0 ; 43.8 ;2;12;73;0;2;0;2;2;0;0;0;2
17608; 35.0 ; 280.2 ; 10.9 ;8;24;12;0;8;4;4;4;4;3;5;0
17609; 15.0 ; 30.0 ; -   ;2;41;62;2;0;2;0;0;2;2;0;0
17610; 36.6 ; 256.1 ; -   ;7;26;68;0;7;0;7;7;0;0;7;0
17611; 37.7 ; 150.9 ; 15.5 ;4;17;5;2;2;0;4;4;0;1;3;0
17612; 40.3 ; 201.7 ; 10.9 ;5;61;2;0;5;2;3;0;5;2;3;0
17613; 42.7 ; 213.6 ; 7.5 ;5;12;209;0;5;5;0;0;5;0;5;0
17614; 49.8 ; 4,131.4 ; 28.3 ;83;5;2;0;83;32;51;39;44;28;27;28
17615; 55.6 ; 333.9 ; 17.6 ;6;24;11;0;6;0;6;5;1;0;0;6
17616; 56.4 ; 169.3 ; 5.2 ;3;16;137;0;3;0;3;0;3;0;0;3
17617; 38.5 ; 76.9 ; 12.4 ;2;29;143;0;2;1;1;2;0;1;1;0
17618; 68.0 ; 203.9 ; 18.2 ;3;176;104;0;3;0;3;1;2;0;0;3
17619; 41.7 ; 125.1 ; 10.6 ;3;112;83;0;3;2;1;2;1;0;3;0
17620; 52.1 ; 156.2 ; 5.4 ;3;40;189;0;3;1;2;3;0;0;2;1
17621; 37.6 ; 112.7 ; 22.7 ;3;38;322;0;3;2;1;2;1;1;1;1
17622; 86.6 ; 259.8 ; 61.8 ;3;167;77;0;3;2;1;1;2;1;0;2
17623; 79.4 ; 317.7 ; 43.3 ;4;8;67;0;4;3;1;1;3;0;0;4
17624; 41.7 ; 83.4 ; 17.3 ;2;7;41;0;2;0;2;2;0;1;0;1
17625; 61.6 ; 369.5 ; 24.9 ;6;49;40;0;6;0;6;4;2;0;0;6
17626; 42.6 ; 170.4 ; 8.8 ;4;12;201;0;4;2;2;2;2;0;4;0
17627; 48.8 ; 97.5 ; 0.9 ;2;62;5;0;2;0;2;2;0;0;2;0
17628; 51.7 ; 878.3 ; 23.5 ;17;18;10;0;17;10;7;3;14;6;5;6
17629; 164.9 ; 494.6 ; 17.1 ;3;180;78;2;1;0;3;1;2;0;0;3
17630; 47.3 ; 473.1 ; 0.9 ;10;19;5;0;10;1;9;8;2;0;10;0
17631; 32.6 ; 227.9 ; 28.3 ;7;22;62;0;7;1;6;6;1;2;3;2
17632; 47.4 ; 142.1 ; 4.4 ;3;14;287;0;3;3;0;1;2;0;3;0
17633; 78.9 ; 315.7 ; 20.9 ;4;79;42;0;4;0;4;4;0;0;0;4
17634; 47.9 ; 239.4 ; 9.3 ;5;53;74;0;5;3;2;2;3;0;3;2
17635; 58.7 ; 352.4 ; 15.4 ;6;60;99;0;6;0;6;6;0;0;0;6
17636; 23.0 ; 367.9 ; 5.9 ;16;10;68;0;16;5;11;3;13;16;0;0
17637; 20.9 ; 167.3 ; 10.0 ;8;10;95;0;8;4;4;4;4;5;3;0
17638; 46.4 ; 232.0 ; 2.1 ;5;44;26;0;5;0;5;4;1;0;5;0
17639; 26.5 ; 53.0 ; 2.2 ;2;3;223;0;2;1;1;1;1;2;0;0
17640; 40.1 ; 200.6 ; 9.6 ;5;31;148;1;4;1;4;3;2;0;5;0
17641; 57.3 ; 343.6 ; 25.1 ;6;51;5;0;6;2;4;2;4;0;0;6
17642; 63.2 ; 632.4 ; 48.2 ;10;6;11;10;0;6;4;8;2;3;0;7
17643; 24.8 ; 74.4 ; 0.5 ;3;29;266;0;3;2;1;1;2;3;0;0
17644; 43.7 ; 393.7 ; 7.6 ;9;16;74;0;9;5;4;1;8;0;9;0
17645; 38.5 ; 154.2 ; 16.7 ;4;21;188;0;4;0;4;1;3;1;2;1
17646; 48.3 ; 1,303.3 ; 34.1 ;27;11;143;0;27;17;10;6;21;9;9;9
17647; 31.6 ; 157.8 ; 12.6 ;5;24;19;0;5;2;3;3;2;2;3;0
17648; 29.8 ; 119.1 ; 15.1 ;4;25;145;0;4;3;1;2;2;3;1;0
17649; 52.3 ; 314.0 ; 7.7 ;6;51;26;0;6;2;4;5;1;0;4;2
17650; 17.2 ; 86.2 ; 3.6 ;5;34;146;0;5;3;2;1;4;5;0;0
17651; 46.8 ; 93.5 ; -   ;2;5;237;0;2;0;2;0;2;0;2;0
17652; 72.8 ; 218.3 ; 34.0 ;3;78;26;0;3;0;3;3;0;0;0;3
17653; 54.7 ; 328.3 ; 46.1 ;6;50;131;0;6;1;5;4;2;2;2;2
17654; 42.0 ; 84.1 ; 8.1 ;2;58;14;0;2;1;1;0;2;0;2;0
17655; 31.9 ; 255.1 ; 13.1 ;8;33;20;0;8;2;6;4;4;3;5;0
17656; 55.7 ; 891.8 ; 21.6 ;16;26;11;0;16;2;14;8;8;0;0;16
17657; 53.4 ; 213.8 ; 27.8 ;4;35;158;0;4;0;4;2;2;1;2;1
17658; 30.1 ; 271.1 ; 11.8 ;9;30;1;0;9;3;6;4;5;3;6;0
17659; 31.3 ; 219.4 ; 3.5 ;7;34;80;0;7;3;4;1;6;2;5;0
17660; 77.0 ; 693.3 ; 34.4 ;9;39;16;0;9;1;8;8;1;0;0;9
17661; 57.6 ; 172.9 ; 8.5 ;3;92;42;0;3;0;3;3;0;0;0;3
17662; 56.2 ; 112.4 ; 21.1 ;2;151;11;2;0;0;2;0;2;0;0;2
17663; 46.1 ; 184.6 ; 1.6 ;4;96;24;0;4;3;1;2;2;0;4;0
17664; 28.6 ; 229.0 ; 15.9 ;8;29;34;0;8;3;5;2;6;5;3;0
17665; 40.1 ; 80.3 ; 14.9 ;2;107;5;0;2;0;2;2;0;1;0;1
17666; 62.2 ; 124.4 ; 23.1 ;2;290;41;0;2;0;2;2;0;0;0;2
17667; 55.3 ; 276.3 ; 31.7 ;5;9;236;0;5;0;5;3;2;2;0;3
17668; 32.0 ; 159.8 ; 6.4 ;5;21;5;0;5;3;2;1;4;2;3;0
17669; 19.1 ; 286.4 ; 6.6 ;15;14;167;0;15;7;8;9;6;15;0;0
17670; 20.1 ; 60.2 ; 9.3 ;3;180;5;0;3;0;3;2;1;3;0;0
17671; 54.4 ; 108.8 ; 8.5 ;2;2;143;0;2;2;0;0;2;0;1;1
17672; 35.9 ; 71.9 ; 0.3 ;2;123;74;0;2;1;1;0;2;0;2;0
17673; 18.9 ; 169.8 ; 5.4 ;9;26;26;0;9;4;5;4;5;9;0;0
17674; 47.0 ; 423.4 ; 11.3 ;9;32;0;0;9;3;6;2;7;0;6;3
17675; 51.5 ; 411.8 ; 9.0 ;8;24;45;0;8;3;5;5;3;0;5;3
17676; 42.0 ; 1,092.2 ; 21.1 ;26;14;24;0;26;11;15;18;8;9;8;9
17677; 15.0 ; 30.0 ; -   ;2;34;242;0;2;1;1;1;1;2;0;0
17678; 17.0 ; 51.1 ; 3.7 ;3;5;83;0;3;2;1;3;0;3;0;0
17679; 41.7 ; 83.4 ; 7.6 ;2;8;204;0;2;0;2;2;0;0;2;0
17680; 30.0 ; 150.0 ; 0.1 ;5;82;7;0;5;4;1;4;1;2;3;0
17681; 15.0 ; 45.0 ; -   ;3;112;9;2;1;3;0;3;0;3;0;0
17682; 117.7 ; 470.9 ; 20.2 ;4;14;275;0;4;2;2;4;0;0;0;4
17683; 26.1 ; 52.3 ; -   ;2;74;89;0;2;0;2;0;2;2;0;0
17684; 50.8 ; 558.3 ; 5.6 ;11;23;11;0;11;6;5;10;1;0;7;4
17685; 25.1 ; 50.1 ; -   ;2;66;66;0;2;1;1;0;2;2;0;0
17686; 82.6 ; 247.9 ; 27.8 ;3;54;183;0;3;0;3;3;0;0;0;3
17687; 52.7 ; 316.3 ; 5.4 ;6;41;60;0;6;1;5;4;2;0;4;2
17688; 62.8 ; 251.1 ; 25.2 ;4;30;115;0;4;1;3;2;2;0;0;4
17689; 42.9 ; 171.5 ; 10.7 ;4;58;67;0;4;3;1;1;3;0;4;0
17690; 54.6 ; 327.7 ; 29.1 ;6;60;10;0;6;1;5;4;2;2;2;2
17691; 44.4 ; 266.2 ; 4.5 ;6;46;64;0;6;0;6;2;4;0;6;0
17692; 68.4 ; 342.0 ; 36.0 ;5;55;36;1;4;1;4;3;2;0;0;5
17693; 51.3 ; 922.6 ; 20.7 ;18;16;2;0;18;13;5;5;13;0;12;6
17694; 30.2 ; 150.9 ; -   ;5;17;113;5;0;3;2;5;0;0;5;0
17695; 24.7 ; 49.4 ; 14.6 ;2;185;92;0;2;1;1;1;1;1;1;0
17696; 22.0 ; 900.5 ; 14.5 ;41;11;2;0;41;25;16;32;9;27;14;0
17697; 52.0 ; 988.7 ; 35.7 ;19;19;68;0;19;8;11;13;6;6;7;6
17698; 52.8 ; 105.7 ; 0.5 ;2;214;21;1;1;0;2;0;2;0;2;0
17699; 24.0 ; 95.9 ; 19.1 ;4;34;185;0;4;4;0;3;1;3;1;0
17700; 23.9 ; 95.7 ; 2.4 ;4;77;96;0;4;2;2;1;3;4;0;0
17701; 19.1 ; 95.6 ; 3.4 ;5;35;114;0;5;3;2;5;0;5;0;0
17702; 67.9 ; 203.7 ; 42.7 ;3;13;267;0;3;0;3;3;0;1;0;2
17703; 22.6 ; 45.2 ; 11.4 ;2;76;160;0;2;2;0;0;2;1;1;0
17704; 54.0 ; 647.9 ; 8.8 ;12;30;92;0;12;4;8;6;6;0;8;4
17705; 21.4 ; 128.5 ; 7.4 ;6;17;10;0;6;1;5;6;0;6;0;0
17706; 46.8 ; 93.5 ; -   ;2;123;158;0;2;1;1;2;0;0;2;0
17707; 38.9 ; 77.7 ; 13.0 ;2;23;169;2;0;0;2;2;0;1;1;0
17708; 30.3 ; 121.0 ; 6.0 ;4;34;215;0;4;1;3;1;3;1;3;0
17709; 70.8 ; 141.7 ; 36.1 ;2;92;33;0;2;1;1;1;1;0;0;2
17710; 37.0 ; 74.0 ; 23.2 ;2;5;304;0;2;0;2;2;0;1;0;1
17711; 62.1 ; 124.1 ; 15.7 ;2;100;99;0;2;0;2;2;0;0;0;2
17712; 44.8 ; 1,119.5 ; 14.3 ;25;14;14;0;25;19;6;19;6;0;17;8
17713; 50.0 ; 249.9 ; 27.0 ;5;36;68;0;5;0;5;1;4;2;1;2
17714; 34.1 ; 204.4 ; 9.8 ;6;32;115;0;6;0;6;3;3;2;4;0
17715; 30.2 ; 60.4 ; -   ;2;51;98;0;2;1;1;0;2;0;2;0
17716; 22.6 ; 496.7 ; 3.9 ;22;15;53;0;22;2;20;6;16;22;0;0
17717; 36.6 ; 109.8 ; -   ;3;18;68;1;2;1;2;3;0;0;3;0
17718; 38.5 ; 76.9 ; 12.4 ;2;74;84;0;2;0;2;1;1;1;1;0
17719; 36.7 ; 183.6 ; 14.2 ;5;35;167;0;5;2;3;2;3;2;3;0
17720; 52.2 ; 313.4 ; 17.0 ;6;31;194;0;6;0;6;4;2;0;4;2
17721; 53.6 ; 214.3 ; 1.8 ;4;44;68;0;4;0;4;4;0;0;3;1
17722; 136.9 ; 410.8 ; 30.1 ;3;76;47;3;0;0;3;3;0;0;0;3
17723; 53.9 ; 269.5 ; 10.3 ;5;22;105;0;5;1;4;3;2;0;3;2
17724; 67.9 ; 135.8 ; 37.5 ;2;7;388;0;2;0;2;2;0;0;0;2
17725; 44.7 ; 446.9 ; 13.4 ;10;14;11;0;10;1;9;8;2;0;7;3
17726; 44.8 ; 134.4 ; 13.5 ;3;98;32;0;3;1;2;1;2;0;2;1
17727; 29.5 ; 58.9 ; 15.2 ;2;134;135;0;2;1;1;1;1;1;1;0
17728; 38.1 ; 304.8 ; 3.6 ;8;33;10;0;8;0;8;8;0;0;8;0
17729; 17.0 ; 51.1 ; 3.7 ;3;31;179;0;3;0;3;3;0;3;0;0
17730; 60.3 ; 542.8 ; 23.7 ;9;35;11;0;9;0;9;9;0;0;0;9
17731; 36.3 ; 72.5 ; 16.8 ;2;355;99;0;2;0;2;1;1;1;1;0
17732; 56.3 ; 168.9 ; 26.4 ;3;20;6;0;3;2;1;1;2;1;0;2
17733; 22.4 ; 44.8 ; 11.1 ;2;19;365;0;2;2;0;1;1;1;1;0
17734; 75.3 ; 150.6 ; 33.1 ;2;45;68;0;2;0;2;1;1;0;0;2
17735; 21.8 ; 87.0 ; 10.8 ;4;43;95;0;4;1;3;1;3;3;1;0
17736; 38.7 ; 154.7 ; 15.8 ;4;19;17;0;4;3;1;1;3;1;3;0
17737; 17.8 ; 106.9 ; 2.0 ;6;9;22;0;6;0;6;2;4;6;0;0
17738; 19.3 ; 115.8 ; 3.1 ;6;27;236;0;6;4;2;6;0;6;0;0
17739; 74.4 ; 817.9 ; 43.7 ;11;29;5;0;11;1;10;10;1;0;0;11
17740; 56.0 ; 111.9 ; 18.8 ;2;286;11;0;2;1;1;1;1;0;0;2
17741; 32.0 ; 127.8 ; 1.6 ;4;14;237;0;4;0;4;2;2;0;4;0
17742; 17.0 ; 85.0 ; 4.8 ;5;23;103;0;5;3;2;4;1;5;0;0
17743; 34.2 ; 102.7 ; 12.4 ;3;139;31;0;3;0;3;3;0;1;2;0
17744; 19.3 ; 38.6 ; -   ;2;466;0;0;2;0;2;1;1;2;0;0
17745; 24.1 ; 96.5 ; 9.1 ;4;41;74;0;4;1;3;1;3;3;1;0
17746; 46.5 ; 186.0 ; 10.4 ;4;107;4;0;4;2;2;3;1;0;3;1
17747; 48.7 ; 341.1 ; 11.0 ;7;29;94;0;7;1;6;5;2;0;5;2
17748; 39.2 ; 78.4 ; 12.4 ;2;110;2;0;2;2;0;1;1;1;1;0
17749; 56.3 ; 506.8 ; 19.7 ;9;40;2;1;8;4;5;6;3;0;0;9
17750; 40.5 ; 566.8 ; 10.1 ;14;12;11;0;14;4;10;6;8;0;14;0
17751; 23.0 ; 206.7 ; 6.3 ;9;14;16;0;9;0;9;4;5;9;0;0
17752; 24.2 ; 121.1 ; 10.9 ;5;8;16;0;5;2;3;5;0;3;2;0
17753; 31.6 ; 157.8 ; 21.4 ;5;19;197;0;5;3;2;2;3;2;3;0
17754; 68.0 ; 339.9 ; 12.4 ;5;42;83;0;5;0;5;5;0;0;0;5
17755; 33.0 ; 66.1 ; 21.6 ;2;107;41;0;2;0;2;0;2;1;1;0
17756; 27.8 ; 250.0 ; 4.7 ;9;39;100;0;9;0;9;7;2;6;3;0
17757; 34.4 ; 447.0 ; 26.1 ;13;22;16;0;13;7;6;11;2;4;5;4
17758; 26.4 ; 79.2 ; 9.6 ;3;95;99;0;3;0;3;2;1;2;1;0
17759; 29.4 ; 147.0 ; 17.3 ;5;66;36;0;5;2;3;1;4;3;2;0
17760; 31.6 ; 94.8 ; 2.6 ;3;13;134;3;0;2;1;2;1;1;2;0
17761; 23.4 ; 234.2 ; 10.8 ;10;23;11;0;10;3;7;8;2;7;3;0
17762; 30.9 ; 123.4 ; 24.1 ;4;62;104;0;4;4;0;2;2;1;3;0
17763; 116.9 ; 233.8 ; 105.0 ;2;38;320;0;2;0;2;1;1;1;0;1
17764; 47.1 ; 94.2 ; 0.5 ;2;128;56;0;2;1;1;0;2;0;2;0
17765; 18.0 ; 89.9 ; 7.1 ;5;50;132;0;5;0;5;1;4;5;0;0
17766; 45.4 ; 226.8 ; 15.4 ;5;72;10;0;5;1;4;4;1;2;1;2
17767; 80.1 ; 561.0 ; 39.1 ;7;39;5;0;7;2;5;4;3;0;0;7
17768; 42.4 ; 169.7 ; 37.8 ;4;29;65;4;0;3;1;2;2;1;2;1
17769; 57.4 ; 114.8 ; 13.0 ;2;123;233;0;2;1;1;0;2;0;0;2
17770; 29.9 ; 59.7 ; 0.5 ;2;53;251;0;2;1;1;0;2;1;1;0
17771; 43.4 ; 130.2 ; 11.8 ;3;108;17;0;3;2;1;0;3;0;2;1
17772; 89.3 ; 268.0 ; 71.5 ;3;24;59;3;0;0;3;2;1;1;0;2
17773; 31.5 ; 157.4 ; 14.7 ;5;35;5;0;5;1;4;5;0;2;3;0
17774; 34.1 ; 477.7 ; 16.9 ;14;23;12;0;14;4;10;4;10;5;9;0
17775; 19.4 ; 58.1 ; 5.5 ;3;104;63;0;3;1;2;3;0;3;0;0
17776; 36.9 ; 184.6 ; 14.6 ;5;86;22;0;5;0;5;3;2;2;3;0
17777; 16.0 ; 48.0 ; 1.9 ;3;130;64;1;2;0;3;3;0;3;0;0
17778; 16.8 ; 33.6 ; 2.7 ;2;5;221;0;2;0;2;2;0;2;0;0
17779; 74.1 ; 222.2 ; 54.3 ;3;142;157;0;3;0;3;3;0;1;0;2
17780; 19.7 ; 39.3 ; -   ;2;45;306;0;2;2;0;1;1;2;0;0
17781; 36.9 ; 258.6 ; 18.8 ;7;6;233;0;7;5;2;4;3;2;3;2
17782; 33.2 ; 132.9 ; 10.4 ;4;27;31;0;4;0;4;3;1;1;3;0
17783; 63.5 ; 127.0 ; 65.1 ;2;104;182;0;2;1;1;0;2;1;0;1
17784; 52.5 ; 262.6 ; -   ;5;32;156;0;5;1;4;4;1;0;5;0
17785; 79.0 ; 237.0 ; 60.1 ;3;72;14;0;3;2;1;1;2;1;0;2
17786; 29.1 ; 87.4 ; 7.5 ;3;67;48;0;3;1;2;0;3;2;1;0
17787; 43.2 ; 388.5 ; 8.1 ;9;36;5;0;9;0;9;9;0;0;9;0
17788; 19.9 ; 417.0 ; 8.0 ;21;8;2;0;21;10;11;6;15;21;0;0
17789; 37.5 ; 299.7 ; 16.0 ;8;36;30;0;8;3;5;1;7;3;5;0
17790; 65.3 ; 130.5 ; 5.3 ;2;170;137;0;2;0;2;2;0;0;0;2
17791; 31.9 ; 127.7 ; 11.5 ;4;73;63;0;4;2;2;2;2;1;3;0
17792; 40.5 ; 202.7 ; 19.9 ;5;43;104;0;5;4;1;5;0;2;1;2
17793; 52.9 ; 211.6 ; 14.1 ;4;95;41;0;4;2;2;3;1;0;3;1
17794; 49.2 ; 393.7 ; 42.5 ;8;27;5;0;8;0;8;8;0;3;2;3
17795; 45.2 ; 406.4 ; 25.2 ;9;50;20;0;9;0;9;7;2;3;3;3
17796; 23.1 ; 46.1 ; 12.1 ;2;5;5;2;0;0;2;2;0;1;1;0
17797; 41.4 ; 537.7 ; 20.6 ;13;26;22;0;13;2;11;8;5;4;5;4
17798; 52.6 ; 368.2 ; 13.7 ;7;43;113;0;7;3;4;1;6;0;5;2
17799; 21.4 ; 171.3 ; 14.7 ;8;22;0;0;8;0;8;5;3;5;3;0
17800; 35.6 ; 392.0 ; 6.1 ;11;26;14;0;11;3;8;11;0;4;7;0
17801; 46.5 ; 232.3 ; 8.4 ;5;36;66;0;5;2;3;2;3;0;5;0
17802; 16.3 ; 245.1 ; 3.6 ;15;16;4;0;15;4;11;3;12;15;0;0
17803; 38.5 ; 192.3 ; 35.0 ;5;59;22;0;5;1;4;1;4;2;1;2
17804; 31.9 ; 509.7 ; 19.5 ;16;9;163;0;16;5;11;10;6;5;11;0
17805; 29.5 ; 88.5 ; 8.6 ;3;108;92;0;3;1;2;3;0;2;1;0
17806; 40.3 ; 3,144.6 ; 8.3 ;78;5;3;0;78;50;28;15;63;0;78;0
17807; 93.6 ; 280.8 ; 31.5 ;3;122;89;0;3;1;2;2;1;0;0;3
17808; 42.4 ; 212.1 ; 14.7 ;5;12;85;4;1;2;3;4;1;2;1;2
17809; 29.3 ; 88.0 ; 14.8 ;3;70;113;0;3;2;1;3;0;2;1;0
17810; 79.2 ; 237.7 ; 22.0 ;3;67;173;0;3;0;3;2;1;0;0;3
17811; 46.9 ; 93.9 ; 28.2 ;2;62;199;0;2;0;2;1;1;1;0;1
17812; 60.6 ; 121.2 ; 61.9 ;2;139;57;0;2;0;2;2;0;1;0;1
17813; 84.5 ; 169.1 ; 19.0 ;2;110;188;0;2;1;1;1;1;0;0;2
17814; 39.6 ; 475.6 ; 51.4 ;12;23;44;0;12;6;6;7;5;4;4;4
17815; 35.0 ; 384.9 ; 20.8 ;11;25;10;0;11;8;3;2;9;4;3;4
17816; 24.7 ; 98.7 ; 3.7 ;4;27;268;0;4;1;3;2;2;4;0;0
17817; 38.8 ; 77.5 ; 12.0 ;2;68;200;0;2;0;2;0;2;1;1;0
17818; 49.0 ; 245.1 ; 2.9 ;5;51;22;0;5;0;5;5;0;0;5;0
17819; 61.7 ; 185.2 ; 27.5 ;3;92;123;0;3;2;1;2;1;0;0;3
17820; 36.2 ; 72.5 ; 0.1 ;2;10;338;0;2;1;1;2;0;0;2;0
17821; 23.1 ; 69.3 ; 3.4 ;3;7;265;0;3;2;1;3;0;3;0;0
17822; 26.1 ; 156.3 ; 9.0 ;6;36;59;0;6;4;2;2;4;4;2;0
17823; 48.4 ; 241.8 ; 14.0 ;5;35;265;0;5;4;1;1;4;0;3;2
17824; 83.1 ; 166.3 ; 32.1 ;2;5;200;0;2;0;2;1;1;0;0;2
17825; 17.3 ; 415.8 ; 5.0 ;24;14;0;0;24;14;10;12;12;24;0;0
17826; 26.5 ; 212.1 ; 8.6 ;8;23;239;0;8;3;5;7;1;5;3;0
17827; 67.8 ; 135.6 ; 9.2 ;2;8;78;0;2;1;1;1;1;0;0;2
17828; 15.0 ; 89.9 ; -   ;6;23;23;0;6;3;3;1;5;6;0;0
17829; 20.0 ; 40.1 ; 7.6 ;2;3;199;2;0;1;1;0;2;2;0;0
17830; 27.1 ; 108.5 ; 8.7 ;4;88;168;3;1;1;3;2;2;3;1;0
17831; 25.3 ; 50.6 ; 8.8 ;2;61;29;0;2;1;1;0;2;1;1;0
17832; 41.2 ; 123.7 ; 10.1 ;3;109;200;0;3;2;1;1;2;0;3;0
17833; 29.6 ; 147.9 ; 14.1 ;5;77;101;0;5;1;4;3;2;3;2;0
17834; 53.3 ; 1,704.1 ; 8.2 ;32;9;10;0;32;0;32;32;0;0;21;11
17835; 27.5 ; 137.5 ; 9.6 ;5;9;5;0;5;3;2;2;3;3;2;0
17836; 51.1 ; 714.8 ; 9.2 ;14;25;10;0;14;0;14;11;3;0;9;5
17837; 46.1 ; 92.1 ; 1.0 ;2;57;93;0;2;1;1;0;2;0;2;0
17838; 58.4 ; 350.6 ; 9.6 ;6;36;5;0;6;0;6;3;3;0;0;6
17839; 25.5 ; 382.5 ; 15.9 ;15;20;164;0;15;14;1;15;0;10;5;0
17840; 21.7 ; 65.1 ; 6.2 ;3;7;72;0;3;2;1;3;0;3;0;0
17841; 34.5 ; 69.0 ; 19.4 ;2;75;173;0;2;0;2;2;0;1;1;0
17842; 52.8 ; 105.7 ; 1.7 ;2;31;11;2;0;0;2;0;2;0;2;0
17843; 47.5 ; 94.9 ; -   ;2;8;50;0;2;1;1;0;2;0;2;0
17844; 35.7 ; 107.1 ; 10.1 ;3;36;150;2;1;1;2;3;0;1;2;0
17845; 15.0 ; 30.0 ; -   ;2;5;36;0;2;0;2;2;0;2;0;0
17846; 41.7 ; 83.4 ; 7.6 ;2;18;126;2;0;0;2;2;0;0;2;0
17847; 59.4 ; 297.0 ; 59.9 ;5;23;26;0;5;1;4;3;2;2;0;3
17848; 43.0 ; 129.0 ; 16.9 ;3;97;19;0;3;2;1;1;2;1;1;1
17849; 31.5 ; 94.5 ; 5.9 ;3;79;26;0;3;1;2;3;0;1;2;0
17850; 40.6 ; 608.8 ; 16.6 ;15;15;0;0;15;0;15;5;10;5;5;5
17851; 56.2 ; 112.4 ; 35.3 ;2;17;163;0;2;0;2;2;0;1;0;1
17852; 44.0 ; 88.0 ; 19.2 ;2;37;11;0;2;0;2;1;1;1;0;1
17853; 30.3 ; 90.8 ; 16.1 ;3;18;40;0;3;2;1;2;1;1;2;0
17854; 47.7 ; 143.1 ; 0.4 ;3;40;23;3;0;1;2;2;1;0;3;0
17855; 28.3 ; 480.9 ; 31.9 ;17;15;4;0;17;8;9;4;13;11;0;6
17856; 29.9 ; 119.8 ; 13.3 ;4;14;17;0;4;2;2;2;2;3;1;0
17857; 57.5 ; 114.9 ; 11.8 ;2;34;194;0;2;1;1;2;0;0;0;2
17858; 29.1 ; 145.3 ; 14.8 ;5;11;266;0;5;3;2;3;2;3;2;0
17859; 16.5 ; 33.0 ; 2.3 ;2;234;40;0;2;2;0;2;0;2;0;0
17860; 30.8 ; 61.7 ; 8.6 ;2;13;146;0;2;0;2;1;1;1;1;0
17861; 42.6 ; 170.4 ; 8.8 ;4;5;377;0;4;0;4;3;1;0;4;0
17862; 39.2 ; 78.4 ; 12.4 ;2;82;15;0;2;0;2;2;0;1;1;0
17863; 17.5 ; 70.0 ; 5.3 ;4;45;50;0;4;3;1;1;3;4;0;0
17864; 38.9 ; 778.4 ; 12.5 ;20;14;6;0;20;5;15;19;1;7;13;0
17865; 37.7 ; 226.2 ; 15.4 ;6;15;136;0;6;1;5;5;1;2;4;0
17866; 31.1 ; 155.6 ; 18.7 ;5;68;15;0;5;0;5;4;1;2;3;0
17867; 32.5 ; 65.0 ; 2.9 ;2;24;28;0;2;1;1;2;0;1;1;0
17868; 44.8 ; 179.0 ; 5.8 ;4;46;45;0;4;4;0;2;2;0;4;0
17869; 17.1 ; 85.6 ; 5.5 ;5;63;0;0;5;0;5;1;4;5;0;0
17870; 65.1 ; 130.1 ; 18.8 ;2;51;116;0;2;1;1;2;0;0;0;2
17871; 30.8 ; 61.7 ; 8.6 ;2;5;259;0;2;1;1;1;1;1;1;0
17872; 18.8 ; 75.0 ; 0.4 ;4;99;25;0;4;2;2;3;1;4;0;0
17873; 32.6 ; 97.8 ; 21.2 ;3;105;105;0;3;2;1;3;0;1;2;0
17874; 15.0 ; 74.9 ; -   ;5;52;62;2;3;1;4;2;3;5;0;0
17875; 43.9 ; 175.7 ; 16.2 ;4;132;41;0;4;1;3;4;0;1;2;1
17876; 110.9 ; 221.8 ; 16.8 ;2;19;62;0;2;0;2;2;0;0;0;2
17877; 29.1 ; 436.9 ; 14.9 ;15;12;5;0;15;0;15;14;1;10;5;0
17878; 52.5 ; 210.1 ; -   ;4;17;147;0;4;0;4;4;0;0;4;0
17879; 41.1 ; 780.9 ; 34.8 ;19;23;16;0;19;5;14;5;14;6;7;6
17880; 57.3 ; 343.5 ; 8.0 ;6;27;162;0;6;0;6;3;3;0;0;6
17881; 48.2 ; 192.6 ; 6.5 ;4;14;251;0;4;0;4;3;1;0;4;0
17882; 67.9 ; 271.7 ; 9.6 ;4;9;160;0;4;2;2;2;2;0;0;4
17883; 42.6 ; 170.4 ; 8.8 ;4;36;207;0;4;2;2;2;2;0;4;0
17884; 40.6 ; 365.4 ; 10.0 ;9;25;67;0;9;2;7;4;5;0;9;0
17885; 51.4 ; 205.6 ; 1.9 ;4;80;47;0;4;0;4;4;0;0;4;0
17886; 54.7 ; 109.5 ; 31.1 ;2;167;250;0;2;1;1;1;1;1;0;1
17887; 66.5 ; 133.1 ; 15.6 ;2;34;267;0;2;1;1;2;0;0;0;2
17888; 44.0 ; 176.0 ; 13.6 ;4;30;73;0;4;1;3;2;2;0;3;1
17889; 43.4 ; 86.8 ; 42.6 ;2;80;179;0;2;0;2;1;1;1;0;1
17890; 36.9 ; 73.9 ; 8.6 ;2;93;5;0;2;0;2;2;0;1;1;0
17891; 33.4 ; 66.8 ; 4.8 ;2;42;105;0;2;0;2;2;0;1;1;0
17892; 38.7 ; 541.3 ; 14.9 ;14;14;17;14;0;6;8;3;11;5;9;0
17893; 47.1 ; 94.2 ; 0.5 ;2;152;99;0;2;0;2;1;1;0;2;0
17894; 35.9 ; 107.8 ; 10.6 ;3;50;80;0;3;2;1;2;1;1;2;0
17895; 19.9 ; 159.6 ; 11.2 ;8;32;57;0;8;0;8;4;4;5;3;0
17896; 22.6 ; 45.2 ; 11.4 ;2;65;187;0;2;1;1;1;1;1;1;0
17897; 25.7 ; 179.6 ; 1.8 ;7;34;10;0;7;3;4;1;6;7;0;0
17898; 21.0 ; 335.4 ; 6.9 ;16;6;26;0;16;10;6;5;11;16;0;0
17899; 57.1 ; 742.6 ; 17.2 ;13;36;10;0;13;1;12;10;3;0;0;13
17900; 36.7 ; 404.2 ; 12.6 ;11;25;21;0;11;2;9;4;7;4;7;0
17901; 61.2 ; 183.6 ; 8.2 ;3;34;199;0;3;1;2;2;1;0;0;3
17902; 24.7 ; 98.7 ; 10.4 ;4;25;230;0;4;0;4;1;3;3;1;0
17903; 16.6 ; 149.8 ; 2.6 ;9;14;28;0;9;6;3;4;5;9;0;0
17904; 38.5 ; 76.9 ; 12.4 ;2;44;239;0;2;2;0;0;2;1;1;0
17905; 63.2 ; 126.3 ; -   ;2;7;16;0;2;1;1;0;2;0;0;2
17906; 92.1 ; 184.2 ; 30.4 ;2;25;356;0;2;0;2;2;0;0;0;2
17907; 22.4 ; 179.3 ; 9.6 ;8;26;22;0;8;7;1;6;2;5;3;0
17908; 36.8 ; 1,142.3 ; 17.4 ;31;10;1;0;31;7;24;11;20;10;21;0
17909; 56.1 ; 112.2 ; 14.0 ;2;131;167;0;2;0;2;2;0;0;0;2
17910; 40.9 ; 81.8 ; 23.7 ;2;43;231;0;2;0;2;2;0;1;0;1
17911; 47.1 ; 94.2 ; 0.5 ;2;169;36;0;2;0;2;2;0;0;2;0
17912; 23.1 ; 277.2 ; 19.7 ;12;12;27;0;12;3;9;6;6;8;4;0
17913; 35.8 ; 71.6 ; 20.9 ;2;62;274;0;2;0;2;1;1;1;0;1
17914; 61.0 ; 122.0 ; 7.3 ;2;42;105;0;2;0;2;2;0;0;0;2
17915; 30.0 ; 59.9 ; -   ;2;145;5;0;2;0;2;2;0;2;0;0
17916; 36.6 ; 73.2 ; -   ;2;13;263;0;2;0;2;1;1;0;2;0
17917; 48.6 ; 97.2 ; 22.6 ;2;34;238;0;2;1;1;2;0;1;0;1
17918; 51.9 ; 518.5 ; 32.6 ;10;31;21;0;10;2;8;5;5;3;4;3
17919; 33.1 ; 99.2 ; 9.2 ;3;97;82;0;3;2;1;1;2;1;2;0
17920; 32.3 ; 161.5 ; 11.1 ;5;16;221;0;5;1;4;3;2;2;3;0
17921; 37.4 ; 74.9 ; 6.2 ;2;17;400;0;2;0;2;0;2;0;2;0
17922; 47.0 ; 94.1 ; 15.6 ;2;38;239;0;2;2;0;0;2;0;1;1
17923; 40.4 ; 485.1 ; 12.3 ;12;17;81;0;12;8;4;5;7;4;8;0
17924; 42.7 ; 213.6 ; 17.7 ;5;65;45;0;5;1;4;5;0;2;1;2
17925; 39.9 ; 199.6 ; 10.5 ;5;74;31;0;5;3;2;1;4;2;3;0
17926; 35.1 ; 140.3 ; 12.3 ;4;13;115;0;4;0;4;2;2;1;3;0
17927; 90.3 ; 180.6 ; 51.4 ;2;32;99;0;2;0;2;1;1;0;0;2
17928; 39.9 ; 1,437.0 ; 18.5 ;36;10;6;1;35;25;11;8;28;12;12;12
17929; 58.3 ; 233.1 ; 40.9 ;4;36;3;0;4;2;2;3;1;1;0;3
17930; 34.5 ; 241.5 ; 32.5 ;7;25;53;0;7;5;2;5;2;2;3;2
17931; 46.0 ; 137.9 ; 17.5 ;3;34;26;0;3;1;2;2;1;1;1;1
17932; 32.6 ; 130.3 ; 21.1 ;4;49;146;0;4;1;3;3;1;1;3;0
17933; 58.0 ; 116.0 ; 22.7 ;2;11;121;0;2;0;2;2;0;0;0;2
17934; 25.3 ; 126.4 ; 6.7 ;5;18;295;0;5;2;3;1;4;3;2;0
17935; 17.2 ; 412.5 ; 3.1 ;24;11;38;0;24;15;9;4;20;24;0;0
17936; 25.4 ; 203.5 ; 14.1 ;8;24;86;0;8;6;2;1;7;5;3;0
17937; 33.0 ; 429.1 ; 10.4 ;13;23;10;0;13;4;9;7;6;4;9;0
17938; 20.6 ; 103.1 ; 2.7 ;5;39;207;0;5;4;1;2;3;5;0;0
17939; 49.2 ; 98.4 ; 28.5 ;2;38;11;0;2;0;2;0;2;1;0;1
17940; 39.1 ; 78.2 ; 6.1 ;2;69;325;0;2;0;2;0;2;0;2;0
17941; 89.3 ; 178.6 ; 12.1 ;2;50;284;0;2;0;2;2;0;0;0;2
17942; 29.1 ; 87.3 ; 7.4 ;3;18;161;0;3;3;0;3;0;2;1;0
17943; 60.7 ; 121.4 ; 31.8 ;2;81;15;0;2;1;1;1;1;1;0;1
17944; 67.8 ; 2,645.0 ; 41.5 ;39;11;14;0;39;19;20;16;23;13;0;26
17945; 15.0 ; 30.0 ; -   ;2;414;9;0;2;2;0;1;1;2;0;0
17946; 19.9 ; 79.7 ; 2.5 ;4;16;73;0;4;0;4;4;0;4;0;0
17947; 105.7 ; 211.5 ; 1.1 ;2;27;93;0;2;1;1;2;0;0;0;2
17948; 48.7 ; 146.2 ; 23.7 ;3;48;299;0;3;2;1;3;0;1;1;1
17949; 33.4 ; 234.1 ; 12.6 ;7;36;5;0;7;0;7;6;1;2;5;0
17950; 46.7 ; 1,914.7 ; 16.3 ;41;10;5;0;41;11;30;27;14;0;27;14
17951; 21.8 ; 152.7 ; 6.3 ;7;31;1;0;7;4;3;3;4;7;0;0
17952; 47.6 ; 857.6 ; 18.1 ;18;19;1;0;18;8;10;2;16;6;6;6
17953; 46.6 ; 373.0 ; 7.1 ;8;32;15;0;8;0;8;5;3;0;8;0
17954; 52.1 ; 104.2 ; 8.0 ;2;156;116;0;2;0;2;1;1;0;1;1
17955; 39.1 ; 156.5 ; 10.6 ;4;10;2;4;0;1;3;2;2;1;3;0
17956; 27.0 ; 135.0 ; 10.2 ;5;24;292;0;5;0;5;2;3;3;2;0
17957; 15.5 ; 77.4 ; 1.3 ;5;32;14;0;5;2;3;1;4;5;0;0
17958; 53.5 ; 428.2 ; 15.5 ;8;31;59;0;8;0;8;4;4;0;5;3
17959; 56.1 ; 112.2 ; -   ;2;31;200;0;2;0;2;2;0;0;0;2
17960; 62.7 ; 125.3 ; 1.5 ;2;24;125;0;2;0;2;2;0;0;0;2
17961; 46.8 ; 93.5 ; -   ;2;96;167;0;2;0;2;2;0;0;2;0
17962; 18.8 ; 56.5 ; 3.5 ;3;4;259;0;3;3;0;3;0;3;0;0
17963; 22.6 ; 45.1 ; 3.8 ;2;11;264;0;2;1;1;0;2;2;0;0
17964; 53.6 ; 107.2 ; 0.5 ;2;56;11;0;2;0;2;2;0;0;2;0
17965; 27.3 ; 54.6 ; 3.3 ;2;68;32;1;1;0;2;2;0;1;1;0
17966; 20.7 ; 83.0 ; -   ;4;65;20;4;0;0;4;2;2;4;0;0
17967; 53.7 ; 161.2 ; 1.5 ;3;59;17;0;3;1;2;1;2;0;2;1
17968; 65.9 ; 395.3 ; 20.0 ;6;52;10;0;6;2;4;4;2;0;0;6
17969; 48.9 ; 1,369.0 ; 26.1 ;28;14;0;0;28;10;18;14;14;9;10;9
17970; 44.9 ; 314.5 ; 17.4 ;7;42;23;0;7;3;4;6;1;2;3;2
17971; 63.6 ; 318.2 ; 27.4 ;5;28;58;0;5;0;5;5;0;0;0;5
17972; 28.3 ; 113.3 ; 11.0 ;4;11;127;0;4;1;3;2;2;3;1;0
17973; 22.3 ; 66.9 ; 2.2 ;3;132;99;1;2;0;3;3;0;3;0;0
17974; 30.2 ; 60.4 ; -   ;2;69;65;0;2;2;0;1;1;0;2;0
17975; 64.2 ; 899.0 ; 16.6 ;14;11;5;0;14;0;14;13;1;0;0;14
17976; 56.7 ; 567.0 ; 10.6 ;10;37;79;0;10;0;10;9;1;0;0;10
17977; 53.0 ; 264.9 ; 12.5 ;5;57;20;0;5;2;3;0;5;0;3;2
17978; 35.6 ; 427.4 ; 22.3 ;12;21;41;0;12;3;9;12;0;4;4;4
17979; 46.1 ; 230.7 ; 5.5 ;5;66;78;0;5;0;5;3;2;0;5;0
17980; 56.8 ; 113.6 ; 14.0 ;2;13;58;0;2;0;2;1;1;0;0;2
17981; 64.6 ; 258.3 ; 24.5 ;4;59;53;2;2;0;4;3;1;0;0;4
17982; 27.3 ; 82.0 ; 9.5 ;3;85;0;1;2;0;3;1;2;2;1;0
17983; 47.8 ; 143.5 ; 35.0 ;3;126;26;2;1;0;3;2;1;1;1;1
17984; 86.8 ; 173.6 ; 57.1 ;2;61;284;0;2;0;2;2;0;1;0;1
17985; 47.1 ; 94.2 ; 0.5 ;2;217;92;0;2;1;1;1;1;0;2;0
17986; 31.2 ; 62.5 ; 24.3 ;2;268;79;1;1;1;1;2;0;1;0;1
17987; 54.7 ; 273.3 ; 20.2 ;5;50;99;0;5;0;5;5;0;0;3;2
17988; 35.8 ; 71.6 ; 3.3 ;2;6;269;0;2;1;1;2;0;0;2;0
17989; 87.5 ; 612.3 ; 31.0 ;7;44;17;0;7;2;5;6;1;0;0;7
17990; 34.7 ; 104.2 ; 23.7 ;3;11;35;2;1;1;2;1;2;1;1;1
17991; 73.7 ; 147.5 ; 31.8 ;2;10;99;0;2;1;1;1;1;0;0;2
17992; 63.3 ; 1,773.1 ; 34.1 ;28;10;53;0;28;18;10;5;23;9;0;19
17993; 36.4 ; 218.4 ; 13.1 ;6;40;15;1;5;0;6;2;4;2;4;0
17994; 49.8 ; 99.6 ; 1.8 ;2;88;262;0;2;0;2;2;0;0;2;0
17995; 35.1 ; 70.2 ; 7.4 ;2;188;49;0;2;1;1;1;1;1;1;0
17996; 47.6 ; 142.9 ; 1.0 ;3;47;64;3;0;1;2;3;0;0;3;0
17997; 34.8 ; 104.4 ; 4.7 ;3;38;201;0;3;2;1;2;1;0;3;0
17998; 40.6 ; 81.2 ; 9.2 ;2;50;259;0;2;2;0;2;0;0;2;0
17999; 32.2 ; 225.5 ; 12.3 ;7;5;217;0;7;6;1;3;4;2;5;0
18000; 48.7 ; 974.6 ; 14.7 ;20;13;41;0;20;4;16;12;8;0;13;7
18001; 26.1 ; 52.2 ; 11.2 ;2;9;264;0;2;1;1;0;2;1;1;0
18002; 58.5 ; 117.0 ; 11.2 ;2;7;231;0;2;1;1;2;0;0;0;2
18003; 36.6 ; 109.9 ; 11.8 ;3;12;193;0;3;3;0;0;3;1;2;0
18004; 17.6 ; 52.7 ; 4.7 ;3;156;23;0;3;1;2;1;2;3;0;0
18005; 53.0 ; 423.7 ; 34.2 ;8;40;5;0;8;5;3;8;0;3;2;3
18006; 29.0 ; 145.0 ; 14.9 ;5;50;6;0;5;2;3;3;2;3;2;0
18007; 57.5 ; 229.8 ; 12.7 ;4;106;1;0;4;1;3;1;3;0;0;4
18008; 79.4 ; 317.7 ; 55.0 ;4;30;168;0;4;2;2;4;0;1;0;3
18009; 26.4 ; 52.9 ; 10.7 ;2;8;64;0;2;1;1;1;1;1;1;0
18010; 62.1 ; 745.6 ; 16.7 ;12;19;83;0;12;3;9;7;5;0;0;12
18011; 82.3 ; 329.3 ; 58.1 ;4;42;162;0;4;0;4;4;0;1;0;3
18012; 84.9 ; 339.6 ; 45.1 ;4;98;65;0;4;1;3;2;2;0;0;4
18013; 72.2 ; 361.0 ; 36.6 ;5;30;104;0;5;1;4;3;2;0;0;5
18014; 16.7 ; 83.6 ; 1.7 ;5;9;189;0;5;1;4;3;2;5;0;0
18015; 21.5 ; 86.0 ; 13.8 ;4;121;5;0;4;1;3;1;3;3;1;0
18016; 21.5 ; 171.8 ; 9.1 ;8;16;252;0;8;0;8;4;4;5;3;0
18017; 32.1 ; 160.7 ; 18.0 ;5;14;212;0;5;4;1;2;3;2;3;0
18018; 33.5 ; 134.1 ; 11.0 ;4;38;292;0;4;3;1;3;1;1;3;0
18019; 64.5 ; 322.5 ; 26.9 ;5;14;5;0;5;0;5;4;1;0;0;5
18020; 54.2 ; 108.5 ; 7.0 ;2;174;22;2;0;0;2;1;1;0;1;1
18021; 23.5 ; 259.0 ; 11.1 ;11;20;15;0;11;6;5;6;5;7;4;0
18022; 51.2 ; 102.4 ; 3.9 ;2;4;149;0;2;1;1;0;2;0;1;1
18023; 22.2 ; 66.6 ; 13.2 ;3;39;3;0;3;1;2;2;1;2;1;0
18024; 27.6 ; 55.3 ; 3.8 ;2;50;110;0;2;0;2;2;0;1;1;0
18025; 37.6 ; 188.1 ; 10.9 ;5;39;13;0;5;1;4;2;3;2;3;0
18026; 43.5 ; 478.7 ; 22.0 ;11;28;3;0;11;5;6;4;7;4;3;4
18027; 55.6 ; 111.3 ; 9.1 ;2;32;134;0;2;2;0;2;0;0;0;2
18028; 64.6 ; 646.3 ; 21.6 ;10;39;26;7;3;1;9;7;3;0;0;10
18029; 87.9 ; 439.4 ; 32.3 ;5;34;125;0;5;1;4;4;1;0;0;5
18030; 20.3 ; 60.8 ; 5.4 ;3;54;179;0;3;1;2;3;0;3;0;0
18031; 47.0 ; 141.0 ; 0.4 ;3;34;100;0;3;1;2;1;2;0;3;0
18032; 49.0 ; 97.9 ; 5.3 ;2;11;158;0;2;1;1;1;1;0;2;0
18033; 52.9 ; 105.8 ; 0.5 ;2;101;94;0;2;0;2;2;0;0;2;0
18034; 28.1 ; 56.1 ; 19.6 ;2;19;246;0;2;0;2;0;2;1;1;0
18035; 41.6 ; 166.3 ; 6.5 ;4;34;243;0;4;3;1;2;2;0;4;0
18036; 24.2 ; 121.0 ; 6.2 ;5;6;94;0;5;2;3;1;4;3;2;0
18037; 87.3 ; 1,134.3 ; 27.2 ;13;18;120;0;13;5;8;3;10;0;0;13
18038; 19.6 ; 117.8 ; 13.0 ;6;18;11;0;6;0;6;4;2;4;2;0
18039; 40.8 ; 81.5 ; 18.7 ;2;35;22;0;2;0;2;2;0;1;0;1
18040; 29.1 ; 58.2 ; 16.6 ;2;178;131;0;2;1;1;1;1;1;1;0
18041; 25.1 ; 50.1 ; -   ;2;12;113;0;2;2;0;1;1;2;0;0
18042; 33.6 ; 100.8 ; 6.3 ;3;22;35;0;3;1;2;3;0;1;2;0
18043; 48.9 ; 97.8 ; 3.2 ;2;23;278;0;2;1;1;2;0;0;2;0
18044; 64.9 ; 194.6 ; 33.8 ;3;59;0;0;3;0;3;3;0;0;0;3
18045; 44.3 ; 309.9 ; 9.9 ;7;28;24;1;6;3;4;1;6;0;7;0
18046; 25.1 ; 526.6 ; 19.0 ;21;16;2;0;21;8;13;11;10;14;7;0
18047; 46.8 ; 187.0 ; -   ;4;25;246;0;4;1;3;3;1;0;4;0
18048; 35.5 ; 1,099.8 ; 21.0 ;31;6;15;0;31;18;13;15;16;10;11;10
18049; 123.6 ; 247.3 ; 40.4 ;2;21;63;0;2;1;1;2;0;0;0;2
18050; 39.1 ; 156.5 ; 5.4 ;4;61;131;0;4;1;3;2;2;0;4;0
18051; 34.1 ; 170.4 ; 10.5 ;5;45;142;5;0;0;5;5;0;2;3;0
18052; 40.5 ; 689.3 ; 18.1 ;17;15;113;0;17;13;4;11;6;6;5;6
18053; 43.4 ; 86.8 ; 42.6 ;2;120;133;0;2;2;0;2;0;1;0;1
18054; 45.1 ; 225.5 ; 26.7 ;5;22;18;0;5;2;3;4;1;2;1;2
18055; 46.8 ; 93.5 ; -   ;2;126;183;0;2;0;2;2;0;0;2;0
18056; 47.5 ; 94.9 ; -   ;2;8;96;0;2;2;0;2;0;0;2;0
18057; 56.9 ; 853.5 ; 27.0 ;15;19;26;0;15;5;10;6;9;5;0;10
18058; 26.8 ; 348.6 ; 6.3 ;13;17;22;0;13;1;12;5;8;9;4;0
18059; 64.2 ; 128.4 ; 4.1 ;2;13;377;0;2;0;2;0;2;0;0;2
18060; 91.4 ; 274.2 ; 19.4 ;3;20;93;0;3;1;2;2;1;0;0;3
18061; 39.1 ; 391.3 ; 35.5 ;10;23;80;0;10;3;7;4;6;3;4;3
18062; 25.7 ; 128.6 ; 9.0 ;5;37;63;0;5;2;3;0;5;3;2;0
18063; 47.1 ; 1,082.9 ; 0.5 ;23;11;10;0;23;0;23;11;12;0;23;0
18064; 41.5 ; 83.0 ; 11.8 ;2;89;25;0;2;1;1;2;0;1;1;0
18065; 26.3 ; 315.6 ; 10.2 ;12;27;49;0;12;10;2;8;4;8;4;0
18066; 42.9 ; 85.7 ; -   ;2;3;366;0;2;2;0;0;2;0;2;0
18067; 35.7 ; 107.1 ; 10.1 ;3;193;31;0;3;1;2;1;2;1;2;0
18068; 83.6 ; 250.7 ; 33.8 ;3;4;275;0;3;3;0;1;2;0;0;3
18069; 29.2 ; 87.7 ; 12.1 ;3;128;19;0;3;1;2;1;2;2;1;0
18070; 76.6 ; 383.1 ; 39.6 ;5;63;57;0;5;1;4;5;0;0;0;5
18071; 27.3 ; 272.6 ; 15.5 ;10;31;10;0;10;2;8;5;5;7;3;0
18072; 32.2 ; 160.9 ; 13.9 ;5;52;100;4;1;2;3;1;4;2;3;0
18073; 29.9 ; 89.8 ; 4.6 ;3;7;229;0;3;1;2;1;2;2;1;0
18074; 71.9 ; 287.6 ; 13.6 ;4;11;250;0;4;1;3;4;0;0;0;4
18075; 96.2 ; 288.6 ; 3.2 ;3;31;52;1;2;1;2;3;0;0;0;3
18076; 31.1 ; 62.2 ; 9.1 ;2;38;146;0;2;0;2;1;1;1;1;0
18077; 27.9 ; 502.8 ; 12.4 ;18;14;5;0;18;9;9;13;5;12;6;0
18078; 36.6 ; 73.2 ; -   ;2;32;246;0;2;0;2;0;2;0;2;0
18079; 15.0 ; 30.0 ; -   ;2;41;246;0;2;1;1;0;2;2;0;0
18080; 17.0 ; 85.0 ; 4.8 ;5;72;20;0;5;1;4;2;3;5;0;0
18081; 63.9 ; 319.7 ; 12.2 ;5;23;68;0;5;0;5;5;0;0;0;5
18082; 21.5 ; 43.0 ; 0.2 ;2;100;111;0;2;0;2;0;2;2;0;0
18083; 31.3 ; 1,564.0 ; 18.4 ;50;6;5;0;50;25;25;26;24;17;33;0
18084; 20.0 ; 179.9 ; 9.0 ;9;36;17;0;9;6;3;7;2;9;0;0
18085; 86.2 ; 172.3 ; 19.4 ;2;3;250;0;2;1;1;0;2;0;0;2
18086; 15.0 ; 45.0 ; -   ;3;47;60;0;3;3;0;1;2;3;0;0
18087; 74.1 ; 370.4 ; 25.6 ;5;49;64;0;5;1;4;5;0;0;0;5
18088; 28.4 ; 142.1 ; 13.4 ;5;23;188;0;5;2;3;3;2;3;2;0
18089; 35.3 ; 106.0 ; 14.6 ;3;88;99;0;3;0;3;1;2;1;2;0
18090; 47.0 ; 845.3 ; 0.4 ;18;22;5;0;18;4;14;3;15;0;18;0
18091; 48.7 ; 97.3 ; 6.4 ;2;106;94;2;0;0;2;2;0;0;1;1
18092; 47.5 ; 94.9 ; 1.1 ;2;243;23;0;2;1;1;2;0;0;2;0
18093; 61.8 ; 247.3 ; 11.5 ;4;57;168;0;4;1;3;2;2;0;0;4
18094; 36.9 ; 73.8 ; 4.8 ;2;45;262;0;2;0;2;1;1;0;2;0
18095; 17.5 ; 489.6 ; 6.1 ;28;10;29;0;28;10;18;16;12;28;0;0
18096; 21.9 ; 109.5 ; 4.9 ;5;33;176;0;5;1;4;3;2;5;0;0
18097; 27.1 ; 81.2 ; 18.2 ;3;137;40;0;3;2;1;3;0;2;1;0
18098; 32.1 ; 128.2 ; 16.7 ;4;29;310;0;4;1;3;2;2;1;3;0
18099; 46.2 ; 647.1 ; 12.0 ;14;21;21;0;14;8;6;14;0;0;9;5
18100; 33.4 ; 200.3 ; 10.8 ;6;38;17;0;6;4;2;1;5;2;4;0
18101; 55.6 ; 611.7 ; 29.8 ;11;34;15;0;11;1;10;11;0;4;0;7
18102; 79.5 ; 158.9 ; 9.4 ;2;191;57;0;2;0;2;2;0;0;0;2
18103; 49.6 ; 495.6 ; 12.8 ;10;32;36;0;10;1;9;8;2;0;7;3
18104; 30.2 ; 60.4 ; -   ;2;2;69;0;2;1;1;1;1;0;2;0
18105; 80.2 ; 160.3 ; 2.1 ;2;12;157;0;2;0;2;1;1;0;0;2
18106; 68.8 ; 275.3 ; 45.1 ;4;33;58;0;4;0;4;3;1;1;0;3
18107; 27.7 ; 83.1 ; 12.1 ;3;16;250;0;3;1;2;3;0;2;1;0
18108; 76.3 ; 305.3 ; 114.2 ;4;90;147;0;4;1;3;4;0;1;0;3
18109; 52.1 ; 104.2 ; 7.0 ;2;31;11;0;2;0;2;1;1;0;1;1
18110; 17.5 ; 35.0 ; 3.8 ;2;1;252;0;2;0;2;0;2;2;0;0
18111; 36.9 ; 73.8 ; 17.7 ;2;194;106;0;2;0;2;0;2;1;1;0
18112; 43.7 ; 131.0 ; 38.6 ;3;71;143;0;3;0;3;1;2;1;1;1
18113; 15.0 ; 74.9 ; -   ;5;24;175;0;5;1;4;0;5;5;0;0
18114; 61.9 ; 185.7 ; 22.8 ;3;14;11;0;3;0;3;3;0;0;0;3
18115; 30.9 ; 61.7 ; 23.8 ;2;59;126;2;0;1;1;1;1;1;1;0
18116; 31.3 ; 156.7 ; 5.4 ;5;75;23;0;5;3;2;3;2;2;3;0
18117; 33.0 ; 99.0 ; 2.6 ;3;36;61;0;3;1;2;2;1;0;3;0
18118; 27.5 ; 165.1 ; 9.9 ;6;57;98;0;6;1;5;4;2;4;2;0
18119; 41.2 ; 123.7 ; 15.1 ;3;40;223;0;3;2;1;2;1;1;1;1
18120; 30.0 ; 150.1 ; 14.0 ;5;49;4;0;5;1;4;4;1;2;3;0
18121; 25.8 ; 51.6 ; 9.1 ;2;208;0;2;0;0;2;0;2;1;1;0
18122; 54.7 ; 273.4 ; 9.8 ;5;54;54;0;5;2;3;2;3;0;3;2
18123; 46.7 ; 513.8 ; 12.4 ;11;26;14;8;3;4;7;11;0;0;7;4
18124; 42.6 ; 170.4 ; 8.8 ;4;4;263;0;4;2;2;1;3;0;4;0
18125; 92.8 ; 556.9 ; 52.5 ;6;41;137;0;6;3;3;4;2;0;0;6
18126; 22.7 ; 680.6 ; 12.2 ;30;15;2;0;30;23;7;4;26;20;10;0
18127; 33.2 ; 66.4 ; 12.1 ;2;65;26;2;0;1;1;2;0;1;1;0
18128; 56.7 ; 283.3 ; 20.4 ;5;42;104;0;5;1;4;4;1;0;0;5
18129; 47.7 ; 95.5 ; 1.5 ;2;113;199;0;2;0;2;0;2;0;2;0
18130; 55.0 ; 330.3 ; 24.4 ;6;11;15;0;6;0;6;5;1;0;0;6
18131; 54.1 ; 270.7 ; 50.2 ;5;30;92;0;5;2;3;4;1;2;1;2
18132; 20.6 ; 247.2 ; 10.1 ;12;32;67;0;12;7;5;8;4;8;4;0
18133; 53.1 ; 424.8 ; 13.7 ;8;26;23;0;8;3;5;3;5;0;5;3
18134; 21.9 ; 262.8 ; 5.6 ;12;11;161;0;12;7;5;10;2;12;0;0
18135; 30.0 ; 59.9 ; -   ;2;105;137;0;2;0;2;1;1;2;0;0
18136; 74.9 ; 1,198.2 ; 41.0 ;16;12;32;0;16;5;11;8;8;0;0;16
18137; 19.9 ; 99.5 ; 6.7 ;5;40;5;5;0;2;3;4;1;5;0;0
18138; 51.0 ; 102.0 ; -   ;2;68;253;0;2;0;2;1;1;0;2;0
18139; 66.6 ; 333.0 ; 10.9 ;5;3;149;5;0;2;3;2;3;0;0;5
18140; 38.0 ; 759.6 ; 14.2 ;20;12;22;20;0;3;17;10;10;7;13;0
18141; 113.1 ; 226.1 ; 52.9 ;2;126;152;0;2;0;2;1;1;0;0;2
18142; 29.9 ; 89.8 ; 6.3 ;3;50;36;0;3;1;2;1;2;2;1;0
18143; 128.3 ; 384.9 ; 29.2 ;3;16;26;0;3;1;2;2;1;0;0;3
18144; 43.6 ; 87.2 ; 1.7 ;2;5;288;0;2;1;1;2;0;0;2;0
18145; 46.8 ; 93.5 ; -   ;2;14;116;0;2;1;1;1;1;0;2;0
18146; 61.8 ; 432.7 ; 39.5 ;7;46;5;0;7;0;7;7;0;2;0;5
18147; 65.6 ; 131.2 ; 12.1 ;2;53;233;0;2;1;1;1;1;0;0;2
18148; 34.8 ; 208.9 ; 10.1 ;6;56;1;0;6;1;5;1;5;2;4;0
18149; 49.6 ; 99.3 ; 4.3 ;2;26;135;0;2;1;1;2;0;0;2;0
18150; 47.4 ; 236.8 ; 0.6 ;5;31;15;0;5;0;5;4;1;0;5;0
18151; 48.6 ; 242.9 ; 13.4 ;5;49;58;0;5;2;3;5;0;0;3;2
18152; 111.8 ; 223.5 ; 1.6 ;2;11;153;0;2;0;2;1;1;0;0;2
18153; 15.3 ; 213.7 ; 0.8 ;14;5;96;0;14;7;7;10;4;14;0;0
18154; 40.2 ; 321.2 ; 14.0 ;8;17;78;0;8;1;7;8;0;3;5;0
18155; 76.6 ; 153.3 ; -   ;2;3;2;0;2;1;1;2;0;0;0;2
18156; 27.2 ; 54.4 ; 4.6 ;2;10;260;0;2;1;1;0;2;1;1;0
18157; 19.8 ; 59.5 ; 5.3 ;3;95;33;0;3;3;0;0;3;3;0;0
18158; 22.2 ; 44.4 ; 4.3 ;2;8;223;0;2;2;0;0;2;2;0;0
18159; 76.4 ; 382.2 ; 40.4 ;5;74;20;0;5;0;5;5;0;0;0;5
18160; 15.0 ; 30.0 ; -   ;2;11;23;0;2;1;1;2;0;2;0;0
18161; 50.6 ; 354.3 ; 8.1 ;7;66;5;0;7;0;7;4;3;0;5;2
18162; 22.6 ; 45.1 ; -   ;2;15;264;0;2;1;1;1;1;2;0;0
18163; 30.1 ; 60.1 ; 0.2 ;2;5;170;0;2;1;1;2;0;1;1;0
18164; 52.4 ; 104.7 ; 6.8 ;2;193;26;2;0;1;1;1;1;0;1;1
18165; 18.3 ; 55.0 ; 6.2 ;3;95;11;3;0;1;2;3;0;3;0;0
18166; 48.5 ; 145.5 ; 9.1 ;3;48;41;0;3;1;2;1;2;0;2;1
18167; 25.1 ; 50.1 ; -   ;2;86;199;0;2;1;1;2;0;2;0;0
18168; 61.8 ; 123.7 ; 47.4 ;2;49;116;0;2;0;2;2;0;1;0;1
18169; 55.7 ; 278.6 ; 17.0 ;5;25;167;0;5;1;4;1;4;0;0;5
18170; 47.4 ; 237.1 ; 30.0 ;5;50;65;0;5;2;3;3;2;2;1;2
18171; 21.2 ; 127.4 ; 13.4 ;6;41;12;0;6;0;6;2;4;4;2;0
18172; 61.1 ; 244.3 ; 66.7 ;4;61;110;0;4;3;1;1;3;1;0;3
18173; 48.6 ; 145.9 ; -   ;3;9;130;1;2;3;0;1;2;0;3;0
18174; 30.2 ; 181.1 ; -   ;6;46;99;0;6;0;6;6;0;0;6;0
18175; 52.1 ; 1,199.0 ; 17.6 ;23;18;2;0;23;6;17;9;14;0;15;8
18176; 28.0 ; 83.9 ; 22.5 ;3;52;89;0;3;1;2;1;2;2;1;0
18177; 72.2 ; 288.9 ; 48.0 ;4;51;228;0;4;1;3;2;2;1;0;3
18178; 48.3 ; 193.1 ; 18.3 ;4;4;269;0;4;4;0;1;3;1;2;1
18179; 28.9 ; 86.8 ; 22.9 ;3;85;5;0;3;0;3;2;1;2;1;0
18180; 44.0 ; 307.7 ; 10.9 ;7;12;0;0;7;2;5;1;6;0;7;0
18181; 31.7 ; 633.1 ; 23.7 ;20;14;5;0;20;4;16;7;13;7;6;7
18182; 34.5 ; 379.0 ; 7.8 ;11;23;176;0;11;5;6;6;5;4;7;0
18183; 22.5 ; 45.0 ; 4.6 ;2;6;263;0;2;0;2;1;1;2;0;0
18184; 33.1 ; 165.6 ; 16.4 ;5;42;89;0;5;0;5;1;4;2;3;0
18185; 77.6 ; 155.2 ; 23.8 ;2;202;104;0;2;0;2;2;0;0;0;2
18186; 28.2 ; 112.9 ; 4.5 ;4;14;157;0;4;2;2;1;3;3;1;0
18187; 95.8 ; 287.3 ; 37.6 ;3;104;15;0;3;0;3;2;1;0;0;3
18188; 39.8 ; 238.8 ; 13.3 ;6;31;113;0;6;3;3;1;5;2;4;0
18189; 49.6 ; 545.1 ; 15.5 ;11;24;32;0;11;2;9;6;5;0;7;4
18190; 35.6 ; 106.7 ; 12.1 ;3;40;80;0;3;1;2;2;1;1;2;0
18191; 72.8 ; 291.2 ; 37.4 ;4;100;32;0;4;0;4;4;0;0;0;4
18192; 33.9 ; 135.6 ; 4.9 ;4;75;107;0;4;1;3;1;3;1;3;0
18193; 44.4 ; 310.6 ; 18.4 ;7;47;84;6;1;1;6;6;1;2;3;2
18194; 35.6 ; 71.1 ; 8.0 ;2;58;99;2;0;0;2;2;0;1;1;0
18195; 25.8 ; 129.2 ; 8.7 ;5;25;116;0;5;2;3;3;2;3;2;0
18196; 59.7 ; 358.4 ; 10.5 ;6;43;31;0;6;0;6;5;1;0;0;6
18197; 52.5 ; 105.0 ; -   ;2;95;235;0;2;1;1;2;0;0;2;0
18198; 62.9 ; 314.4 ; 19.0 ;5;62;2;0;5;3;2;1;4;0;0;5
18199; 31.9 ; 191.1 ; 9.8 ;6;40;22;0;6;0;6;3;3;2;4;0
18200; 22.2 ; 133.0 ; 9.7 ;6;18;137;6;0;0;6;5;1;4;2;0
18201; 41.6 ; 83.2 ; 24.8 ;2;145;140;0;2;1;1;2;0;1;0;1
18202; 21.6 ; 302.7 ; 6.9 ;14;29;23;0;14;12;2;9;5;14;0;0
18203; 25.1 ; 50.1 ; -   ;2;182;247;0;2;0;2;1;1;2;0;0
18204; 62.8 ; 878.7 ; 27.6 ;14;25;35;0;14;6;8;4;10;0;0;14
18205; 28.9 ; 144.5 ; 3.3 ;5;5;173;0;5;2;3;1;4;3;2;0
18206; 25.8 ; 51.6 ; 16.2 ;2;198;103;0;2;1;1;1;1;1;1;0
18207; 46.8 ; 93.5 ; -   ;2;8;264;0;2;2;0;0;2;0;2;0
18208; 35.6 ; 71.1 ; 7.0 ;2;1;242;0;2;0;2;2;0;1;1;0
18209; 93.5 ; 187.0 ; 70.0 ;2;82;190;1;1;0;2;1;1;1;0;1
18210; 45.7 ; 319.9 ; 12.3 ;7;22;182;0;7;1;6;5;2;0;5;2
18211; 18.6 ; 37.2 ; -   ;2;9;187;0;2;1;1;2;0;2;0;0
18212; 27.7 ; 249.2 ; 23.9 ;9;33;11;0;9;4;5;7;2;6;3;0
18213; 20.2 ; 60.7 ; 2.8 ;3;6;131;0;3;0;3;3;0;3;0;0
18214; 56.0 ; 224.0 ; 5.8 ;4;50;45;0;4;2;2;3;1;0;0;4
18215; 45.7 ; 502.3 ; 20.9 ;11;23;92;0;11;0;11;10;1;4;3;4
18216; 98.3 ; 491.6 ; 35.3 ;5;49;100;0;5;0;5;5;0;0;0;5
18217; 46.8 ; 93.5 ; -   ;2;13;269;0;2;2;0;0;2;0;2;0
18218; 58.5 ; 409.5 ; 17.8 ;7;56;14;0;7;1;6;5;2;0;0;7
18219; 16.8 ; 33.6 ; 2.7 ;2;50;236;0;2;0;2;0;2;2;0;0
18220; 39.5 ; 631.4 ; 8.3 ;16;25;4;0;16;5;11;12;4;0;16;0
18221; 33.4 ; 533.9 ; 5.2 ;16;16;32;1;15;10;6;1;15;5;11;0
18222; 42.4 ; 169.6 ; 13.8 ;4;81;99;0;4;1;3;2;2;1;2;1
18223; 35.2 ; 70.4 ; 7.8 ;2;6;5;0;2;0;2;2;0;1;1;0
18224; 23.3 ; 46.6 ; 10.3 ;2;5;39;2;0;2;0;1;1;1;1;0
18225; 24.2 ; 435.4 ; 11.4 ;18;16;10;0;18;1;17;17;1;12;6;0
18226; 43.1 ; 301.6 ; 13.4 ;7;48;17;0;7;4;3;5;2;2;3;2
18227; 28.5 ; 684.6 ; 8.8 ;24;5;0;0;24;5;19;9;15;16;8;0
18228; 81.8 ; 1,226.9 ; 40.2 ;15;12;22;0;15;5;10;6;9;0;0;15
18229; 56.9 ; 284.7 ; 7.9 ;5;40;5;0;5;0;5;0;5;0;0;5
18230; 48.3 ; 145.0 ; 1.5 ;3;84;215;0;3;1;2;2;1;0;3;0
18231; 22.2 ; 66.6 ; 13.2 ;3;32;199;0;3;0;3;2;1;2;1;0
18232; 45.2 ; 226.0 ; 8.5 ;5;38;5;0;5;1;4;5;0;0;5;0
18233; 38.5 ; 115.6 ; 4.7 ;3;5;245;0;3;3;0;1;2;0;3;0
18234; 33.8 ; 101.3 ; 6.6 ;3;14;258;0;3;1;2;1;2;1;2;0
18235; 27.2 ; 136.1 ; 3.1 ;5;33;110;0;5;0;5;2;3;3;2;0
18236; 22.1 ; 110.6 ; 8.6 ;5;76;31;0;5;1;4;3;2;3;2;0
18237; 36.0 ; 72.0 ; 16.4 ;2;329;40;0;2;2;0;1;1;1;1;0
18238; 52.5 ; 210.2 ; 29.0 ;4;86;65;0;4;3;1;1;3;1;2;1
18239; 109.8 ; 219.6 ; 54.8 ;2;6;248;0;2;2;0;0;2;0;0;2
18240; 57.8 ; 115.5 ; 16.5 ;2;7;233;0;2;2;0;2;0;0;0;2
18241; 44.7 ; 134.2 ; 19.5 ;3;49;50;0;3;1;2;1;2;1;1;1
18242; 66.4 ; 1,194.8 ; 12.8 ;18;13;5;0;18;0;18;14;4;0;0;18
18243; 32.5 ; 129.9 ; 4.8 ;4;84;69;0;4;0;4;4;0;1;3;0
18244; 49.3 ; 197.1 ; 2.8 ;4;38;5;0;4;0;4;3;1;0;4;0
18245; 139.7 ; 279.3 ; 50.7 ;2;1;160;0;2;2;0;2;0;0;0;2
18246; 46.8 ; 93.5 ; -   ;2;22;142;0;2;1;1;0;2;0;2;0
18247; 48.5 ; 291.2 ; 1.6 ;6;63;47;0;6;1;5;4;2;0;6;0
18248; 100.3 ; 301.0 ; 47.4 ;3;81;99;0;3;0;3;3;0;0;0;3
18249; 17.0 ; 85.2 ; 1.7 ;5;23;15;0;5;0;5;1;4;5;0;0
18250; 47.5 ; 332.8 ; 24.5 ;7;14;146;0;7;2;5;3;4;2;3;2
18251; 15.0 ; 45.0 ; -   ;3;141;131;0;3;0;3;3;0;3;0;0
18252; 51.1 ; 255.7 ; 21.4 ;5;41;110;0;5;2;3;1;4;2;1;2
18253; 36.6 ; 183.2 ; 7.1 ;5;61;105;0;5;0;5;1;4;2;3;0
18254; 18.3 ; 55.0 ; 6.2 ;3;39;35;0;3;1;2;2;1;3;0;0
18255; 15.0 ; 30.0 ; -   ;2;30;62;0;2;1;1;0;2;2;0;0
18256; 30.2 ; 60.4 ; -   ;2;62;108;0;2;2;0;0;2;0;2;0
18257; 17.2 ; 34.4 ; 3.3 ;2;5;248;0;2;2;0;0;2;2;0;0
18258; 60.3 ; 422.3 ; 7.7 ;7;18;158;0;7;1;6;1;6;0;0;7
18259; 38.8 ; 77.6 ; 20.5 ;2;219;202;0;2;1;1;1;1;1;0;1
18260; 25.1 ; 50.1 ; -   ;2;81;42;0;2;0;2;1;1;2;0;0
18261; 47.3 ; 236.6 ; 0.6 ;5;81;0;0;5;1;4;4;1;0;5;0
18262; 24.8 ; 49.6 ; 8.0 ;2;25;182;0;2;1;1;2;0;1;1;0
18263; 25.3 ; 480.8 ; 9.5 ;19;8;20;0;19;9;10;11;8;13;6;0
18264; 29.1 ; 116.3 ; 10.5 ;4;50;51;1;3;3;1;1;3;3;1;0
18265; 67.2 ; 403.0 ; 22.1 ;6;35;90;0;6;2;4;4;2;0;0;6
18266; 20.0 ; 40.1 ; 7.6 ;2;395;63;0;2;1;1;0;2;2;0;0
18267; 58.4 ; 175.1 ; 14.5 ;3;40;47;0;3;1;2;1;2;0;0;3
18268; 55.7 ; 111.4 ; 11.2 ;2;3;3;2;0;1;1;0;2;0;0;2
18269; 47.7 ; 95.5 ; 1.5 ;2;13;267;0;2;0;2;2;0;0;2;0
18270; 46.8 ; 187.0 ; -   ;4;5;284;0;4;1;3;3;1;0;4;0
18271; 67.7 ; 135.4 ; 50.1 ;2;6;131;0;2;0;2;1;1;1;0;1
18272; 65.4 ; 326.9 ; 45.1 ;5;36;189;0;5;0;5;3;2;2;0;3
18273; 52.4 ; 104.9 ; 20.9 ;2;32;36;0;2;0;2;2;0;0;1;1
18274; 30.2 ; 60.4 ; -   ;2;25;89;0;2;0;2;2;0;0;2;0
18275; 41.3 ; 577.5 ; 7.9 ;14;16;41;0;14;4;10;13;1;0;14;0
18276; 17.5 ; 87.3 ; 1.5 ;5;55;5;0;5;1;4;1;4;5;0;0
18277; 27.4 ; 301.7 ; 18.8 ;11;26;33;0;11;1;10;8;3;7;4;0
18278; 47.4 ; 236.9 ; 5.6 ;5;29;146;0;5;0;5;5;0;0;5;0
18279; 47.2 ; 236.0 ; 28.3 ;5;30;48;0;5;0;5;2;3;2;1;2
18280; 37.2 ; 260.4 ; 13.4 ;7;28;10;0;7;1;6;3;4;2;5;0
18281; 36.3 ; 108.8 ; 11.3 ;3;115;12;0;3;1;2;1;2;1;2;0
18282; 52.3 ; 1,149.7 ; 22.0 ;22;12;39;0;22;8;14;15;7;0;15;7
18283; 47.7 ; 95.4 ; 1.4 ;2;24;194;1;1;0;2;1;1;0;2;0
18284; 67.5 ; 135.1 ; 21.4 ;2;57;89;0;2;0;2;2;0;0;0;2
18285; 29.0 ; 261.4 ; 13.7 ;9;9;7;9;0;4;5;9;0;6;3;0
18286; 45.4 ; 499.8 ; 13.5 ;11;26;0;0;11;3;8;2;9;0;7;4
18287; 46.2 ; 184.9 ; 12.9 ;4;53;180;0;4;3;1;2;2;0;3;1
18288; 47.4 ; 236.8 ; 0.3 ;5;19;27;0;5;1;4;5;0;0;5;0
18289; 61.3 ; 429.4 ; 26.1 ;7;29;52;7;0;0;7;7;0;0;0;7
18290; 21.1 ; 105.5 ; 13.0 ;5;52;101;0;5;3;2;5;0;3;2;0
18291; 49.2 ; 1,083.3 ; 23.6 ;22;8;5;0;22;7;15;13;9;7;8;7
18292; 57.8 ; 289.0 ; 21.5 ;5;32;197;0;5;4;1;4;1;0;0;5
18293; 49.3 ; 98.6 ; 31.6 ;2;44;164;2;0;2;0;1;1;1;0;1
18294; 41.9 ; 335.5 ; 18.1 ;8;45;6;0;8;3;5;6;2;3;2;3
18295; 118.5 ; 355.4 ; 57.9 ;3;41;167;0;3;0;3;2;1;0;0;3
18296; 44.6 ; 89.3 ; 21.6 ;2;74;53;0;2;0;2;1;1;1;0;1
18297; 46.8 ; 93.5 ; -   ;2;8;255;0;2;1;1;2;0;0;2;0
18298; 76.9 ; 384.3 ; 30.0 ;5;34;83;0;5;0;5;3;2;0;0;5
18299; 19.4 ; 58.2 ; 0.1 ;3;14;302;0;3;3;0;2;1;3;0;0
18300; 71.5 ; 142.9 ; 17.3 ;2;404;37;0;2;0;2;2;0;0;0;2
18301; 42.0 ; 84.1 ; 8.1 ;2;158;26;2;0;0;2;1;1;0;2;0
18302; 29.3 ; 410.6 ; 19.2 ;14;11;0;0;14;4;10;7;7;9;5;0
18303; 128.4 ; 513.4 ; 47.2 ;4;54;21;0;4;0;4;3;1;0;0;4
18304; 27.1 ; 54.2 ; 4.3 ;2;19;93;0;2;1;1;1;1;1;1;0
18305; 58.0 ; 116.0 ; 59.0 ;2;181;116;0;2;0;2;2;0;1;0;1
18306; 58.4 ; 116.8 ; 16.3 ;2;16;70;2;0;1;1;1;1;0;0;2
18307; 44.0 ; 879.2 ; 25.6 ;20;19;75;1;19;17;3;15;5;7;6;7
18308; 33.7 ; 371.2 ; 15.2 ;11;18;15;0;11;7;4;11;0;4;7;0
18309; 32.1 ; 192.6 ; 11.4 ;6;38;99;0;6;0;6;6;0;2;4;0
18310; 47.9 ; 335.4 ; 15.8 ;7;41;78;0;7;2;5;6;1;0;5;2
18311; 49.2 ; 492.0 ; 24.0 ;10;20;35;1;9;8;2;1;9;3;4;3
18312; 43.0 ; 171.9 ; 19.0 ;4;14;71;0;4;1;3;3;1;1;2;1
18313; 57.3 ; 286.3 ; 45.5 ;5;55;40;0;5;2;3;2;3;2;0;3
18314; 35.9 ; 71.8 ; 16.2 ;2;77;200;0;2;1;1;0;2;1;1;0
18315; 73.4 ; 293.5 ; 19.3 ;4;36;17;0;4;3;1;3;1;0;0;4
18316; 22.1 ; 88.3 ; 4.5 ;4;4;258;0;4;3;1;1;3;4;0;0
18317; 53.9 ; 161.8 ; 28.3 ;3;2;258;0;3;2;1;3;0;1;1;1
18318; 48.1 ; 144.2 ; 28.2 ;3;5;232;0;3;1;2;1;2;1;1;1
18319; 47.7 ; 95.4 ; 1.4 ;2;16;189;0;2;1;1;1;1;0;2;0
18320; 53.7 ; 429.5 ; 4.8 ;8;27;89;0;8;2;6;7;1;0;5;3
18321; 30.7 ; 92.2 ; 8.0 ;3;5;38;0;3;2;1;0;3;1;2;0
18322; 54.5 ; 109.0 ; 17.9 ;2;3;152;2;0;1;1;0;2;0;1;1
18323; 33.4 ; 66.8 ; 4.8 ;2;217;80;0;2;1;1;1;1;1;1;0
18324; 55.9 ; 111.7 ; 5.0 ;2;18;1;0;2;0;2;0;2;0;0;2
18325; 28.5 ; 142.6 ; 14.7 ;5;68;49;0;5;4;1;3;2;3;2;0
18326; 16.4 ; 49.2 ; 2.6 ;3;16;235;0;3;1;2;1;2;3;0;0
18327; 31.7 ; 63.3 ; 9.9 ;2;52;216;0;2;1;1;0;2;1;1;0
18328; 49.0 ; 833.3 ; 32.9 ;17;14;64;0;17;7;10;7;10;6;5;6
18329; 18.3 ; 55.0 ; 6.2 ;3;8;205;0;3;1;2;3;0;3;0;0
18330; 27.5 ; 137.7 ; 12.7 ;5;13;42;0;5;0;5;2;3;3;2;0
18331; 15.0 ; 30.0 ; -   ;2;8;36;0;2;1;1;0;2;2;0;0
18332; 31.9 ; 159.5 ; 15.7 ;5;20;20;0;5;3;2;2;3;2;3;0
18333; 37.2 ; 74.4 ; 18.2 ;2;123;64;0;2;1;1;0;2;1;0;1
18334; 23.7 ; 118.7 ; 15.5 ;5;46;116;0;5;1;4;4;1;3;2;0
18335; 23.2 ; 186.0 ; 6.2 ;8;39;17;0;8;1;7;4;4;8;0;0
18336; 74.7 ; 149.4 ; 38.9 ;2;6;252;0;2;0;2;1;1;0;0;2
18337; 39.1 ; 78.1 ; 13.6 ;2;31;20;0;2;2;0;0;2;1;1;0
18338; 40.9 ; 899.7 ; 18.5 ;22;19;0;0;22;5;17;8;14;7;8;7
18339; 54.6 ; 109.2 ; 11.8 ;2;47;120;0;2;1;1;2;0;0;1;1
18340; 74.1 ; 667.0 ; 26.9 ;9;23;5;0;9;1;8;7;2;0;0;9
18341; 32.1 ; 833.8 ; 32.2 ;26;9;4;0;26;4;22;19;7;9;8;9
18342; 31.8 ; 127.4 ; 20.6 ;4;27;26;0;4;0;4;4;0;1;3;0
18343; 21.7 ; 65.1 ; 6.2 ;3;22;75;0;3;3;0;3;0;3;0;0
18344; 45.8 ; 549.5 ; 25.9 ;12;29;35;0;12;9;3;4;8;4;4;4
18345; 30.9 ; 154.6 ; 22.6 ;5;40;52;0;5;1;4;4;1;2;3;0
18346; 28.1 ; 140.5 ; 11.4 ;5;26;5;0;5;0;5;4;1;3;2;0
18347; 22.3 ; 111.7 ; 10.9 ;5;45;116;0;5;2;3;4;1;3;2;0
18348; 60.9 ; 243.6 ; 12.0 ;4;40;163;0;4;1;3;4;0;0;0;4
18349; 20.4 ; 81.6 ; 11.4 ;4;19;5;0;4;0;4;3;1;3;1;0
18350; 42.6 ; 127.9 ; 10.9 ;3;50;20;0;3;0;3;2;1;0;3;0
18351; 50.0 ; 650.4 ; 7.5 ;13;23;15;0;13;0;13;7;6;0;9;4
18352; 36.5 ; 802.4 ; 7.6 ;22;19;26;0;22;0;22;11;11;7;15;0
18353; 46.8 ; 140.3 ; -   ;3;41;115;0;3;0;3;3;0;0;3;0
18354; 73.3 ; 146.6 ; 23.7 ;2;320;34;0;2;2;0;1;1;0;0;2
18355; 34.6 ; 346.3 ; 6.9 ;10;31;6;0;10;2;8;9;1;3;7;0
18356; 15.3 ; 138.1 ; 1.2 ;9;27;68;0;9;1;8;8;1;9;0;0
18357; 28.2 ; 141.1 ; 12.3 ;5;60;20;0;5;3;2;3;2;3;2;0
18358; 37.3 ; 1,194.1 ; 12.1 ;32;5;9;0;32;19;13;28;4;11;21;0
18359; 42.4 ; 805.9 ; 13.4 ;19;11;15;0;19;2;17;16;3;6;7;6
18360; 23.2 ; 255.7 ; 9.2 ;11;19;2;0;11;7;4;3;8;7;4;0
18361; 33.9 ; 135.4 ; 23.3 ;4;9;236;0;4;0;4;1;3;1;2;1
18362; 85.5 ; 427.4 ; 94.6 ;5;41;22;0;5;1;4;3;2;2;0;3
18363; 36.7 ; 183.7 ; 16.6 ;5;67;15;0;5;0;5;3;2;2;3;0
18364; 39.0 ; 117.1 ; 9.1 ;3;5;242;0;3;2;1;2;1;1;2;0
18365; 16.7 ; 116.6 ; 2.4 ;7;23;19;0;7;4;3;0;7;7;0;0
18366; 33.5 ; 803.8 ; 19.9 ;24;14;8;0;24;14;10;9;15;8;16;0
18367; 44.4 ; 88.9 ; 11.8 ;2;5;345;0;2;2;0;1;1;0;1;1
18368; 32.5 ; 195.0 ; 17.1 ;6;37;6;0;6;3;3;3;3;2;4;0
18369; 19.4 ; 155.4 ; 7.2 ;8;34;20;0;8;0;8;6;2;8;0;0
18370; 33.5 ; 100.6 ; 17.4 ;3;101;48;0;3;2;1;2;1;1;2;0
18371; 15.0 ; 30.0 ; -   ;2;155;270;0;2;1;1;2;0;2;0;0
18372; 28.6 ; 572.4 ; 5.7 ;20;8;134;0;20;14;6;10;10;13;7;0
18373; 36.4 ; 109.1 ; 11.9 ;3;43;20;0;3;2;1;3;0;1;2;0
18374; 54.0 ; 108.1 ; 2.3 ;2;127;237;0;2;1;1;0;2;0;1;1
18375; 16.2 ; 129.2 ; 1.6 ;8;32;34;1;7;6;2;2;6;8;0;0
18376; 23.3 ; 372.5 ; 6.7 ;16;23;1;0;16;6;10;6;10;16;0;0
18377; 46.7 ; 93.4 ; 18.4 ;2;62;272;0;2;0;2;2;0;1;0;1
18378; 77.1 ; 385.4 ; 8.7 ;5;54;55;0;5;1;4;1;4;0;0;5
18379; 25.2 ; 176.4 ; 13.8 ;7;18;52;0;7;1;6;2;5;5;2;0
18380; 27.8 ; 55.5 ; 3.2 ;2;4;197;2;0;1;1;0;2;1;1;0
18381; 35.2 ; 281.8 ; 17.7 ;8;25;6;0;8;2;6;2;6;3;5;0
18382; 25.9 ; 77.7 ; 11.4 ;3;160;89;0;3;0;3;1;2;2;1;0
18383; 35.9 ; 143.4 ; 12.2 ;4;84;11;0;4;0;4;2;2;1;3;0
18384; 25.1 ; 225.6 ; -   ;9;19;67;0;9;3;6;4;5;9;0;0
18385; 25.5 ; 127.3 ; 10.0 ;5;43;109;0;5;3;2;3;2;3;2;0
18386; 30.4 ; 60.8 ; 13.9 ;2;2;80;0;2;1;1;0;2;1;1;0
18387; 43.7 ; 1,006.0 ; 30.9 ;23;14;1;0;23;9;14;13;10;8;7;8
18388; 22.7 ; 91.0 ; 12.3 ;4;79;153;0;4;1;3;2;2;3;1;0
18389; 84.1 ; 336.5 ; 46.6 ;4;52;28;0;4;2;2;3;1;0;0;4
18390; 112.7 ; 225.3 ; 140.9 ;2;8;211;2;0;1;1;2;0;1;0;1
18391; 68.9 ; 206.7 ; 39.1 ;3;144;48;0;3;1;2;2;1;1;0;2
18392; 16.4 ; 32.8 ; 2.1 ;2;243;9;0;2;2;0;1;1;2;0;0
18393; 49.4 ; 148.2 ; 3.5 ;3;15;74;1;2;1;2;1;2;0;3;0
18394; 26.1 ; 52.2 ; 11.2 ;2;156;7;2;0;1;1;2;0;1;1;0
18395; 27.8 ; 83.3 ; 10.4 ;3;1;44;0;3;3;0;3;0;2;1;0
18396; 21.9 ; 65.8 ; 7.6 ;3;28;215;0;3;1;2;2;1;3;0;0
18397; 46.2 ; 230.9 ; 10.1 ;5;81;1;0;5;3;2;5;0;0;3;2
18398; 20.0 ; 40.1 ; 7.6 ;2;5;260;0;2;2;0;2;0;2;0;0
18399; 40.1 ; 240.6 ; 11.5 ;6;49;20;1;5;4;2;5;1;2;4;0
18400; 30.3 ; 151.4 ; 15.7 ;5;52;102;0;5;4;1;3;2;2;3;0
18401; 47.4 ; 1,328.3 ; 19.6 ;28;11;30;0;28;21;7;17;11;9;10;9
18402; 43.3 ; 606.3 ; 19.1 ;14;19;31;0;14;1;13;10;4;5;4;5
18403; 28.0 ; 56.0 ; 19.5 ;2;25;64;0;2;0;2;0;2;1;1;0
18404; 40.0 ; 120.0 ; 22.9 ;3;31;216;0;3;0;3;1;2;1;1;1
18405; 70.7 ; 282.9 ; 8.4 ;4;14;41;0;4;0;4;4;0;0;0;4
18406; 73.9 ; 221.7 ; 27.0 ;3;100;111;0;3;0;3;1;2;0;0;3
18407; 15.0 ; 30.0 ; -   ;2;188;141;1;1;0;2;2;0;2;0;0
18408; 69.7 ; 1,603.3 ; 10.3 ;23;14;2;0;23;11;12;6;17;0;0;23
18409; 72.2 ; 433.0 ; 33.7 ;6;31;250;0;6;1;5;4;2;0;0;6
18410; 16.4 ; 213.5 ; 3.9 ;13;23;5;0;13;5;8;2;11;13;0;0
18411; 15.0 ; 30.0 ; -   ;2;54;56;0;2;2;0;0;2;2;0;0
18412; 36.6 ; 73.2 ; -   ;2;14;209;0;2;0;2;2;0;0;2;0
18413; 62.2 ; 124.3 ; 23.1 ;2;185;126;0;2;1;1;1;1;0;0;2
18414; 42.1 ; 547.1 ; 13.1 ;13;10;264;0;13;7;6;3;10;4;5;4
18415; 44.6 ; 89.1 ; 11.9 ;2;165;251;0;2;1;1;2;0;0;1;1
18416; 46.4 ; 602.7 ; 23.2 ;13;29;26;0;13;2;11;5;8;4;5;4
18417; 25.1 ; 50.1 ; -   ;2;14;182;0;2;1;1;2;0;2;0;0
18418; 16.7 ; 83.3 ; 4.4 ;5;70;2;0;5;1;4;4;1;5;0;0
18419; 46.7 ; 326.8 ; 13.4 ;7;49;104;0;7;0;7;3;4;0;5;2
18420; 56.1 ; 112.2 ; 1.2 ;2;2;138;2;0;2;0;0;2;0;0;2
18421; 33.9 ; 135.8 ; 2.9 ;4;21;227;0;4;2;2;4;0;0;4;0
18422; 46.4 ; 324.6 ; 13.0 ;7;44;77;0;7;2;5;3;4;0;5;2
18423; 30.9 ; 92.7 ; -   ;3;5;8;3;0;3;0;1;2;0;3;0
18424; 30.8 ; 123.3 ; 7.0 ;4;7;364;0;4;2;2;1;3;1;3;0
18425; 17.0 ; 84.8 ; 1.6 ;5;20;98;0;5;5;0;2;3;5;0;0
18426; 41.2 ; 370.9 ; 11.1 ;9;28;11;0;9;0;9;5;4;0;9;0
18427; 53.8 ; 268.8 ; 7.8 ;5;93;32;0;5;3;2;3;2;0;3;2
18428; 69.6 ; 278.4 ; 20.2 ;4;36;14;0;4;1;3;2;2;0;0;4
18429; 39.8 ; 119.3 ; 13.5 ;3;66;68;0;3;1;2;3;0;1;2;0
18430; 22.7 ; 91.0 ; 9.5 ;4;96;42;0;4;0;4;1;3;3;1;0
18431; 23.6 ; 848.8 ; 10.1 ;36;7;139;1;35;23;13;21;15;24;12;0
18432; 23.9 ; 263.1 ; 11.4 ;11;15;15;11;0;1;10;6;5;7;4;0
18433; 25.1 ; 50.1 ; -   ;2;10;100;0;2;1;1;2;0;2;0;0
18434; 20.1 ; 60.2 ; 3.7 ;3;66;58;0;3;1;2;1;2;3;0;0
18435; 33.9 ; 203.6 ; 12.9 ;6;49;31;6;0;0;6;4;2;2;4;0
18436; 21.3 ; 64.0 ; 5.1 ;3;2;282;0;3;1;2;1;2;3;0;0
18437; 47.0 ; 281.7 ; 0.4 ;6;38;74;0;6;0;6;1;5;0;6;0
18438; 35.2 ; 317.2 ; 15.1 ;9;32;3;0;9;3;6;2;7;3;6;0
18439; 55.4 ; 221.5 ; 26.4 ;4;100;152;0;4;3;1;1;3;1;0;3
18440; 25.1 ; 75.4 ; 9.3 ;3;83;235;0;3;2;1;2;1;2;1;0
18441; 50.7 ; 202.6 ; 23.2 ;4;25;204;0;4;2;2;2;2;1;2;1
18442; 44.3 ; 177.1 ; 25.7 ;4;5;5;0;4;0;4;1;3;1;2;1
18443; 65.2 ; 325.9 ; 28.6 ;5;32;31;0;5;0;5;3;2;0;0;5
18444; 16.7 ; 50.0 ; 1.9 ;3;9;2;0;3;2;1;1;2;3;0;0
18445; 63.4 ; 316.8 ; 20.6 ;5;66;0;0;5;3;2;1;4;0;0;5
18446; 42.2 ; 211.1 ; 27.4 ;5;65;2;0;5;2;3;2;3;2;1;2
18447; 111.1 ; 333.4 ; 23.3 ;3;79;142;0;3;0;3;3;0;0;0;3
18448; 50.7 ; 101.4 ; 10.5 ;2;51;278;0;2;1;1;0;2;0;1;1
18449; 15.0 ; 30.0 ; -   ;2;259;29;0;2;2;0;1;1;2;0;0
18450; 25.6 ; 870.5 ; 2.1 ;34;13;5;0;34;21;13;17;17;34;0;0
18451; 47.3 ; 94.7 ; 18.9 ;2;51;326;0;2;1;1;1;1;1;0;1
18452; 33.4 ; 66.7 ; 27.5 ;2;9;91;2;0;1;1;1;1;1;0;1
18453; 25.6 ; 588.5 ; 7.4 ;23;14;0;8;15;0;23;21;2;15;8;0
18454; 44.1 ; 308.8 ; 18.9 ;7;33;0;0;7;0;7;7;0;2;3;2
18455; 25.1 ; 50.1 ; -   ;2;8;62;0;2;1;1;1;1;2;0;0
18456; 77.7 ; 310.7 ; 30.2 ;4;35;142;0;4;0;4;4;0;0;0;4
18457; 36.8 ; 110.4 ; 12.5 ;3;61;80;0;3;0;3;3;0;1;2;0
18458; 63.5 ; 127.1 ; 18.0 ;2;38;210;0;2;0;2;1;1;0;0;2
18459; 35.8 ; 501.6 ; 20.2 ;14;17;6;12;2;7;7;9;5;5;4;5
18460; 62.2 ; 124.5 ; 38.4 ;2;81;184;0;2;0;2;1;1;1;0;1
18461; 16.8 ; 33.6 ; 1.8 ;2;31;152;0;2;0;2;1;1;2;0;0
18462; 52.5 ; 105.0 ; -   ;2;69;146;0;2;0;2;2;0;0;2;0
18463; 63.8 ; 574.0 ; 34.5 ;9;30;6;0;9;2;7;1;8;3;0;6
18464; 44.1 ; 88.2 ; 12.6 ;2;1;260;0;2;1;1;1;1;0;1;1
18465; 23.7 ; 118.4 ; 14.1 ;5;49;235;0;5;4;1;4;1;3;2;0
18466; 40.8 ; 163.1 ; 15.8 ;4;36;267;0;4;1;3;4;0;1;2;1
18467; 47.0 ; 93.9 ; 39.3 ;2;10;263;0;2;1;1;1;1;1;0;1
18468; 31.1 ; 155.3 ; 15.9 ;5;14;320;0;5;1;4;2;3;2;3;0
18469; 30.9 ; 61.7 ; 23.8 ;2;91;94;1;1;1;1;1;1;1;1;0
18470; 24.7 ; 123.4 ; 16.7 ;5;5;108;0;5;1;4;1;4;3;2;0
18471; 20.7 ; 1,467.7 ; 8.7 ;71;5;29;0;71;46;25;47;24;71;0;0
18472; 20.4 ; 61.1 ; 5.4 ;3;43;111;0;3;1;2;2;1;3;0;0
18473; 45.3 ; 90.6 ; 9.4 ;2;160;39;1;1;1;1;1;1;0;2;0
18474; 58.6 ; 117.2 ; 3.2 ;2;13;104;2;0;0;2;1;1;0;0;2
18475; 66.3 ; 331.5 ; 32.8 ;5;48;50;0;5;2;3;3;2;0;0;5
18476; 45.4 ; 272.5 ; 7.7 ;6;49;20;0;6;3;3;1;5;0;6;0
18477; 28.5 ; 114.0 ; 1.2 ;4;3;261;0;4;3;1;3;1;4;0;0
18478; 32.9 ; 460.8 ; 13.3 ;14;23;92;0;14;3;11;6;8;5;9;0
18479; 20.1 ; 340.9 ; 9.0 ;17;9;10;0;17;3;14;10;7;17;0;0
18480; 19.3 ; 443.8 ; 8.0 ;23;5;242;0;23;8;15;9;14;23;0;0
18481; 26.8 ; 80.3 ; 3.1 ;3;18;341;0;3;1;2;3;0;3;0;0
18482; 57.2 ; 286.2 ; 23.7 ;5;20;183;0;5;2;3;4;1;0;0;5
18483; 38.6 ; 77.3 ; 6.3 ;2;71;83;0;2;1;1;1;1;0;2;0
18484; 25.1 ; 50.1 ; -   ;2;289;73;0;2;0;2;2;0;2;0;0
18485; 60.1 ; 180.4 ; 26.6 ;3;99;13;0;3;1;2;0;3;0;0;3
18486; 29.1 ; 174.7 ; 10.3 ;6;41;75;0;6;1;5;5;1;4;2;0
18487; 140.2 ; 280.4 ; 87.4 ;2;1;257;0;2;0;2;2;0;0;0;2
18488; 86.6 ; 519.3 ; 17.1 ;6;32;231;0;6;0;6;6;0;0;0;6
18489; 45.6 ; 91.1 ; 7.0 ;2;22;241;0;2;1;1;1;1;0;2;0
18490; 34.4 ; 103.1 ; 17.8 ;3;91;74;0;3;0;3;3;0;1;2;0
18491; 35.6 ; 106.8 ; 12.1 ;3;85;26;0;3;0;3;2;1;1;2;0
18492; 28.4 ; 141.9 ; 12.6 ;5;49;10;0;5;1;4;3;2;3;2;0
18493; 49.0 ; 343.2 ; 14.0 ;7;14;2;7;0;5;2;5;2;0;5;2
18494; 44.6 ; 89.2 ; 38.9 ;2;176;55;1;1;2;0;1;1;1;0;1
18495; 102.0 ; 1,020.1 ; 48.7 ;10;23;20;10;0;2;8;7;3;0;0;10
18496; 42.6 ; 170.5 ; 21.9 ;4;9;0;0;4;1;3;2;2;1;2;1
18497; 33.4 ; 66.8 ; 4.8 ;2;64;68;0;2;0;2;2;0;1;1;0
18498; 37.9 ; 75.8 ; 34.3 ;2;22;136;0;2;1;1;1;1;1;0;1
18499; 67.5 ; 135.0 ; 23.3 ;2;232;42;0;2;0;2;1;1;0;0;2
18500; 18.3 ; 55.0 ; 6.2 ;3;86;5;0;3;1;2;2;1;3;0;0
18501; 39.3 ; 196.5 ; 17.7 ;5;49;68;0;5;2;3;3;2;2;1;2
18502; 49.9 ; 448.7 ; 3.9 ;9;23;15;0;9;0;9;8;1;0;9;0
18503; 93.2 ; 372.8 ; 74.7 ;4;19;65;0;4;2;2;2;2;1;0;3
18504; 46.8 ; 93.5 ; -   ;2;122;170;0;2;1;1;1;1;0;2;0
18505; 50.6 ; 962.1 ; 29.3 ;19;16;10;0;19;0;19;18;1;6;7;6
18506; 62.5 ; 312.3 ; 28.1 ;5;14;141;0;5;2;3;2;3;0;0;5
18507; 36.7 ; 73.4 ; 9.8 ;2;68;86;0;2;2;0;0;2;1;1;0
18508; 25.7 ; 745.2 ; 6.9 ;29;11;16;0;29;11;18;15;14;19;10;0
18509; 33.0 ; 165.1 ; 15.3 ;5;39;131;0;5;0;5;3;2;2;3;0
18510; 39.9 ; 239.4 ; 9.3 ;6;22;5;0;6;1;5;0;6;0;6;0
18511; 24.9 ; 49.8 ; 0.3 ;2;23;260;0;2;1;1;0;2;2;0;0
18512; 51.5 ; 154.6 ; 15.6 ;3;16;300;0;3;0;3;3;0;0;2;1
18513; 57.0 ; 285.0 ; 9.9 ;5;21;110;0;5;0;5;5;0;0;0;5
18514; 52.5 ; 105.0 ; 8.6 ;2;56;68;0;2;0;2;2;0;0;1;1
18515; 44.9 ; 584.2 ; 13.3 ;13;16;10;0;13;0;13;5;8;0;9;4
18516; 72.2 ; 288.7 ; 33.3 ;4;75;63;0;4;2;2;2;2;0;0;4
18517; 30.1 ; 120.6 ; 25.2 ;4;9;62;0;4;1;3;3;1;1;2;1
18518; 56.4 ; 281.8 ; 6.9 ;5;13;96;0;5;4;1;4;1;0;0;5
18519; 20.4 ; 61.1 ; 4.9 ;3;6;113;0;3;2;1;2;1;3;0;0
18520; 39.4 ; 78.8 ; 13.8 ;2;32;246;0;2;0;2;2;0;1;1;0
18521; 47.7 ; 95.5 ; 1.5 ;2;8;255;0;2;1;1;1;1;0;2;0
18522; 51.5 ; 154.5 ; 2.7 ;3;83;32;0;3;2;1;1;2;0;3;0
18523; 39.7 ; 198.3 ; 20.5 ;5;42;92;0;5;0;5;3;2;2;1;2
18524; 49.3 ; 98.7 ; 3.3 ;2;43;226;0;2;0;2;2;0;0;2;0
18525; 29.0 ; 86.9 ; 21.6 ;3;61;164;0;3;1;2;3;0;2;1;0
18526; 30.9 ; 61.7 ; 23.8 ;2;16;229;0;2;2;0;2;0;1;1;0
18527; 80.2 ; 160.3 ; 8.6 ;2;1;303;0;2;1;1;2;0;0;0;2
18528; 46.9 ; 234.3 ; 0.3 ;5;40;74;0;5;3;2;2;3;0;5;0
18529; 52.5 ; 157.4 ; 42.6 ;3;20;65;0;3;3;0;1;2;1;1;1
18530; 25.6 ; 153.6 ; 9.1 ;6;55;38;0;6;2;4;4;2;4;2;0
18531; 36.7 ; 220.2 ; 13.3 ;6;26;11;0;6;0;6;2;4;2;4;0
18532; 46.8 ; 93.5 ; -   ;2;75;322;0;2;1;1;1;1;0;2;0
18533; 30.4 ; 182.5 ; 18.8 ;6;34;11;0;6;0;6;2;4;2;4;0
18534; 22.3 ; 44.5 ; 10.9 ;2;13;271;0;2;2;0;2;0;1;1;0
18535; 25.1 ; 50.1 ; -   ;2;21;56;0;2;1;1;0;2;2;0;0
18536; 46.9 ; 374.9 ; 9.2 ;8;1;249;0;8;3;5;7;1;0;5;3
18537; 23.1 ; 69.4 ; 3.5 ;3;11;258;0;3;2;1;2;1;3;0;0
18538; 15.8 ; 31.7 ; -   ;2;12;54;0;2;1;1;2;0;2;0;0
18539; 21.0 ; 104.9 ; 8.7 ;5;28;175;0;5;5;0;5;0;5;0;0
18540; 28.9 ; 86.7 ; 7.0 ;3;5;338;0;3;2;1;2;1;2;1;0
18541; 20.0 ; 80.1 ; 6.2 ;4;23;2;0;4;3;1;1;3;4;0;0
18542; 22.4 ; 44.7 ; 4.0 ;2;137;116;0;2;0;2;1;1;2;0;0
18543; 42.2 ; 379.8 ; 14.4 ;9;32;26;0;9;2;7;8;1;3;3;3
18544; 30.2 ; 60.4 ; -   ;2;3;99;2;0;1;1;0;2;0;2;0
18545; 25.8 ; 360.9 ; 14.1 ;14;29;5;0;14;5;9;4;10;9;5;0
18546; 47.7 ; 95.5 ; 1.5 ;2;207;121;0;2;0;2;1;1;0;2;0
18547; 20.0 ; 80.1 ; 6.2 ;4;2;119;0;4;3;1;2;2;4;0;0
18548; 38.8 ; 77.7 ; 12.9 ;2;5;44;0;2;1;1;1;1;1;1;0
18549; 21.8 ; 414.7 ; 13.8 ;19;14;1;0;19;7;12;5;14;13;6;0
18550; 30.9 ; 92.6 ; 15.8 ;3;4;40;0;3;1;2;1;2;1;2;0
18551; 28.4 ; 85.3 ; 22.1 ;3;19;218;0;3;3;0;1;2;2;1;0
18552; 20.0 ; 40.1 ; 7.6 ;2;88;41;0;2;0;2;2;0;2;0;0
18553; 44.1 ; 1,412.0 ; 30.6 ;32;12;8;0;32;17;15;15;17;11;10;11
18554; 37.7 ; 75.4 ; 0.3 ;2;98;121;0;2;1;1;1;1;0;2;0
18555; 35.2 ; 175.8 ; 12.7 ;5;19;62;0;5;3;2;2;3;2;3;0
18556; 25.1 ; 50.1 ; -   ;2;304;29;0;2;1;1;1;1;2;0;0
18557; 47.3 ; 709.5 ; 5.8 ;15;12;105;0;15;6;9;15;0;0;15;0
18558; 30.1 ; 210.5 ; 2.7 ;7;14;188;0;7;0;7;7;0;2;5;0
18559; 47.1 ; 94.2 ; 0.5 ;2;283;99;1;1;0;2;2;0;0;2;0
18560; 35.8 ; 71.5 ; 8.0 ;2;28;125;0;2;2;0;2;0;1;1;0
18561; 26.1 ; 104.3 ; 20.7 ;4;31;128;0;4;2;2;3;1;3;1;0
18562; 17.3 ; 207.8 ; 4.7 ;12;22;52;0;12;0;12;11;1;12;0;0
18563; 33.4 ; 66.8 ; 4.8 ;2;82;26;0;2;0;2;2;0;1;1;0
18564; 29.1 ; 87.4 ; 1.9 ;3;6;74;0;3;1;2;1;2;2;1;0
18565; 36.2 ; 181.2 ; 13.3 ;5;74;26;0;5;2;3;4;1;2;3;0
18566; 35.3 ; 1,376.4 ; 20.5 ;39;7;2;0;39;26;13;15;24;13;13;13
18567; 55.7 ; 278.4 ; 12.9 ;5;23;78;0;5;0;5;5;0;0;0;5
18568; 50.0 ; 100.0 ; 3.8 ;2;104;74;0;2;1;1;1;1;0;2;0
18569; 48.0 ; 240.0 ; 13.4 ;5;30;32;0;5;0;5;5;0;0;3;2
18570; 16.4 ; 32.8 ; 2.1 ;2;11;205;0;2;0;2;2;0;2;0;0
18571; 17.3 ; 51.9 ; 0.9 ;3;4;179;0;3;2;1;1;2;3;0;0
18572; 36.3 ; 181.7 ; 11.9 ;5;28;62;0;5;0;5;5;0;2;3;0
18573; 15.2 ; 76.1 ; 0.6 ;5;17;44;5;0;3;2;5;0;5;0;0
18574; 45.2 ; 180.9 ; 6.2 ;4;26;46;4;0;2;2;0;4;0;4;0
18575; 20.7 ; 124.2 ; 10.8 ;6;43;0;0;6;0;6;2;4;4;2;0
18576; 70.8 ; 141.7 ; 36.1 ;2;48;91;0;2;1;1;0;2;0;0;2
18577; 55.2 ; 110.4 ; 3.4 ;2;18;48;1;1;0;2;2;0;0;0;2
18578; 84.4 ; 253.1 ; 43.9 ;3;48;183;0;3;0;3;2;1;0;0;3
18579; 34.6 ; 173.2 ; 13.2 ;5;26;260;0;5;3;2;5;0;2;3;0
18580; 36.4 ; 182.2 ; 9.6 ;5;79;11;0;5;1;4;3;2;2;3;0
18581; 39.1 ; 156.3 ; 15.3 ;4;38;25;0;4;1;3;1;3;1;3;0
18582; 30.2 ; 150.9 ; -   ;5;9;250;0;5;3;2;1;4;0;5;0
18583; 25.8 ; 51.6 ; 16.2 ;2;6;267;0;2;0;2;2;0;1;1;0
18584; 34.8 ; 278.2 ; 16.8 ;8;38;14;0;8;5;3;5;3;3;5;0
18585; 26.6 ; 930.9 ; 12.6 ;35;11;6;0;35;17;18;10;25;23;12;0
18586; 41.9 ; 83.8 ; 4.5 ;2;119;167;0;2;2;0;2;0;0;2;0
18587; 51.5 ; 257.5 ; 5.7 ;5;39;78;0;5;0;5;3;2;0;3;2
18588; 33.1 ; 66.1 ; 20.4 ;2;16;242;0;2;0;2;2;0;1;1;0
18589; 32.6 ; 130.3 ; 9.2 ;4;11;210;0;4;0;4;2;2;1;3;0
18590; 20.6 ; 144.1 ; 13.9 ;7;46;12;0;7;2;5;3;4;5;2;0
18591; 19.8 ; 99.1 ; 6.6 ;5;74;34;0;5;4;1;2;3;5;0;0
18592; 50.0 ; 149.9 ; 23.8 ;3;50;36;0;3;1;2;1;2;1;1;1
18593; 52.5 ; 105.0 ; -   ;2;37;279;0;2;0;2;0;2;0;2;0
18594; 69.9 ; 209.8 ; 7.5 ;3;97;146;0;3;1;2;1;2;0;0;3
18595; 47.8 ; 95.7 ; 0.5 ;2;30;22;0;2;0;2;2;0;0;2;0
18596; 47.7 ; 333.7 ; 17.6 ;7;33;64;0;7;0;7;4;3;0;5;2
18597; 61.9 ; 927.8 ; 10.6 ;15;24;5;1;14;4;11;12;3;0;0;15
18598; 50.7 ; 101.4 ; 3.7 ;2;16;2;0;2;1;1;1;1;0;2;0
18599; 42.3 ; 126.9 ; 5.8 ;3;119;57;0;3;1;2;3;0;0;3;0
18600; 20.0 ; 140.0 ; 7.1 ;7;43;26;0;7;3;4;5;2;7;0;0
18601; 36.7 ; 73.4 ; 32.5 ;2;1;124;0;2;1;1;2;0;1;0;1
18602; 43.9 ; 1,405.7 ; 19.4 ;32;12;10;0;32;8;24;15;17;11;10;11
18603; 44.8 ; 89.6 ; 2.9 ;2;5;304;0;2;0;2;0;2;0;2;0
18604; 50.0 ; 99.9 ; 4.8 ;2;305;18;0;2;1;1;0;2;0;2;0
18605; 28.4 ; 198.7 ; 5.0 ;7;14;4;0;7;4;3;1;6;5;2;0
18606; 38.5 ; 76.9 ; 12.4 ;2;2;288;0;2;0;2;1;1;1;1;0
18607; 47.7 ; 95.4 ; 1.4 ;2;72;328;0;2;1;1;0;2;0;2;0
18608; 25.8 ; 77.4 ; 19.9 ;3;108;43;0;3;1;2;2;1;2;1;0
18609; 46.8 ; 93.5 ; -   ;2;24;244;0;2;2;0;0;2;0;2;0
18610; 34.3 ; 617.0 ; 24.6 ;18;23;8;0;18;6;12;14;4;6;6;6
18611; 38.7 ; 154.9 ; 40.4 ;4;44;15;0;4;1;3;2;2;1;2;1
18612; 84.5 ; 1,013.7 ; 32.7 ;12;23;11;1;11;4;8;6;6;0;0;12
18613; 15.0 ; 74.9 ; -   ;5;16;40;0;5;4;1;2;3;5;0;0
18614; 30.2 ; 241.3 ; 5.5 ;8;7;327;0;8;4;4;1;7;3;5;0
18615; 33.6 ; 335.9 ; 13.3 ;10;15;41;0;10;8;2;10;0;3;7;0
18616; 58.3 ; 349.5 ; 22.9 ;6;51;6;0;6;2;4;3;3;0;0;6
18617; 38.3 ; 115.0 ; 17.2 ;3;11;269;0;3;2;1;2;1;1;1;1
18618; 39.8 ; 318.8 ; 35.1 ;8;14;8;8;0;8;0;1;7;3;2;3
18619; 40.6 ; 81.2 ; 9.2 ;2;51;73;0;2;0;2;2;0;0;2;0
18620; 45.3 ; 271.7 ; 15.1 ;6;16;143;0;6;1;5;4;2;0;4;2
18621; 78.7 ; 236.0 ; 48.6 ;3;32;146;0;3;1;2;2;1;0;0;3
18622; 58.9 ; 176.6 ; 20.7 ;3;72;157;0;3;0;3;1;2;0;0;3
18623; 45.7 ; 228.7 ; 16.0 ;5;23;100;0;5;0;5;2;3;2;1;2
18624; 64.0 ; 383.8 ; 27.3 ;6;23;119;0;6;3;3;3;3;0;0;6
18625; 48.4 ; 241.8 ; 10.1 ;5;31;94;0;5;0;5;3;2;0;3;2
18626; 104.3 ; 417.1 ; 50.9 ;4;82;11;4;0;1;3;4;0;0;0;4
18627; 35.9 ; 143.7 ; 13.3 ;4;32;288;0;4;0;4;2;2;1;3;0
18628; 38.5 ; 76.9 ; 12.4 ;2;19;262;0;2;0;2;2;0;1;1;0
18629; 45.7 ; 457.1 ; 12.2 ;10;39;53;0;10;9;1;2;8;0;7;3
18630; 45.4 ; 90.8 ; 16.5 ;2;3;91;0;2;1;1;2;0;1;0;1
18631; 33.0 ; 99.0 ; 17.5 ;3;5;89;0;3;0;3;2;1;1;2;0
18632; 38.6 ; 115.8 ; 9.2 ;3;15;120;0;3;0;3;3;0;1;2;0
18633; 20.2 ; 40.3 ; 7.8 ;2;18;53;2;0;0;2;1;1;2;0;0
18634; 49.9 ; 249.4 ; 7.1 ;5;48;79;0;5;1;4;4;1;0;3;2
18635; 54.1 ; 108.3 ; 11.1 ;2;73;235;0;2;2;0;1;1;0;1;1
18636; 49.1 ; 2,161.0 ; 36.5 ;44;9;2;0;44;11;33;31;13;15;14;15
18637; 83.1 ; 166.3 ; 70.3 ;2;8;246;0;2;1;1;1;1;1;0;1
18638; 47.9 ; 239.5 ; 2.7 ;5;50;187;0;5;1;4;5;0;0;5;0
18639; 36.9 ; 73.8 ; 17.7 ;2;171;158;0;2;0;2;0;2;1;1;0
18640; 25.1 ; 100.3 ; -   ;4;32;20;0;4;2;2;4;0;4;0;0
18641; 20.0 ; 40.1 ; 7.6 ;2;4;260;0;2;1;1;0;2;2;0;0
18642; 16.9 ; 33.7 ; -   ;2;19;228;0;2;2;0;0;2;2;0;0
18643; 37.9 ; 265.0 ; 3.8 ;7;62;36;0;7;0;7;5;2;0;7;0
18644; 46.8 ; 93.5 ; -   ;2;79;296;0;2;1;1;0;2;0;2;0
18645; 17.7 ; 301.1 ; 3.9 ;17;21;58;0;17;3;14;8;9;17;0;0
18646; 26.0 ; 1,639.7 ; 17.3 ;63;5;13;0;63;27;36;31;32;42;21;0
18647; 29.9 ; 239.3 ; 10.7 ;8;42;66;0;8;6;2;5;3;5;3;0
18648; 67.1 ; 201.3 ; 39.6 ;3;23;64;3;0;1;2;0;3;1;0;2
18649; 22.6 ; 45.2 ; 11.4 ;2;58;273;0;2;0;2;1;1;1;1;0
18650; 14.9 ; 74.6 ; 0.1 ;5;10;3;5;0;4;1;1;4;5;0;0
18651; 73.0 ; 365.2 ; 20.7 ;5;41;52;0;5;0;5;3;2;0;0;5
18652; 18.0 ; 36.1 ; 4.6 ;2;1;278;0;2;0;2;1;1;2;0;0
18653; 36.7 ; 183.7 ; 24.3 ;5;14;2;0;5;3;2;1;4;2;1;2
18654; 50.7 ; 101.4 ; 4.9 ;2;23;17;2;0;1;1;2;0;0;1;1
18655; 49.3 ; 246.6 ; 11.4 ;5;17;2;0;5;2;3;2;3;0;3;2
18656; 34.1 ; 204.5 ; 14.1 ;6;16;236;0;6;0;6;0;6;2;4;0
18657; 87.9 ; 351.6 ; 20.3 ;4;2;288;0;4;1;3;3;1;0;0;4
18658; 31.6 ; 94.7 ; 10.9 ;3;5;149;0;3;2;1;1;2;1;2;0
18659; 17.5 ; 70.0 ; 5.3 ;4;68;51;0;4;4;0;1;3;4;0;0
18660; 24.4 ; 121.9 ; 8.1 ;5;37;74;0;5;3;2;5;0;3;2;0
18661; 28.3 ; 84.8 ; 17.5 ;3;62;74;1;2;1;2;1;2;2;1;0
18662; 46.8 ; 140.3 ; -   ;3;81;194;0;3;0;3;2;1;0;3;0
18663; 43.7 ; 218.3 ; 7.7 ;5;8;239;0;5;3;2;3;2;0;5;0
18664; 26.4 ; 210.8 ; 9.7 ;8;23;22;0;8;0;8;4;4;5;3;0
18665; 34.6 ; 138.5 ; 12.0 ;4;23;99;0;4;2;2;1;3;1;3;0
18666; 55.0 ; 274.9 ; 51.0 ;5;58;89;0;5;1;4;2;3;2;1;2
18667; 36.0 ; 107.9 ; 26.0 ;3;28;152;0;3;1;2;2;1;1;1;1
18668; 98.9 ; 197.9 ; 1.0 ;2;57;242;0;2;0;2;0;2;0;0;2
18669; 22.0 ; 175.8 ; 10.0 ;8;16;32;0;8;2;6;5;3;5;3;0
18670; 61.7 ; 185.1 ; 13.5 ;3;76;29;0;3;1;2;3;0;0;0;3
18671; 60.1 ; 480.7 ; 14.7 ;8;19;10;0;8;0;8;7;1;0;0;8
18672; 22.9 ; 68.7 ; 4.0 ;3;14;77;0;3;2;1;1;2;3;0;0
18673; 20.8 ; 41.6 ; 3.3 ;2;19;360;0;2;2;0;1;1;2;0;0
18674; 54.3 ; 1,575.1 ; 16.1 ;29;10;2;0;29;9;20;14;15;0;19;10
18675; 66.9 ; 133.8 ; 8.0 ;2;5;184;0;2;0;2;1;1;0;0;2
18676; 49.2 ; 147.7 ; 7.3 ;3;90;10;0;3;2;1;2;1;0;2;1
18677; 75.9 ; 911.4 ; 23.8 ;12;27;10;0;12;0;12;5;7;0;0;12
18678; 44.2 ; 132.5 ; 2.4 ;3;11;251;0;3;3;0;1;2;0;3;0
18679; 41.1 ; 82.3 ; 9.2 ;2;10;242;0;2;1;1;0;2;0;2;0
18680; 58.4 ; 1,285.3 ; 19.2 ;22;19;41;0;22;9;13;17;5;0;0;22
18681; 20.5 ; 410.2 ; 6.2 ;20;15;6;0;20;9;11;10;10;20;0;0
18682; 166.1 ; 332.3 ; 35.5 ;2;11;80;0;2;0;2;0;2;0;0;2
18683; 23.0 ; 506.4 ; 8.2 ;22;7;0;0;22;9;13;15;7;15;7;0
18684; 22.0 ; 131.9 ; 4.3 ;6;6;51;0;6;4;2;5;1;6;0;0
18685; 35.6 ; 106.7 ; 9.6 ;3;63;31;0;3;0;3;3;0;1;2;0
18686; 49.9 ; 149.6 ; 36.0 ;3;191;6;1;2;0;3;2;1;1;1;1
18687; 23.2 ; 92.8 ; 8.0 ;4;40;0;3;1;0;4;3;1;3;1;0
18688; 38.3 ; 306.0 ; 21.1 ;8;28;6;0;8;3;5;2;6;3;2;3
18689; 30.4 ; 424.9 ; 8.6 ;14;21;5;0;14;3;11;3;11;5;9;0
18690; 23.6 ; 330.3 ; 9.2 ;14;16;65;0;14;8;6;12;2;9;5;0
18691; 48.2 ; 96.4 ; 17.4 ;2;123;173;0;2;1;1;1;1;0;1;1
18692; 37.3 ; 149.1 ; 9.6 ;4;94;12;0;4;1;3;4;0;1;3;0
18693; 22.6 ; 45.2 ; 11.4 ;2;9;51;0;2;2;0;1;1;1;1;0
18694; 44.8 ; 447.5 ; 13.2 ;10;29;23;0;10;5;5;6;4;0;7;3
18695; 39.8 ; 198.9 ; 34.3 ;5;49;103;0;5;3;2;3;2;2;1;2
18696; 39.0 ; 77.9 ; 11.7 ;2;14;153;0;2;1;1;1;1;1;1;0
18697; 44.3 ; 177.1 ; 2.5 ;4;63;41;0;4;0;4;4;0;0;4;0
18698; 42.2 ; 126.5 ; 9.1 ;3;76;17;0;3;0;3;1;2;0;3;0
18699; 56.7 ; 113.5 ; 38.9 ;2;9;107;0;2;1;1;0;2;1;0;1
18700; 36.6 ; 256.5 ; 23.7 ;7;14;120;0;7;0;7;2;5;2;3;2
18701; 35.5 ; 177.6 ; 11.3 ;5;30;58;0;5;2;3;4;1;2;3;0
18702; 25.8 ; 51.6 ; 16.2 ;2;29;239;0;2;2;0;0;2;1;1;0
18703; 44.2 ; 707.2 ; 5.7 ;16;19;31;0;16;2;14;10;6;0;16;0
18704; 40.0 ; 119.9 ; 6.2 ;3;11;130;1;2;3;0;3;0;0;3;0
18705; 22.0 ; 154.3 ; 4.5 ;7;18;42;0;7;2;5;0;7;7;0;0
18706; 27.9 ; 55.8 ; 13.9 ;2;47;237;0;2;1;1;2;0;1;1;0
18707; 30.8 ; 123.3 ; 0.4 ;4;8;10;0;4;0;4;2;2;0;4;0
18708; 38.3 ; 76.6 ; 12.7 ;2;24;326;0;2;0;2;1;1;1;1;0
18709; 55.3 ; 276.6 ; 26.9 ;5;14;186;4;1;3;2;2;3;2;0;3
18710; 61.0 ; 183.0 ; 7.3 ;3;47;173;0;3;1;2;2;1;0;0;3
18711; 46.8 ; 93.5 ; -   ;2;19;167;0;2;0;2;2;0;0;2;0
18712; 73.0 ; 146.0 ; 36.5 ;2;232;74;0;2;0;2;2;0;0;0;2
18713; 15.0 ; 30.0 ; -   ;2;24;36;1;1;0;2;2;0;2;0;0
18714; 42.5 ; 255.0 ; 6.8 ;6;34;0;0;6;0;6;2;4;0;6;0
18715; 36.9 ; 110.6 ; 6.9 ;3;30;137;0;3;1;2;2;1;1;2;0
18716; 28.9 ; 86.8 ; 17.0 ;3;70;37;0;3;1;2;1;2;2;1;0
18717; 15.0 ; 45.0 ; -   ;3;3;209;1;2;2;1;0;3;3;0;0
18718; 45.0 ; 90.0 ; 3.2 ;2;56;145;0;2;2;0;0;2;0;2;0
18719; 33.1 ; 198.7 ; 13.1 ;6;18;0;0;6;2;4;2;4;2;4;0
18720; 27.1 ; 54.2 ; 1.5 ;2;59;175;0;2;1;1;0;2;2;0;0
18721; 41.1 ; 82.1 ; 32.4 ;2;113;10;0;2;0;2;2;0;1;0;1
18722; 25.1 ; 50.1 ; -   ;2;11;127;2;0;0;2;0;2;2;0;0
18723; 44.8 ; 89.6 ; 2.9 ;2;172;116;1;1;1;1;1;1;0;2;0
18724; 49.4 ; 148.2 ; 31.4 ;3;13;236;0;3;0;3;2;1;1;1;1
18725; 34.3 ; 171.4 ; 14.0 ;5;38;95;0;5;0;5;3;2;2;3;0
18726; 39.1 ; 273.5 ; 12.3 ;7;15;5;0;7;1;6;0;7;2;5;0
18727; 70.2 ; 140.3 ; 4.0 ;2;170;204;0;2;0;2;2;0;0;0;2
18728; 49.6 ; 198.3 ; 4.7 ;4;26;189;0;4;1;3;3;1;0;4;0
18729; 47.5 ; 94.9 ; -   ;2;24;26;0;2;0;2;0;2;0;2;0
18730; 47.4 ; 379.0 ; 1.0 ;8;24;10;0;8;0;8;1;7;0;8;0
18731; 44.6 ; 1,159.1 ; 22.8 ;26;12;26;3;23;10;16;26;0;9;8;9
18732; 18.3 ; 55.0 ; 6.2 ;3;5;152;0;3;2;1;1;2;3;0;0
18733; 24.4 ; 122.0 ; 8.7 ;5;26;52;0;5;0;5;4;1;3;2;0
18734; 28.0 ; 56.0 ; 4.4 ;2;23;1;0;2;0;2;1;1;1;1;0
18735; 21.0 ; 483.5 ; 5.0 ;23;18;34;0;23;8;15;10;13;23;0;0
18736; 34.5 ; 103.5 ; 13.2 ;3;59;204;0;3;0;3;2;1;1;2;0
18737; 35.6 ; 106.8 ; 14.9 ;3;47;83;0;3;0;3;2;1;1;2;0
18738; 47.8 ; 95.7 ; 0.5 ;2;32;23;2;0;2;0;2;0;0;2;0
18739; 50.8 ; 152.5 ; 3.1 ;3;65;54;1;2;1;2;1;2;0;3;0
18740; 25.6 ; 76.7 ; 19.4 ;3;28;173;0;3;0;3;3;0;2;1;0
18741; 35.2 ; 211.4 ; 9.8 ;6;22;241;0;6;3;3;2;4;2;4;0
18742; 39.7 ; 119.1 ; 30.9 ;3;38;152;0;3;1;2;2;1;1;1;1
18743; 29.3 ; 351.8 ; 15.3 ;12;25;22;0;12;4;8;9;3;8;4;0
18744; 27.5 ; 384.6 ; 6.6 ;14;15;14;2;12;4;10;8;6;9;5;0
18745; 48.4 ; 96.8 ; 2.5 ;2;284;17;0;2;2;0;0;2;0;2;0
18746; 41.7 ; 125.1 ; 9.9 ;3;150;20;1;2;1;2;2;1;0;3;0
18747; 46.8 ; 140.3 ; 3.6 ;3;90;111;0;3;1;2;1;2;0;3;0
18748; 45.4 ; 136.3 ; 2.4 ;3;83;121;0;3;1;2;2;1;0;3;0
18749; 38.8 ; 155.2 ; 10.9 ;4;16;234;0;4;3;1;1;3;1;3;0
18750; 15.4 ; 369.9 ; 2.1 ;24;12;10;0;24;11;13;19;5;24;0;0
18751; 38.2 ; 534.9 ; 39.0 ;14;25;8;0;14;6;8;6;8;5;4;5
18752; 30.8 ; 61.7 ; 8.6 ;2;103;40;0;2;1;1;2;0;1;1;0
18753; 41.6 ; 208.0 ; 11.9 ;5;83;11;0;5;0;5;5;0;2;3;0
18754; 26.1 ; 130.7 ; -   ;5;32;0;0;5;1;4;0;5;5;0;0
18755; 38.4 ; 191.9 ; 14.2 ;5;20;5;4;1;2;3;5;0;2;3;0
18756; 34.5 ; 241.2 ; 2.7 ;7;28;31;0;7;2;5;3;4;0;7;0
18757; 40.2 ; 120.7 ; 11.9 ;3;77;38;0;3;0;3;2;1;1;2;0
18758; 71.8 ; 215.4 ; -   ;3;32;104;0;3;0;3;3;0;0;0;3
18759; 36.8 ; 73.6 ; 22.4 ;2;46;99;1;1;0;2;0;2;1;0;1
18760; 24.8 ; 49.6 ; 0.5 ;2;4;212;0;2;1;1;1;1;2;0;0
18761; 45.0 ; 585.3 ; 9.3 ;13;20;70;0;13;8;5;13;0;0;13;0
18762; 74.6 ; 1,119.1 ; 30.4 ;15;11;242;0;15;9;6;13;2;0;0;15
18763; 58.9 ; 1,414.1 ; 35.8 ;24;14;89;0;24;7;17;9;15;8;0;16
18764; 35.2 ; 70.4 ; 18.4 ;2;150;26;1;1;0;2;1;1;1;1;0
18765; 32.7 ; 130.9 ; 13.2 ;4;18;105;0;4;2;2;2;2;1;3;0
18766; 48.6 ; 97.2 ; -   ;2;7;237;0;2;1;1;1;1;0;2;0
18767; 51.9 ; 103.7 ; 0.6 ;2;14;93;2;0;1;1;2;0;0;2;0
18768; 26.9 ; 107.6 ; 8.6 ;4;11;91;0;4;4;0;1;3;3;1;0
18769; 43.0 ; 214.9 ; 9.7 ;5;72;57;0;5;0;5;3;2;0;5;0
18770; 15.0 ; 89.9 ; -   ;6;36;85;0;6;1;5;1;5;6;0;0
18771; 15.0 ; 45.0 ; -   ;3;72;157;0;3;1;2;1;2;3;0;0
18772; 32.3 ; 96.9 ; 13.3 ;3;21;254;0;3;1;2;1;2;1;2;0
18773; 49.2 ; 98.5 ; 2.6 ;2;334;79;0;2;0;2;1;1;0;2;0
18774; 17.7 ; 123.6 ; 1.1 ;7;23;24;0;7;4;3;2;5;7;0;0
18775; 55.3 ; 442.7 ; 5.0 ;8;31;22;0;8;1;7;7;1;0;0;8
18776; 32.0 ; 192.0 ; 9.6 ;6;33;64;0;6;0;6;6;0;2;4;0
18777; 53.5 ; 160.4 ; 2.1 ;3;50;116;0;3;1;2;1;2;0;2;1
18778; 62.2 ; 124.3 ; 23.1 ;2;16;236;0;2;1;1;0;2;0;0;2
18779; 28.3 ; 141.7 ; 8.5 ;5;42;62;0;5;0;5;4;1;3;2;0
18780; 49.6 ; 248.0 ; 27.3 ;5;57;26;0;5;0;5;2;3;2;1;2
18781; 41.7 ; 83.4 ; 7.6 ;2;345;0;0;2;0;2;1;1;0;2;0
18782; 30.8 ; 61.7 ; 8.6 ;2;16;115;0;2;1;1;1;1;1;1;0
18783; 21.6 ; 215.7 ; 7.7 ;10;35;36;0;10;0;10;4;6;10;0;0
18784; 51.6 ; 103.2 ; -   ;2;6;118;0;2;2;0;2;0;0;2;0
18785; 20.2 ; 806.5 ; 10.4 ;40;10;11;0;40;11;29;8;32;27;13;0
18786; 24.4 ; 122.1 ; 13.8 ;5;2;242;0;5;1;4;2;3;3;2;0
18787; 59.9 ; 239.7 ; 32.9 ;4;79;38;0;4;1;3;2;2;1;0;3
18788; 17.3 ; 34.7 ; 3.5 ;2;9;323;0;2;1;1;0;2;2;0;0
18789; 47.6 ; 238.2 ; 6.0 ;5;47;79;0;5;0;5;4;1;0;5;0
18790; 21.9 ; 241.0 ; 9.7 ;11;19;200;0;11;3;8;10;1;7;4;0
18791; 117.9 ; 235.7 ; 103.5 ;2;151;152;0;2;0;2;2;0;1;0;1
18792; 36.3 ; 72.5 ; 16.8 ;2;20;98;0;2;1;1;1;1;1;1;0
18793; 34.6 ; 69.2 ; 22.4 ;2;84;248;0;2;1;1;1;1;1;0;1
18794; 47.6 ; 142.9 ; 1.0 ;3;58;50;3;0;1;2;3;0;0;3;0
18795; 28.2 ; 338.5 ; 9.6 ;12;18;33;0;12;3;9;4;8;8;4;0
18796; 40.0 ; 199.8 ; 15.2 ;5;32;38;0;5;3;2;3;2;2;1;2
18797; 15.0 ; 59.9 ; -   ;4;50;20;4;0;0;4;2;2;4;0;0
18798; 24.3 ; 48.6 ; 8.5 ;2;23;234;0;2;2;0;2;0;1;1;0
18799; 49.5 ; 99.0 ; 9.9 ;2;37;320;0;2;0;2;2;0;0;1;1
18800; 18.3 ; 55.0 ; 6.2 ;3;29;105;0;3;0;3;1;2;3;0;0
18801; 49.5 ; 1,139.6 ; 29.0 ;23;17;2;0;23;0;23;19;4;8;7;8
18802; 28.4 ; 141.8 ; 2.7 ;5;54;62;0;5;1;4;2;3;3;2;0
18803; 56.1 ; 112.2 ; 11.2 ;2;12;173;0;2;0;2;2;0;0;0;2
18804; 35.3 ; 423.5 ; 19.9 ;12;15;5;0;12;4;8;8;4;4;4;4
18805; 57.7 ; 115.3 ; 16.3 ;2;94;173;0;2;0;2;1;1;0;0;2
18806; 26.5 ; 53.0 ; 2.1 ;2;57;188;0;2;2;0;0;2;2;0;0
18807; 51.2 ; 255.9 ; 16.5 ;5;47;63;0;5;0;5;3;2;0;3;2
18808; 49.0 ; 637.3 ; 14.5 ;13;20;32;0;13;8;5;8;5;0;9;4
18809; 47.6 ; 285.5 ; 5.3 ;6;38;29;0;6;1;5;6;0;0;6;0
18810; 23.9 ; 119.5 ; 8.9 ;5;43;212;0;5;3;2;2;3;3;2;0
18811; 52.0 ; 259.8 ; 5.0 ;5;51;43;0;5;2;3;4;1;0;3;2
18812; 40.9 ; 163.7 ; 18.4 ;4;47;141;0;4;3;1;3;1;1;2;1
18813; 29.4 ; 235.1 ; 18.6 ;8;30;81;0;8;3;5;1;7;5;3;0
18814; 55.8 ; 167.3 ; 36.8 ;3;45;314;0;3;0;3;3;0;1;0;2
18815; 32.7 ; 424.5 ; 15.7 ;13;23;6;0;13;10;3;6;7;4;9;0
18816; 75.0 ; 225.0 ; 30.6 ;3;58;65;0;3;2;1;1;2;0;0;3
18817; 19.7 ; 39.3 ; -   ;2;7;113;0;2;2;0;0;2;2;0;0
18818; 28.3 ; 113.3 ; 13.9 ;4;41;47;0;4;0;4;2;2;3;1;0
18819; 53.1 ; 1,222.3 ; 27.8 ;23;13;4;0;23;15;8;3;20;8;7;8
18820; 50.0 ; 100.0 ; 3.8 ;2;402;69;1;1;0;2;2;0;0;2;0
18821; 36.9 ; 73.8 ; 17.7 ;2;5;53;0;2;0;2;0;2;1;1;0
18822; 55.3 ; 553.3 ; 6.8 ;10;24;69;0;10;0;10;10;0;0;0;10
18823; 60.1 ; 240.4 ; 4.6 ;4;29;6;0;4;0;4;1;3;0;0;4
18824; 33.5 ; 100.4 ; 5.4 ;3;106;17;0;3;1;2;1;2;1;2;0
18825; 37.6 ; 75.2 ; 18.8 ;2;5;83;2;0;1;1;1;1;1;0;1
18826; 28.7 ; 143.6 ; 9.8 ;5;15;165;0;5;3;2;2;3;3;2;0
18827; 35.9 ; 71.8 ; 16.2 ;2;24;268;0;2;0;2;2;0;1;1;0
18828; 65.2 ; 325.9 ; 23.6 ;5;80;20;1;4;1;4;5;0;0;0;5
18829; 53.6 ; 428.5 ; 41.4 ;8;22;5;7;1;0;8;6;2;3;2;3
18830; 70.3 ; 140.6 ; 34.7 ;2;12;136;0;2;0;2;2;0;0;0;2
18831; 23.9 ; 239.3 ; 3.2 ;10;12;201;0;10;8;2;8;2;10;0;0
18832; 30.0 ; 59.9 ; -   ;2;18;230;0;2;0;2;2;0;2;0;0
18833; 24.0 ; 47.9 ; 8.0 ;2;5;154;2;0;1;1;2;0;1;1;0
18834; 27.8 ; 55.5 ; 10.0 ;2;245;142;0;2;0;2;2;0;1;1;0
18835; 39.5 ; 355.2 ; 18.7 ;9;23;202;0;9;9;0;1;8;3;3;3
18836; 15.0 ; 30.0 ; -   ;2;25;128;0;2;2;0;2;0;2;0;0
18837; 25.6 ; 102.6 ; 12.9 ;4;76;153;0;4;1;3;3;1;3;1;0
18838; 17.0 ; 254.5 ; 2.3 ;15;17;8;0;15;12;3;2;13;15;0;0
18839; 37.5 ; 600.6 ; 20.0 ;16;17;5;0;16;5;11;5;11;5;6;5
18840; 27.4 ; 109.7 ; 17.5 ;4;27;131;0;4;0;4;2;2;3;1;0
18841; 26.5 ; 79.5 ; 2.6 ;3;16;98;0;3;1;2;2;1;3;0;0
18842; 60.0 ; 959.8 ; 27.7 ;16;21;12;0;16;8;8;3;13;0;0;16
18843; 34.9 ; 384.0 ; 9.8 ;11;23;137;0;11;0;11;1;10;4;7;0
18844; 39.9 ; 239.3 ; 9.3 ;6;14;231;0;6;3;3;6;0;0;6;0
18845; 47.6 ; 142.9 ; 1.6 ;3;22;84;0;3;0;3;3;0;0;3;0
18846; 49.1 ; 98.2 ; 0.7 ;2;38;125;2;0;2;0;0;2;0;2;0
18847; 46.7 ; 233.3 ; 16.6 ;5;50;72;0;5;3;2;3;2;0;3;2
18848; 58.6 ; 527.5 ; 21.5 ;9;43;5;0;9;4;5;5;4;0;0;9
18849; 19.7 ; 78.9 ; 4.6 ;4;16;150;0;4;3;1;3;1;4;0;0
18850; 62.8 ; 313.9 ; 18.5 ;5;64;59;0;5;1;4;3;2;0;0;5
18851; 37.4 ; 859.2 ; 17.1 ;23;9;17;0;23;4;19;18;5;8;15;0
18852; 93.6 ; 468.1 ; 36.4 ;5;34;52;0;5;0;5;5;0;0;0;5
18853; 56.0 ; 224.0 ; 14.6 ;4;50;68;0;4;1;3;1;3;0;0;4
18854; 20.0 ; 40.1 ; 7.6 ;2;23;365;0;2;1;1;2;0;2;0;0
18855; 26.1 ; 78.2 ; 9.7 ;3;101;94;0;3;0;3;1;2;2;1;0
18856; 77.2 ; 386.2 ; 24.6 ;5;48;89;0;5;1;4;2;3;0;0;5
18857; 29.0 ; 115.8 ; 19.7 ;4;67;29;4;0;1;3;4;0;3;1;0
18858; 44.9 ; 1,078.8 ; 6.3 ;24;11;26;0;24;6;18;9;15;0;24;0
18859; 45.2 ; 90.4 ; 39.9 ;2;1;276;0;2;1;1;2;0;1;0;1
18860; 40.3 ; 242.0 ; 12.0 ;6;52;42;0;6;0;6;5;1;2;4;0
18861; 19.3 ; 77.0 ; 2.8 ;4;57;134;0;4;2;2;4;0;4;0;0
18862; 47.5 ; 94.9 ; -   ;2;14;53;0;2;1;1;2;0;0;2;0
18863; 88.8 ; 444.2 ; 92.0 ;5;17;63;0;5;0;5;1;4;2;0;3
18864; 115.5 ; 231.1 ; 5.7 ;2;303;160;0;2;2;0;1;1;0;0;2
18865; 32.5 ; 162.6 ; 13.7 ;5;22;279;0;5;3;2;5;0;2;3;0
18866; 22.8 ; 91.3 ; 5.6 ;4;45;73;0;4;2;2;3;1;4;0;0
18867; 25.9 ; 337.0 ; 10.9 ;13;15;114;0;13;6;7;2;11;9;4;0
18868; 39.0 ; 195.2 ; 11.0 ;5;25;257;0;5;0;5;1;4;2;3;0
18869; 17.9 ; 71.5 ; 2.6 ;4;36;127;0;4;2;2;3;1;4;0;0
18870; 21.9 ; 371.9 ; 4.1 ;17;21;5;0;17;0;17;5;12;17;0;0
18871; 25.0 ; 124.8 ; 10.9 ;5;67;5;0;5;1;4;3;2;3;2;0
18872; 62.2 ; 186.6 ; 32.5 ;3;52;153;0;3;1;2;2;1;1;0;2
18873; 41.6 ; 124.8 ; 20.4 ;3;14;101;0;3;1;2;1;2;1;1;1
18874; 53.2 ; 478.9 ; 1.9 ;9;20;59;0;9;0;9;8;1;0;6;3
18875; 48.9 ; 97.8 ; 3.2 ;2;7;262;0;2;0;2;1;1;0;2;0
18876; 35.9 ; 71.8 ; 16.2 ;2;58;72;0;2;1;1;2;0;1;1;0
18877; 70.8 ; 141.6 ; 17.8 ;2;289;17;0;2;0;2;1;1;0;0;2
18878; 23.0 ; 322.6 ; 8.3 ;14;32;14;0;14;6;8;3;11;9;5;0
18879; 25.1 ; 50.1 ; -   ;2;14;255;0;2;1;1;1;1;2;0;0
18880; 96.6 ; 193.2 ; 1.0 ;2;177;119;1;1;1;1;2;0;0;0;2
18881; 68.5 ; 274.1 ; 2.6 ;4;74;83;0;4;1;3;4;0;0;0;4
18882; 20.3 ; 305.1 ; 6.6 ;15;12;24;0;15;11;4;14;1;15;0;0
18883; 46.1 ; 138.4 ; 3.2 ;3;91;10;0;3;0;3;1;2;0;3;0
18884; 46.6 ; 233.2 ; 6.4 ;5;5;272;0;5;0;5;3;2;0;5;0
18885; 31.0 ; 123.9 ; 12.5 ;4;33;131;0;4;0;4;1;3;1;3;0
18886; 38.5 ; 76.9 ; 12.4 ;2;12;257;0;2;0;2;2;0;1;1;0
18887; 52.1 ; 104.2 ; 8.0 ;2;51;161;0;2;2;0;1;1;0;1;1
18888; 38.9 ; 194.7 ; 18.5 ;5;59;5;0;5;2;3;2;3;2;1;2
18889; 31.5 ; 220.7 ; 21.6 ;7;18;16;0;7;0;7;5;2;2;5;0
18890; 59.9 ; 299.7 ; 39.2 ;5;16;188;0;5;4;1;1;4;2;0;3
18891; 55.9 ; 391.2 ; 24.9 ;7;24;52;0;7;1;6;4;3;0;0;7
18892; 25.4 ; 76.1 ; 9.5 ;3;88;20;0;3;1;2;3;0;2;1;0
18893; 40.6 ; 243.6 ; 9.0 ;6;16;126;6;0;1;5;6;0;0;6;0
18894; 90.1 ; 180.2 ; 7.2 ;2;13;36;0;2;0;2;2;0;0;0;2
18895; 39.0 ; 77.9 ; 11.7 ;2;87;194;0;2;0;2;2;0;1;1;0
18896; 25.1 ; 125.6 ; 7.7 ;5;7;295;0;5;2;3;3;2;3;2;0
18897; 20.0 ; 40.1 ; 7.6 ;2;76;356;0;2;1;1;1;1;2;0;0
18898; 26.5 ; 53.0 ; 2.1 ;2;71;128;0;2;2;0;0;2;2;0;0
18899; 66.0 ; 197.9 ; 36.9 ;3;153;2;2;1;2;1;1;2;1;0;2
18900; 70.1 ; 140.3 ; 35.0 ;2;24;104;0;2;0;2;2;0;0;0;2
18901; 90.4 ; 1,084.3 ; 27.5 ;12;26;0;0;12;2;10;10;2;0;0;12
18902; 46.1 ; 507.1 ; 5.0 ;11;41;15;0;11;1;10;11;0;0;11;0
18903; 61.6 ; 246.3 ; 10.7 ;4;82;63;0;4;0;4;4;0;0;0;4
18904; 34.2 ; 102.6 ; 19.2 ;3;22;188;0;3;1;2;2;1;1;2;0
18905; 21.3 ; 85.0 ; 7.9 ;4;49;53;0;4;2;2;2;2;4;0;0
18906; 73.1 ; 365.6 ; 45.7 ;5;48;20;4;1;4;1;5;0;2;0;3
18907; 63.9 ; 255.7 ; 4.5 ;4;77;10;0;4;0;4;3;1;0;0;4
18908; 27.7 ; 138.4 ; 2.4 ;5;63;77;0;5;2;3;1;4;3;2;0
18909; 66.4 ; 199.2 ; 44.6 ;3;52;35;0;3;2;1;1;2;1;0;2
18910; 38.6 ; 77.2 ; 28.9 ;2;13;110;0;2;0;2;1;1;1;0;1
18911; 41.8 ; 418.3 ; 20.3 ;10;24;31;0;10;3;7;7;3;3;4;3
18912; 95.4 ; 190.9 ; 2.9 ;2;35;233;0;2;1;1;0;2;0;0;2
18913; 17.9 ; 250.0 ; 4.8 ;14;19;59;0;14;1;13;7;7;14;0;0
18914; 33.7 ; 101.1 ; 15.8 ;3;22;265;0;3;3;0;2;1;1;2;0
18915; 43.1 ; 129.2 ; 33.7 ;3;45;17;0;3;1;2;3;0;1;1;1
18916; 15.0 ; 30.0 ; -   ;2;31;79;1;1;0;2;2;0;2;0;0
18917; 92.9 ; 2,602.3 ; 43.5 ;28;12;5;0;28;7;21;23;5;0;0;28
18918; 21.1 ; 63.2 ; 8.5 ;3;28;170;0;3;3;0;1;2;3;0;0
18919; 64.2 ; 834.3 ; 4.4 ;13;22;5;0;13;3;10;4;9;0;0;13
18920; 50.7 ; 101.4 ; 17.3 ;2;128;99;1;1;1;1;2;0;0;1;1
18921; 42.1 ; 210.4 ; 12.3 ;5;42;8;0;5;3;2;2;3;2;3;0
18922; 34.5 ; 103.6 ; 30.4 ;3;4;176;0;3;3;0;1;2;1;1;1
18923; 61.3 ; 245.2 ; 30.7 ;4;107;1;0;4;3;1;2;2;0;0;4
18924; 77.0 ; 461.8 ; 83.5 ;6;16;32;0;6;0;6;1;5;2;0;4
18925; 28.5 ; 228.3 ; 9.2 ;8;43;0;0;8;0;8;3;5;5;3;0
18926; 45.8 ; 183.1 ; 20.4 ;4;8;194;0;4;2;2;1;3;1;2;1
18927; 53.0 ; 264.9 ; 3.2 ;5;8;1;0;5;4;1;3;2;0;3;2
18928; 40.2 ; 80.4 ; 22.7 ;2;201;184;0;2;0;2;0;2;1;0;1
18929; 39.0 ; 195.0 ; 29.8 ;5;61;5;0;5;1;4;0;5;2;1;2
18930; 45.4 ; 318.0 ; 11.9 ;7;38;160;0;7;0;7;7;0;0;5;2
18931; 54.0 ; 216.2 ; 14.1 ;4;52;141;0;4;1;3;2;2;0;3;1
18932; 43.5 ; 348.2 ; 26.0 ;8;22;36;0;8;0;8;4;4;3;2;3
18933; 54.8 ; 274.0 ; 13.1 ;5;38;152;0;5;0;5;3;2;0;3;2
18934; 61.1 ; 733.7 ; 34.7 ;12;30;0;0;12;1;11;8;4;4;0;8
18935; 58.5 ; 292.7 ; 11.7 ;5;13;10;0;5;2;3;5;0;0;0;5
18936; 25.8 ; 51.6 ; 16.2 ;2;64;22;0;2;1;1;2;0;1;1;0
18937; 35.5 ; 71.0 ; 15.6 ;2;4;304;0;2;1;1;1;1;1;1;0
18938; 48.7 ; 97.4 ; -   ;2;32;93;0;2;1;1;2;0;0;2;0
18939; 64.2 ; 192.7 ; 17.7 ;3;200;30;1;2;2;1;3;0;0;0;3
18940; 30.2 ; 60.4 ; -   ;2;21;364;0;2;2;0;1;1;0;2;0
18941; 23.2 ; 208.8 ; 7.1 ;9;43;22;0;9;1;8;7;2;6;3;0
18942; 35.4 ; 106.3 ; 6.2 ;3;101;111;0;3;1;2;3;0;1;2;0
18943; 45.7 ; 593.9 ; 27.2 ;13;14;15;0;13;4;9;9;4;4;5;4
18944; 38.6 ; 269.9 ; 20.2 ;7;24;25;0;7;6;1;6;1;2;3;2
18945; 34.7 ; 173.4 ; 15.5 ;5;62;95;0;5;1;4;2;3;2;3;0
18946; 20.0 ; 40.1 ; 7.6 ;2;31;253;0;2;0;2;0;2;2;0;0
18947; 38.4 ; 307.2 ; 20.6 ;8;34;1;0;8;5;3;1;7;3;2;3
18948; 101.0 ; 202.0 ; 58.8 ;2;43;110;0;2;0;2;1;1;0;0;2
18949; 52.9 ; 370.2 ; 19.6 ;7;36;53;0;7;1;6;3;4;0;5;2
18950; 40.1 ; 561.7 ; 16.5 ;14;17;65;0;14;6;8;6;8;5;4;5
18951; 21.8 ; 109.2 ; 4.3 ;5;23;173;0;5;1;4;2;3;5;0;0
18952; 45.4 ; 272.2 ; 37.1 ;6;34;68;0;6;5;1;2;4;2;2;2
18953; 55.0 ; 110.0 ; 3.7 ;2;75;99;0;2;0;2;0;2;0;0;2
18954; 77.6 ; 155.2 ; 7.6 ;2;131;99;0;2;0;2;0;2;0;0;2
18955; 30.8 ; 246.4 ; 15.5 ;8;27;116;0;8;0;8;5;3;3;5;0
18956; 27.3 ; 355.0 ; 19.1 ;13;24;1;0;13;6;7;9;4;9;4;0
18957; 26.1 ; 182.6 ; 24.9 ;7;9;90;0;7;1;6;2;5;5;2;0
18958; 20.7 ; 103.6 ; 4.1 ;5;34;21;0;5;0;5;2;3;5;0;0
18959; 59.4 ; 118.9 ; 14.0 ;2;8;6;2;0;1;1;1;1;0;0;2
18960; 38.4 ; 153.7 ; 11.4 ;4;131;31;0;4;1;3;3;1;1;3;0
18961; 42.2 ; 168.8 ; 28.1 ;4;81;182;0;4;2;2;4;0;1;2;1
18962; 43.2 ; 86.4 ; 0.5 ;2;82;47;0;2;0;2;0;2;0;2;0
18963; 47.0 ; 93.9 ; 0.8 ;2;358;99;1;1;0;2;0;2;0;2;0
18964; 37.0 ; 111.0 ; 25.5 ;3;4;131;0;3;0;3;3;0;1;1;1
18965; 33.6 ; 134.6 ; 14.2 ;4;38;179;0;4;0;4;4;0;1;3;0
18966; 42.6 ; 127.8 ; 26.6 ;3;6;227;0;3;1;2;1;2;1;1;1
18967; 35.8 ; 178.8 ; 7.7 ;5;32;93;0;5;2;3;2;3;2;3;0
18968; 16.2 ; 97.3 ; 1.6 ;6;17;121;0;6;1;5;2;4;6;0;0
18969; 36.6 ; 109.8 ; -   ;3;137;116;0;3;2;1;3;0;0;3;0
18970; 45.7 ; 365.4 ; 27.8 ;8;26;52;0;8;1;7;4;4;3;2;3
18971; 57.9 ; 231.4 ; 29.1 ;4;20;170;0;4;1;3;4;0;1;0;3
18972; 42.0 ; 461.7 ; 25.1 ;11;28;0;0;11;3;8;8;3;4;3;4
18973; 48.3 ; 241.6 ; 4.1 ;5;32;157;0;5;0;5;5;0;0;5;0
18974; 47.2 ; 188.9 ; 1.0 ;4;39;118;0;4;3;1;1;3;0;4;0
18975; 35.6 ; 71.2 ; 21.7 ;2;8;101;2;0;2;0;1;1;1;0;1
18976; 65.0 ; 195.1 ; 16.7 ;3;85;5;0;3;1;2;3;0;0;0;3
18977; 42.4 ; 509.0 ; 14.7 ;12;6;14;0;12;3;9;3;9;4;4;4
18978; 68.2 ; 204.7 ; 20.9 ;3;40;29;3;0;1;2;1;2;0;0;3
18979; 29.9 ; 448.5 ; 20.5 ;15;20;65;0;15;5;10;11;4;10;5;0
18980; 46.8 ; 93.5 ; -   ;2;12;116;0;2;0;2;2;0;0;2;0
18981; 41.2 ; 82.5 ; 39.3 ;2;177;43;0;2;1;1;0;2;1;0;1
18982; 18.6 ; 37.2 ; -   ;2;122;155;0;2;1;1;0;2;2;0;0
18983; 48.5 ; 291.1 ; 18.9 ;6;50;0;0;6;3;3;4;2;2;2;2
18984; 75.6 ; 302.3 ; 22.6 ;4;55;40;0;4;1;3;4;0;0;0;4
18985; 34.4 ; 721.7 ; 23.3 ;21;7;2;0;21;17;4;14;7;7;7;7
18986; 24.1 ; 216.6 ; 13.9 ;9;33;5;0;9;1;8;7;2;6;3;0
18987; 43.8 ; 87.6 ; 10.8 ;2;166;137;0;2;1;1;2;0;0;2;0
18988; 29.5 ; 88.5 ; 14.7 ;3;40;5;0;3;2;1;0;3;2;1;0
18989; 26.8 ; 80.3 ; 3.1 ;3;5;273;0;3;0;3;1;2;3;0;0
18990; 29.2 ; 87.5 ; 26.0 ;3;10;252;0;3;2;1;1;2;2;0;1
18991; 41.6 ; 124.9 ; 15.3 ;3;135;173;0;3;1;2;3;0;1;1;1
18992; 51.1 ; 255.4 ; 37.3 ;5;25;288;0;5;3;2;3;2;2;1;2
18993; 28.1 ; 84.3 ; -   ;3;6;99;0;3;0;3;3;0;3;0;0
18994; 24.4 ; 171.0 ; 12.4 ;7;39;21;0;7;1;6;5;2;5;2;0
18995; 31.1 ; 62.2 ; 9.1 ;2;18;247;0;2;0;2;0;2;1;1;0
18996; 34.8 ; 69.5 ; 6.0 ;2;14;10;0;2;0;2;2;0;1;1;0
18997; 65.1 ; 195.3 ; 6.6 ;3;76;120;0;3;0;3;2;1;0;0;3
18998; 49.1 ; 540.0 ; 2.3 ;11;43;10;0;11;6;5;10;1;0;11;0
18999; 55.8 ; 1,338.0 ; 21.8 ;24;15;5;0;24;0;24;8;16;0;0;24
19000; 50.6 ; 101.1 ; 2.9 ;2;23;206;0;2;0;2;2;0;0;2;0
19001; 48.3 ; 193.4 ; 17.7 ;4;5;16;0;4;1;3;2;2;0;3;1
19002; 38.4 ; 192.0 ; 25.4 ;5;34;167;0;5;2;3;2;3;2;1;2
19003; 35.1 ; 175.6 ; 19.2 ;5;86;20;0;5;3;2;4;1;2;3;0
19004; 34.6 ; 173.1 ; 9.7 ;5;40;116;0;5;3;2;2;3;2;3;0
19005; 39.7 ; 79.5 ; 4.7 ;2;56;220;0;2;0;2;2;0;0;2;0
19006; 41.7 ; 83.4 ; 7.6 ;2;50;231;0;2;0;2;2;0;0;2;0
19007; 21.2 ; 1,039.6 ; 6.9 ;49;6;2;0;49;31;18;46;3;49;0;0
19008; 30.9 ; 61.7 ; 23.8 ;2;37;294;0;2;0;2;0;2;1;1;0
19009; 15.0 ; 30.0 ; -   ;2;27;196;0;2;2;0;0;2;2;0;0
19010; 48.7 ; 97.4 ; -   ;2;75;152;0;2;0;2;2;0;0;2;0
19011; 30.8 ; 61.7 ; 8.6 ;2;77;214;0;2;1;1;0;2;1;1;0
19012; 52.5 ; 893.0 ; 23.6 ;17;20;5;0;17;6;11;6;11;6;5;6
19013; 76.4 ; 381.9 ; 28.9 ;5;44;78;0;5;1;4;3;2;0;0;5
19014; 62.7 ; 501.3 ; 23.9 ;8;18;40;0;8;0;8;2;6;0;0;8
19015; 52.4 ; 104.8 ; 2.1 ;2;77;198;0;2;1;1;1;1;0;2;0
19016; 36.6 ; 146.4 ; 13.8 ;4;117;105;0;4;0;4;2;2;1;3;0
19017; 48.4 ; 96.8 ; 3.9 ;2;46;225;0;2;1;1;1;1;0;2;0
19018; 19.1 ; 477.7 ; 6.8 ;25;14;20;0;25;7;18;5;20;25;0;0
19019; 49.1 ; 786.2 ; 6.9 ;16;20;17;0;16;3;13;9;7;0;11;5
19020; 25.0 ; 150.1 ; 7.5 ;6;67;69;0;6;2;4;1;5;4;2;0
19021; 66.9 ; 669.0 ; 25.3 ;10;36;83;0;10;4;6;8;2;0;0;10
19022; 32.3 ; 97.0 ; 3.9 ;3;73;120;0;3;1;2;2;1;1;2;0
19023; 60.9 ; 548.5 ; 9.9 ;9;37;12;0;9;7;2;3;6;0;0;9
19024; 36.6 ; 73.2 ; -   ;2;13;47;2;0;0;2;2;0;0;2;0
19025; 43.9 ; 87.7 ; -   ;2;11;13;0;2;1;1;0;2;0;2;0
19026; 37.9 ; 417.1 ; 17.2 ;11;35;10;0;11;2;9;8;3;4;3;4
19027; 30.4 ; 152.0 ; 7.9 ;5;59;146;0;5;3;2;3;2;2;3;0
19028; 39.0 ; 155.9 ; 16.5 ;4;40;121;0;4;1;3;3;1;1;2;1
19029; 18.2 ; 72.8 ; 5.0 ;4;40;96;0;4;2;2;1;3;4;0;0
19030; 47.8 ; 573.2 ; 7.2 ;12;29;100;0;12;2;10;12;0;0;12;0
19031; 20.0 ; 40.1 ; 7.6 ;2;19;230;0;2;0;2;0;2;2;0;0
19032; 25.6 ; 256.2 ; 12.0 ;10;15;21;0;10;4;6;6;4;7;3;0
19033; 22.6 ; 45.2 ; 11.4 ;2;50;236;0;2;0;2;0;2;1;1;0
19034; 49.5 ; 98.9 ; 36.5 ;2;101;180;0;2;2;0;1;1;1;0;1
19035; 50.6 ; 151.7 ; 4.6 ;3;23;47;1;2;0;3;2;1;0;2;1
19036; 67.1 ; 1,074.1 ; 12.0 ;16;18;93;0;16;5;11;10;6;0;0;16
19037; 18.9 ; 226.3 ; 5.4 ;12;24;36;0;12;7;5;9;3;12;0;0
19038; 45.2 ; 90.3 ; 3.5 ;2;16;93;2;0;2;0;1;1;0;2;0
19039; 15.0 ; 74.9 ; -   ;5;29;5;0;5;0;5;5;0;5;0;0
19040; 61.8 ; 123.7 ; 22.6 ;2;6;230;0;2;0;2;2;0;0;0;2
19041; 27.0 ; 134.8 ; 12.5 ;5;11;341;0;5;0;5;3;2;3;2;0
19042; 26.9 ; 107.7 ; 8.4 ;4;2;16;0;4;1;3;2;2;3;1;0
19043; 33.7 ; 101.1 ; 3.6 ;3;72;100;0;3;0;3;2;1;0;3;0
19044; 29.2 ; 116.8 ; 12.7 ;4;24;203;0;4;3;1;2;2;3;1;0
19045; 38.1 ; 228.6 ; 5.2 ;6;51;26;0;6;1;5;4;2;0;6;0
19046; 53.6 ; 107.2 ; -   ;2;25;26;0;2;0;2;0;2;0;2;0
19047; 47.5 ; 760.8 ; 2.8 ;16;19;27;0;16;7;9;6;10;0;16;0
19048; 18.3 ; 55.0 ; 6.2 ;3;9;7;0;3;3;0;1;2;3;0;0
19049; 48.2 ; 96.4 ; -   ;2;1;10;2;0;0;2;2;0;0;2;0
19050; 51.6 ; 154.7 ; 12.2 ;3;139;36;0;3;0;3;3;0;0;2;1
19051; 50.5 ; 101.1 ; 1.8 ;2;3;38;0;2;1;1;2;0;0;2;0
19052; 56.4 ; 282.1 ; 19.4 ;5;32;26;0;5;1;4;3;2;0;0;5
19053; 49.6 ; 99.3 ; 4.3 ;2;113;110;1;1;0;2;2;0;0;2;0
19054; 38.5 ; 76.9 ; 12.4 ;2;95;111;0;2;1;1;0;2;1;1;0
19055; 72.1 ; 360.3 ; 34.3 ;5;65;52;0;5;0;5;5;0;0;0;5
19056; 28.1 ; 168.8 ; 15.1 ;6;56;2;0;6;6;0;6;0;4;2;0
19057; 15.0 ; 74.9 ; -   ;5;3;5;0;5;2;3;3;2;5;0;0
19058; 42.1 ; 168.6 ; 27.3 ;4;111;0;0;4;0;4;1;3;1;2;1
19059; 31.3 ; 282.1 ; 6.1 ;9;12;38;0;9;4;5;2;7;3;6;0
19060; 30.8 ; 61.7 ; 8.6 ;2;131;96;0;2;2;0;0;2;1;1;0
19061; 24.5 ; 98.2 ; 17.8 ;4;44;17;0;4;2;2;4;0;3;1;0
19062; 33.2 ; 199.1 ; 6.1 ;6;50;57;0;6;4;2;0;6;2;4;0
19063; 44.1 ; 132.4 ; 9.9 ;3;32;30;0;3;2;1;2;1;0;3;0
19064; 25.6 ; 76.7 ; 11.4 ;3;68;94;0;3;2;1;0;3;2;1;0
19065; 41.0 ; 615.4 ; 6.3 ;15;19;14;0;15;8;7;1;14;0;15;0
19066; 24.7 ; 49.5 ; 9.2 ;2;140;16;0;2;1;1;0;2;1;1;0
19067; 24.3 ; 145.8 ; 2.2 ;6;42;74;0;6;0;6;3;3;6;0;0
19068; 50.7 ; 152.1 ; 1.9 ;3;16;42;0;3;1;2;1;2;0;3;0
19069; 15.0 ; 30.0 ; -   ;2;12;268;0;2;0;2;1;1;2;0;0
19070; 16.7 ; 50.1 ; 1.6 ;3;138;42;0;3;1;2;2;1;3;0;0
19071; 16.8 ; 201.9 ; 1.6 ;12;25;50;0;12;4;8;12;0;12;0;0
19072; 28.9 ; 288.6 ; 11.5 ;10;16;19;0;10;8;2;10;0;7;3;0
19073; 30.9 ; 61.7 ; 23.8 ;2;18;113;0;2;2;0;0;2;1;1;0
19074; 79.7 ; 239.0 ; 40.4 ;3;18;29;3;0;3;0;1;2;0;0;3
19075; 25.8 ; 696.5 ; 13.0 ;27;8;108;0;27;10;17;10;17;18;9;0
19076; 47.1 ; 94.2 ; 0.5 ;2;38;89;0;2;0;2;1;1;0;2;0
19077; 29.7 ; 148.3 ; 13.5 ;5;14;45;0;5;3;2;1;4;3;2;0
19078; 36.7 ; 183.4 ; 12.0 ;5;42;11;0;5;1;4;1;4;2;3;0
19079; 20.9 ; 83.4 ; 6.9 ;4;85;50;0;4;2;2;4;0;4;0;0
19080; 17.3 ; 155.6 ; 3.2 ;9;19;22;0;9;0;9;5;4;9;0;0
19081; 47.9 ; 239.4 ; 1.9 ;5;41;32;0;5;0;5;5;0;0;5;0
19082; 38.5 ; 77.1 ; 6.5 ;2;173;86;0;2;1;1;0;2;0;2;0
19083; 16.1 ; 32.1 ; 1.6 ;2;53;99;1;1;1;1;1;1;2;0;0
19084; 64.5 ; 193.4 ; 48.1 ;3;5;116;0;3;0;3;3;0;1;0;2
19085; 73.2 ; 146.4 ; 54.8 ;2;95;108;2;0;2;0;0;2;1;0;1
19086; 33.0 ; 395.7 ; 11.8 ;12;21;73;0;12;5;7;7;5;4;8;0
19087; 37.2 ; 222.9 ; 13.3 ;6;30;93;0;6;1;5;1;5;2;4;0
19088; 27.2 ; 353.8 ; 23.4 ;13;14;8;0;13;6;7;3;10;9;4;0
19089; 86.2 ; 258.7 ; 57.5 ;3;13;38;0;3;1;2;1;2;1;0;2
19090; 24.8 ; 123.9 ; 3.8 ;5;6;172;0;5;3;2;3;2;5;0;0
19091; 62.2 ; 124.4 ; 22.1 ;2;82;57;0;2;0;2;2;0;0;0;2
19092; 19.7 ; 59.0 ; -   ;3;34;58;0;3;0;3;2;1;3;0;0
19093; 48.7 ; 97.3 ; 10.7 ;2;271;10;1;1;0;2;1;1;0;1;1
19094; 48.4 ; 871.2 ; 17.7 ;18;10;10;0;18;4;14;10;8;0;12;6
19095; 47.5 ; 427.6 ; 1.0 ;9;24;188;0;9;1;8;3;6;0;9;0
19096; 16.3 ; 98.1 ; 4.1 ;6;4;248;0;6;3;3;1;5;6;0;0
19097; 24.5 ; 440.3 ; 7.4 ;18;16;115;0;18;10;8;10;8;12;6;0
19098; 15.0 ; 59.9 ; -   ;4;94;20;0;4;2;2;2;2;4;0;0
19099; 62.1 ; 124.2 ; 23.0 ;2;29;242;0;2;0;2;2;0;0;0;2
19100; 55.1 ; 110.3 ; 9.8 ;2;346;16;0;2;0;2;1;1;0;0;2
19101; 19.5 ; 195.1 ; 1.7 ;10;41;0;0;10;5;5;7;3;10;0;0
19102; 57.1 ; 285.3 ; 17.2 ;5;26;73;0;5;0;5;3;2;0;0;5
19103; 109.6 ; 219.3 ; 89.1 ;2;172;19;0;2;1;1;0;2;1;0;1
19104; 46.8 ; 93.5 ; -   ;2;102;104;1;1;0;2;2;0;0;2;0
19105; 22.3 ; 66.9 ; 4.1 ;3;50;178;0;3;1;2;1;2;3;0;0
19106; 52.5 ; 105.0 ; -   ;2;27;115;0;2;0;2;2;0;0;2;0
19107; 53.8 ; 161.5 ; 26.9 ;3;67;64;0;3;0;3;2;1;1;1;1
19108; 43.0 ; 473.2 ; 16.1 ;11;25;26;0;11;0;11;11;0;4;3;4
19109; 15.0 ; 30.0 ; -   ;2;1;247;0;2;0;2;1;1;2;0;0
19110; 55.0 ; 110.0 ; 3.7 ;2;29;251;0;2;2;0;1;1;0;0;2
19111; 31.6 ; 94.8 ; 2.6 ;3;28;252;0;3;0;3;0;3;1;2;0
19112; 101.9 ; 203.9 ; 9.0 ;2;12;281;0;2;2;0;0;2;0;0;2
19113; 121.5 ; 243.0 ; 18.8 ;2;93;30;0;2;2;0;0;2;0;0;2
19114; 49.8 ; 1,046.2 ; 9.9 ;21;8;275;0;21;18;3;3;18;0;14;7
19115; 45.3 ; 453.1 ; 23.8 ;10;10;5;10;0;3;7;4;6;3;4;3
19116; 18.1 ; 234.7 ; 4.9 ;13;14;19;0;13;3;10;4;9;13;0;0
19117; 100.0 ; 800.2 ; 28.5 ;8;44;5;0;8;0;8;8;0;0;0;8
19118; 58.9 ; 235.4 ; 12.5 ;4;40;194;0;4;1;3;2;2;0;0;4
19119; 38.5 ; 76.9 ; 12.4 ;2;6;179;0;2;0;2;2;0;1;1;0
19120; 70.8 ; 283.2 ; 55.9 ;4;82;59;0;4;3;1;2;2;1;0;3
19121; 45.4 ; 181.7 ; 23.2 ;4;65;99;0;4;0;4;4;0;1;2;1
19122; 47.0 ; 141.0 ; 17.5 ;3;34;98;1;2;2;1;1;2;1;1;1
19123; 35.3 ; 70.5 ; 25.8 ;2;148;146;0;2;1;1;1;1;1;0;1
19124; 47.0 ; 141.0 ; 0.4 ;3;170;47;0;3;1;2;1;2;0;3;0
19125; 29.0 ; 116.1 ; 16.3 ;4;37;187;0;4;3;1;1;3;3;1;0
19126; 30.3 ; 242.4 ; 17.8 ;8;41;8;0;8;2;6;3;5;3;5;0
19127; 20.0 ; 40.1 ; 7.6 ;2;1;154;0;2;2;0;0;2;2;0;0
19128; 26.8 ; 508.7 ; 4.1 ;19;14;21;0;19;11;8;5;14;13;6;0
19129; 18.2 ; 308.7 ; 5.4 ;17;21;20;0;17;6;11;8;9;17;0;0
19130; 35.7 ; 570.5 ; 16.8 ;16;21;6;0;16;8;8;9;7;5;11;0
19131; 31.8 ; 158.9 ; 5.0 ;5;23;65;0;5;2;3;2;3;2;3;0
19132; 16.9 ; 50.7 ; 1.9 ;3;4;189;0;3;0;3;3;0;3;0;0
19133; 48.0 ; 240.0 ; 9.4 ;5;43;82;0;5;2;3;2;3;0;3;2
19134; 23.4 ; 187.5 ; 7.7 ;8;45;11;0;8;2;6;5;3;5;3;0
19135; 55.9 ; 558.6 ; 12.1 ;10;16;26;0;10;0;10;10;0;0;0;10
19136; 41.0 ; 81.9 ; 16.1 ;2;22;75;0;2;2;0;1;1;1;0;1
19137; 21.1 ; 232.2 ; 11.7 ;11;19;0;0;11;4;7;8;3;7;4;0
19138; 37.9 ; 227.4 ; 10.9 ;6;50;11;0;6;2;4;2;4;2;4;0
19139; 36.3 ; 399.6 ; 16.4 ;11;13;2;0;11;3;8;4;7;4;7;0
19140; 52.8 ; 105.7 ; 8.0 ;2;104;5;1;1;1;1;2;0;0;1;1
19141; 15.7 ; 62.8 ; 1.5 ;4;86;44;0;4;1;3;2;2;4;0;0
19142; 58.6 ; 820.9 ; 20.3 ;14;18;5;0;14;0;14;6;8;0;0;14
19143; 23.6 ; 496.4 ; 12.3 ;21;13;185;0;21;15;6;4;17;14;7;0
19144; 27.1 ; 244.1 ; 12.8 ;9;20;5;0;9;5;4;3;6;6;3;0
19145; 65.3 ; 326.4 ; 14.3 ;5;65;2;0;5;2;3;0;5;0;0;5
19146; 31.6 ; 63.2 ; 24.9 ;2;5;17;0;2;1;1;1;1;1;0;1
19147; 42.7 ; 128.2 ; 22.8 ;3;34;75;3;0;2;1;2;1;1;1;1
19148; 21.8 ; 87.0 ; 4.9 ;4;33;58;3;1;0;4;3;1;4;0;0
19149; 34.0 ; 442.3 ; 12.6 ;13;23;8;0;13;7;6;7;6;4;9;0
19150; 62.6 ; 187.7 ; 28.4 ;3;25;100;3;0;0;3;1;2;0;0;3
19151; 46.0 ; 460.4 ; 20.6 ;10;32;28;0;10;4;6;10;0;3;4;3
19152; 38.8 ; 77.6 ; 6.7 ;2;219;22;0;2;0;2;2;0;0;2;0
19153; 42.0 ; 210.2 ; 26.5 ;5;46;129;0;5;3;2;4;1;2;1;2
19154; 44.4 ; 266.2 ; 11.7 ;6;21;127;0;6;0;6;4;2;0;4;2
19155; 57.7 ; 115.3 ; 4.1 ;2;64;204;0;2;0;2;1;1;0;0;2
19156; 15.0 ; 30.0 ; -   ;2;25;241;0;2;0;2;2;0;2;0;0
19157; 52.1 ; 156.3 ; 4.0 ;3;41;287;0;3;2;1;2;1;0;2;1
19158; 15.5 ; 77.3 ; 1.2 ;5;50;0;1;4;1;4;0;5;5;0;0
19159; 17.5 ; 192.3 ; 6.2 ;11;37;11;0;11;6;5;1;10;11;0;0
19160; 37.6 ; 75.1 ; 12.0 ;2;5;152;2;0;0;2;0;2;1;1;0
19161; 22.1 ; 442.3 ; 6.7 ;20;20;20;0;20;11;9;5;15;20;0;0
19162; 16.8 ; 33.6 ; -   ;2;4;17;1;1;1;1;0;2;2;0;0
19163; 46.8 ; 93.5 ; -   ;2;162;167;0;2;1;1;0;2;0;2;0
19164; 48.1 ; 240.3 ; 3.1 ;5;52;64;0;5;2;3;5;0;0;5;0
19165; 32.5 ; 97.5 ; 20.0 ;3;76;142;0;3;1;2;1;2;1;2;0
19166; 35.8 ; 107.5 ; 0.3 ;3;123;71;0;3;2;1;1;2;0;3;0
19167; 41.5 ; 166.1 ; 11.6 ;4;13;99;0;4;0;4;4;0;1;3;0
19168; 34.9 ; 697.7 ; 12.9 ;20;14;11;0;20;11;9;3;17;7;13;0
19169; 38.8 ; 155.2 ; 16.8 ;4;103;133;0;4;2;2;3;1;1;2;1
19170; 44.8 ; 89.6 ; 2.9 ;2;9;176;0;2;1;1;0;2;0;2;0
19171; 50.0 ; 100.0 ; 4.3 ;2;14;113;0;2;1;1;0;2;0;2;0
19172; 57.9 ; 173.7 ; 24.1 ;3;25;96;0;3;2;1;2;1;0;0;3
19173; 32.8 ; 98.3 ; 17.2 ;3;3;335;0;3;0;3;0;3;1;2;0
19174; 50.0 ; 250.0 ; 16.5 ;5;63;3;0;5;1;4;3;2;0;3;2
19175; 62.9 ; 2,957.5 ; 26.3 ;47;6;4;0;47;26;21;12;35;0;0;47
19176; 76.4 ; 229.1 ; 35.8 ;3;110;47;0;3;0;3;1;2;0;0;3
19177; 56.6 ; 113.2 ; 10.5 ;2;68;226;0;2;0;2;0;2;0;0;2
19178; 54.5 ; 109.0 ; 10.5 ;2;121;39;0;2;2;0;2;0;0;1;1
19179; 23.0 ; 160.8 ; 10.7 ;7;16;1;0;7;2;5;2;5;5;2;0
19180; 50.6 ; 151.7 ; 14.6 ;3;41;131;0;3;1;2;2;1;0;2;1
19181; 20.3 ; 324.6 ; 11.7 ;16;24;36;0;16;4;12;11;5;11;5;0
19182; 52.4 ; 104.7 ; 45.2 ;2;4;254;0;2;1;1;1;1;1;0;1
19183; 19.7 ; 39.3 ; -   ;2;59;246;0;2;1;1;1;1;2;0;0
19184; 20.0 ; 40.1 ; 7.6 ;2;49;99;0;2;1;1;2;0;2;0;0
19185; 33.1 ; 99.4 ; 14.7 ;3;144;30;0;3;3;0;3;0;1;2;0
19186; 26.5 ; 132.7 ; 1.7 ;5;26;95;0;5;2;3;2;3;5;0;0
19187; 50.0 ; 200.1 ; 15.2 ;4;90;15;0;4;0;4;4;0;0;3;1
19188; 23.2 ; 92.8 ; 10.1 ;4;32;229;0;4;1;3;2;2;3;1;0
19189; 80.5 ; 161.1 ; 54.9 ;2;62;5;2;0;0;2;2;0;1;0;1
19190; 56.5 ; 169.6 ; 4.3 ;3;131;37;0;3;1;2;2;1;0;0;3
19191; 18.9 ; 320.6 ; 6.0 ;17;8;2;17;0;8;9;9;8;17;0;0
19192; 51.6 ; 154.7 ; 3.8 ;3;23;9;0;3;2;1;3;0;0;2;1
19193; 45.7 ; 91.3 ; 30.9 ;2;100;62;0;2;1;1;2;0;1;0;1
19194; 19.1 ; 152.8 ; 6.7 ;8;31;22;7;1;0;8;2;6;8;0;0
19195; 28.9 ; 115.6 ; 2.7 ;4;46;98;1;3;1;3;2;2;3;1;0
19196; 20.0 ; 40.1 ; 7.6 ;2;113;79;0;2;0;2;1;1;2;0;0
19197; 39.4 ; 78.9 ; 13.9 ;2;70;209;0;2;0;2;1;1;1;1;0
19198; 41.3 ; 82.7 ; 32.0 ;2;1;221;0;2;1;1;1;1;1;0;1
19199; 26.1 ; 52.3 ; -   ;2;5;274;0;2;0;2;0;2;2;0;0
19200; 25.1 ; 75.2 ; -   ;3;8;139;0;3;2;1;1;2;3;0;0
19201; 26.0 ; 130.1 ; 22.3 ;5;39;125;0;5;2;3;5;0;3;2;0
19202; 42.1 ; 126.4 ; 28.5 ;3;10;70;2;1;2;1;3;0;1;1;1
19203; 66.2 ; 132.3 ; 17.2 ;2;25;73;2;0;0;2;2;0;0;0;2
19204; 43.4 ; 86.7 ; 27.4 ;2;5;5;0;2;1;1;1;1;1;0;1
19205; 52.8 ; 2,534.5 ; 31.4 ;48;9;0;0;48;21;27;28;20;16;16;16
19206; 28.4 ; 227.3 ; 7.3 ;8;43;95;0;8;5;3;5;3;5;3;0
19207; 34.5 ; 792.4 ; 15.0 ;23;16;6;0;23;10;13;9;14;8;15;0
19208; 36.3 ; 72.5 ; 16.8 ;2;17;97;0;2;2;0;1;1;1;1;0
19209; 20.1 ; 140.4 ; 8.6 ;7;22;41;0;7;5;2;7;0;7;0;0
19210; 27.8 ; 55.6 ; 4.6 ;2;29;8;2;0;1;1;0;2;1;1;0
19211; 17.3 ; 34.7 ; 3.5 ;2;52;327;0;2;2;0;0;2;2;0;0
19212; 16.5 ; 49.4 ; 2.7 ;3;4;117;0;3;3;0;0;3;3;0;0
19213; 15.0 ; 59.9 ; -   ;4;5;83;0;4;1;3;2;2;4;0;0
19214; 98.8 ; 197.7 ; 38.9 ;2;119;161;0;2;2;0;2;0;0;0;2
19215; 52.5 ; 105.0 ; -   ;2;2;282;0;2;1;1;1;1;0;2;0
19216; 57.6 ; 345.5 ; 12.1 ;6;32;32;0;6;0;6;4;2;0;0;6
19217; 27.9 ; 139.4 ; 13.2 ;5;22;263;0;5;1;4;2;3;3;2;0
19218; 43.5 ; 391.5 ; 18.3 ;9;28;23;0;9;6;3;3;6;3;3;3
19219; 51.0 ; 306.2 ; 17.9 ;6;19;148;0;6;1;5;3;3;0;4;2
19220; 46.8 ; 187.0 ; -   ;4;38;173;0;4;0;4;4;0;0;4;0
19221; 53.3 ; 159.9 ; 8.0 ;3;13;314;0;3;2;1;2;1;0;2;1
19222; 45.0 ; 405.1 ; 23.6 ;9;26;46;0;9;6;3;7;2;3;3;3
19223; 31.8 ; 95.5 ; 15.0 ;3;97;142;0;3;1;2;2;1;1;2;0
19224; 24.0 ; 48.0 ; 9.3 ;2;62;170;0;2;2;0;1;1;1;1;0
19225; 43.3 ; 129.9 ; 20.0 ;3;67;99;0;3;1;2;2;1;1;1;1
19226; 87.3 ; 261.9 ; 25.5 ;3;129;78;0;3;0;3;3;0;0;0;3
19227; 46.2 ; 138.7 ; 16.1 ;3;107;20;0;3;0;3;0;3;0;2;1
19228; 28.5 ; 170.9 ; 7.1 ;6;26;264;0;6;4;2;0;6;4;2;0
19229; 25.0 ; 74.9 ; 9.2 ;3;85;94;0;3;1;2;2;1;2;1;0
19230; 15.0 ; 45.0 ; -   ;3;4;114;0;3;1;2;2;1;3;0;0
19231; 27.5 ; 55.0 ; 3.7 ;2;10;14;0;2;2;0;1;1;1;1;0
19232; 16.8 ; 33.6 ; 2.7 ;2;18;294;0;2;0;2;2;0;2;0;0
19233; 24.8 ; 74.3 ; 9.1 ;3;121;15;0;3;0;3;2;1;2;1;0
19234; 99.3 ; 198.7 ; 75.8 ;2;121;15;0;2;0;2;1;1;1;0;1
19235; 35.1 ; 245.9 ; 15.2 ;7;23;160;0;7;2;5;7;0;2;5;0
19236; 35.6 ; 106.8 ; 18.6 ;3;86;41;0;3;1;2;1;2;1;2;0
19237; 38.9 ; 155.8 ; 10.7 ;4;21;277;0;4;3;1;1;3;1;3;0
19238; 43.4 ; 86.7 ; 27.4 ;2;24;236;0;2;0;2;1;1;1;0;1
19239; 45.0 ; 89.9 ; 40.3 ;2;39;93;0;2;1;1;1;1;1;0;1
19240; 30.7 ; 61.4 ; 18.2 ;2;27;205;0;2;1;1;1;1;1;1;0
19241; 44.4 ; 443.6 ; 7.2 ;10;40;26;0;10;1;9;9;1;0;10;0
19242; 53.4 ; 267.0 ; 15.6 ;5;50;167;0;5;0;5;4;1;0;3;2
19243; 29.0 ; 58.1 ; 8.6 ;2;14;259;0;2;2;0;2;0;1;1;0
19244; 20.0 ; 120.3 ; 3.4 ;6;36;131;4;2;0;6;4;2;6;0;0
19245; 36.9 ; 73.8 ; 17.7 ;2;12;263;0;2;0;2;2;0;1;1;0
19246; 73.9 ; 147.8 ; 36.5 ;2;31;70;0;2;1;1;0;2;0;0;2
19247; 30.7 ; 92.1 ; 1.3 ;3;65;40;0;3;3;0;1;2;1;2;0
19248; 28.9 ; 57.8 ; 1.6 ;2;17;232;0;2;0;2;0;2;1;1;0
19249; 91.7 ; 275.2 ; 46.7 ;3;35;93;0;3;1;2;1;2;0;0;3
19250; 48.4 ; 96.7 ; 7.2 ;2;61;5;0;2;0;2;2;0;0;1;1
19251; 76.6 ; 153.2 ; 36.1 ;2;182;62;1;1;0;2;2;0;0;0;2
19252; 36.6 ; 109.8 ; -   ;3;9;94;3;0;0;3;3;0;0;3;0
19253; 68.5 ; 1,232.9 ; 20.3 ;18;20;5;2;16;0;18;7;11;0;0;18
19254; 49.7 ; 347.9 ; 14.0 ;7;25;22;2;5;2;5;7;0;0;5;2
19255; 23.2 ; 324.2 ; 12.0 ;14;23;18;0;14;2;12;5;9;9;5;0
19256; 42.7 ; 598.1 ; 12.0 ;14;21;15;0;14;6;8;9;5;0;14;0
19257; 47.5 ; 522.4 ; 21.1 ;11;31;26;0;11;0;11;11;0;4;3;4
19258; 25.5 ; 101.9 ; 11.6 ;4;23;284;0;4;2;2;4;0;3;1;0
19259; 47.7 ; 95.5 ; 1.5 ;2;24;194;0;2;0;2;2;0;0;2;0
19260; 18.6 ; 92.9 ; -   ;5;26;106;0;5;3;2;3;2;5;0;0
19261; 41.7 ; 208.4 ; 21.2 ;5;101;11;0;5;3;2;4;1;2;1;2
19262; 31.8 ; 63.7 ; 25.2 ;2;83;147;1;1;0;2;2;0;1;0;1
19263; 28.6 ; 314.8 ; 18.6 ;11;25;31;0;11;1;10;3;8;7;4;0
19264; 77.1 ; 308.3 ; 5.4 ;4;41;57;4;0;0;4;4;0;0;0;4
19265; 45.5 ; 91.1 ; 2.9 ;2;71;34;0;2;2;0;1;1;0;2;0
19266; 46.8 ; 93.5 ; -   ;2;131;231;0;2;0;2;2;0;0;2;0
19267; 40.5 ; 80.9 ; 9.4 ;2;88;115;0;2;0;2;2;0;0;2;0
19268; 63.0 ; 314.9 ; 20.8 ;5;59;62;0;5;1;4;5;0;0;0;5
19269; 44.5 ; 222.7 ; 15.1 ;5;54;99;0;5;0;5;3;2;2;1;2
19270; 21.7 ; 108.7 ; 8.1 ;5;49;26;0;5;2;3;4;1;5;0;0
19271; 31.5 ; 283.4 ; 8.3 ;9;32;11;0;9;3;6;5;4;3;6;0
19272; 36.6 ; 292.4 ; 13.9 ;8;18;123;0;8;2;6;5;3;3;5;0
19273; 35.2 ; 105.7 ; 24.5 ;3;9;158;0;3;0;3;1;2;1;1;1
19274; 70.1 ; 140.2 ; 18.9 ;2;50;147;0;2;0;2;2;0;0;0;2
19275; 23.1 ; 46.2 ; 3.0 ;2;170;15;0;2;0;2;1;1;2;0;0
19276; 18.8 ; 187.9 ; 7.3 ;10;31;15;0;10;4;6;4;6;10;0;0
19277; 23.9 ; 143.3 ; 12.3 ;6;27;131;0;6;4;2;5;1;4;2;0
19278; 45.4 ; 90.8 ; 24.1 ;2;5;238;0;2;1;1;2;0;1;0;1
19279; 25.1 ; 125.4 ; 10.4 ;5;27;65;0;5;2;3;2;3;3;2;0
19280; 51.1 ; 102.3 ; 6.6 ;2;88;141;0;2;0;2;2;0;0;1;1
19281; 45.7 ; 182.6 ; 11.7 ;4;51;253;0;4;1;3;3;1;0;3;1
19282; 33.5 ; 66.9 ; 23.1 ;2;3;163;0;2;1;1;1;1;1;0;1
19283; 31.1 ; 155.6 ; 5.5 ;5;52;35;0;5;1;4;2;3;2;3;0
19284; 71.2 ; 142.4 ; 35.5 ;2;23;31;0;2;1;1;1;1;0;0;2
19285; 26.0 ; 181.7 ; 9.6 ;7;48;5;0;7;2;5;4;3;5;2;0
19286; 38.1 ; 76.3 ; 19.6 ;2;100;125;0;2;0;2;0;2;1;0;1
19287; 35.9 ; 71.8 ; 16.2 ;2;46;144;2;0;1;1;1;1;1;1;0
19288; 51.4 ; 205.5 ; 15.7 ;4;111;121;0;4;1;3;3;1;0;3;1
19289; 31.2 ; 62.5 ; 24.3 ;2;115;83;2;0;0;2;2;0;1;0;1
19290; 36.6 ; 73.3 ; 17.3 ;2;461;7;0;2;2;0;2;0;1;1;0
19291; 40.6 ; 608.4 ; 26.1 ;15;11;0;0;15;11;4;12;3;5;5;5
19292; 62.0 ; 929.9 ; 32.1 ;15;23;5;0;15;2;13;8;7;5;0;10
19293; 20.0 ; 219.8 ; 11.1 ;11;23;160;0;11;1;10;8;3;7;4;0
19294; 37.7 ; 188.7 ; 3.0 ;5;46;26;0;5;1;4;5;0;0;5;0
19295; 39.7 ; 79.5 ; 4.7 ;2;78;155;0;2;1;1;2;0;0;2;0
19296; 60.2 ; 662.2 ; 20.4 ;11;26;26;0;11;0;11;9;2;0;0;11
19297; 68.7 ; 206.2 ; 28.0 ;3;107;99;1;2;1;2;1;2;0;0;3
19298; 51.2 ; 153.7 ; 2.3 ;3;63;126;0;3;0;3;3;0;0;3;0
19299; 30.9 ; 433.0 ; 14.1 ;14;31;35;0;14;9;5;3;11;5;9;0
19300; 24.1 ; 96.5 ; 19.4 ;4;42;53;0;4;1;3;2;2;3;1;0
19301; 43.6 ; 87.2 ; 10.5 ;2;15;354;0;2;1;1;0;2;0;2;0
19302; 22.6 ; 90.2 ; 5.3 ;4;63;99;0;4;2;2;2;2;4;0;0
19303; 16.4 ; 32.8 ; 2.1 ;2;8;209;0;2;1;1;0;2;2;0;0
19304; 18.3 ; 146.7 ; 7.0 ;8;9;2;0;8;3;5;2;6;8;0;0
19305; 54.7 ; 492.7 ; 27.5 ;9;40;0;0;9;0;9;8;1;3;3;3
19306; 46.8 ; 93.5 ; -   ;2;33;252;0;2;1;1;2;0;0;2;0
19307; 46.8 ; 93.5 ; -   ;2;3;233;0;2;1;1;1;1;0;2;0
19308; 26.0 ; 545.9 ; 3.9 ;21;5;0;21;0;9;12;4;17;21;0;0
19309; 47.0 ; 141.0 ; 0.4 ;3;66;99;3;0;0;3;3;0;0;3;0
19310; 84.8 ; 508.9 ; 31.1 ;6;39;83;0;6;0;6;4;2;0;0;6
19311; 47.5 ; 189.8 ; 1.5 ;4;19;116;0;4;0;4;4;0;0;4;0
19312; 40.0 ; 439.9 ; 13.3 ;11;37;11;0;11;3;8;6;5;4;7;0
19313; 21.7 ; 65.1 ; 6.2 ;3;194;2;0;3;2;1;3;0;3;0;0
19314; 27.1 ; 135.3 ; 14.9 ;5;13;243;0;5;3;2;3;2;3;2;0
19315; 28.9 ; 86.6 ; 9.1 ;3;4;80;0;3;3;0;1;2;2;1;0
19316; 25.0 ; 124.8 ; 14.9 ;5;22;143;0;5;3;2;3;2;3;2;0
19317; 40.5 ; 121.4 ; 7.1 ;3;25;11;1;2;1;2;3;0;0;3;0
19318; 44.8 ; 89.6 ; 2.9 ;2;57;207;0;2;2;0;1;1;0;2;0
19319; 54.2 ; 216.8 ; 18.8 ;4;91;93;0;4;2;2;4;0;0;3;1
19320; 25.1 ; 225.8 ; 9.7 ;9;26;86;0;9;1;8;5;4;6;3;0
19321; 29.9 ; 59.9 ; 16.5 ;2;138;63;1;1;0;2;2;0;1;1;0
19322; 35.2 ; 70.3 ; 5.9 ;2;14;40;0;2;1;1;0;2;1;1;0
19323; 46.2 ; 184.8 ; 5.2 ;4;122;73;0;4;2;2;2;2;0;4;0
19324; 44.7 ; 223.6 ; 10.7 ;5;15;39;0;5;3;2;4;1;0;3;2
19325; 17.5 ; 87.3 ; 2.3 ;5;11;71;0;5;5;0;5;0;5;0;0
19326; 27.6 ; 55.3 ; 3.8 ;2;5;88;0;2;2;0;1;1;1;1;0
19327; 47.6 ; 95.2 ; 0.8 ;2;368;92;0;2;1;1;2;0;0;2;0
19328; 25.6 ; 153.5 ; 6.6 ;6;45;169;0;6;0;6;2;4;4;2;0
19329; 31.9 ; 1,210.6 ; 14.6 ;38;8;5;0;38;16;22;26;12;13;25;0
19330; 26.4 ; 845.6 ; 7.3 ;32;10;8;0;32;20;12;16;16;21;11;0
19331; 44.6 ; 89.1 ; 11.9 ;2;12;162;0;2;0;2;2;0;0;1;1
19332; 49.7 ; 99.3 ; 12.0 ;2;7;1;0;2;1;1;0;2;0;1;1
19333; 34.2 ; 308.0 ; 14.6 ;9;45;53;0;9;6;3;5;4;3;6;0
19334; 70.6 ; 141.3 ; 1.5 ;2;176;99;0;2;0;2;2;0;0;0;2
19335; 47.0 ; 141.0 ; 0.4 ;3;22;99;0;3;0;3;0;3;0;3;0
19336; 38.0 ; 190.1 ; 22.8 ;5;63;39;0;5;2;3;2;3;2;1;2
19337; 45.4 ; 90.8 ; 16.1 ;2;39;329;0;2;1;1;0;2;1;0;1
19338; 69.8 ; 349.0 ; 13.1 ;5;16;93;0;5;0;5;1;4;0;0;5
19339; 34.9 ; 384.0 ; 14.5 ;11;35;47;0;11;0;11;10;1;4;7;0
19340; 45.6 ; 91.1 ; 30.7 ;2;11;42;0;2;0;2;1;1;1;0;1
19341; 86.3 ; 258.8 ; 13.3 ;3;23;257;0;3;0;3;3;0;0;0;3
19342; 59.1 ; 118.2 ; 11.0 ;2;10;40;2;0;1;1;2;0;0;0;2
19343; 30.2 ; 150.9 ; -   ;5;23;304;0;5;0;5;1;4;0;5;0
19344; 36.4 ; 109.1 ; 15.9 ;3;25;226;0;3;0;3;2;1;1;2;0
19345; 41.7 ; 83.4 ; 7.6 ;2;113;52;0;2;0;2;2;0;0;2;0
19346; 36.6 ; 109.8 ; -   ;3;81;161;0;3;1;2;1;2;0;3;0
19347; 44.4 ; 177.6 ; 5.5 ;4;85;57;0;4;1;3;3;1;0;4;0
19348; 37.3 ; 74.6 ; 18.3 ;2;8;184;0;2;1;1;0;2;1;0;1
19349; 16.6 ; 281.8 ; 5.0 ;17;15;2;0;17;9;8;16;1;17;0;0
19350; 16.1 ; 64.4 ; 2.4 ;4;23;299;0;4;0;4;4;0;4;0;0
19351; 29.7 ; 148.5 ; 12.9 ;5;78;5;0;5;1;4;4;1;3;2;0
19352; 16.0 ; 64.2 ; 2.3 ;4;26;58;0;4;3;1;2;2;4;0;0
19353; 32.8 ; 131.3 ; 14.4 ;4;16;36;0;4;1;3;3;1;1;3;0
19354; 127.3 ; 254.6 ; 20.2 ;2;44;230;0;2;0;2;2;0;0;0;2
19355; 34.0 ; 102.0 ; 7.0 ;3;16;5;0;3;0;3;3;0;1;2;0
19356; 38.3 ; 881.5 ; 12.0 ;23;14;3;0;23;11;12;5;18;8;15;0
19357; 32.8 ; 196.8 ; 14.1 ;6;5;55;0;6;3;3;1;5;2;4;0
19358; 16.7 ; 83.3 ; 4.4 ;5;23;192;0;5;2;3;2;3;5;0;0
19359; 31.5 ; 94.4 ; 17.6 ;3;27;10;0;3;2;1;1;2;1;2;0
19360; 24.2 ; 48.5 ; 13.4 ;2;3;105;0;2;1;1;0;2;1;1;0
19361; 52.8 ; 105.7 ; 7.0 ;2;86;1;2;0;0;2;1;1;0;1;1
19362; 84.6 ; 169.3 ; 71.9 ;2;24;131;0;2;0;2;1;1;1;0;1
19363; 75.7 ; 378.5 ; 20.9 ;5;46;5;1;4;0;5;4;1;0;0;5
19364; 43.5 ; 217.3 ; 17.8 ;5;54;49;1;4;3;2;0;5;2;1;2
19365; 45.8 ; 91.6 ; 34.3 ;2;49;173;0;2;0;2;1;1;1;0;1
19366; 25.4 ; 50.7 ; 15.5 ;2;81;78;0;2;0;2;1;1;1;1;0
19367; 16.1 ; 64.3 ; 2.3 ;4;71;52;0;4;1;3;2;2;4;0;0
19368; 24.6 ; 221.2 ; 6.9 ;9;35;16;0;9;0;9;4;5;6;3;0
19369; 46.4 ; 139.2 ; 17.0 ;3;10;194;0;3;0;3;1;2;1;1;1
19370; 54.5 ; 109.0 ; 7.7 ;2;37;37;2;0;0;2;1;1;0;1;1
19371; 34.4 ; 172.2 ; 46.0 ;5;21;122;5;0;5;0;5;0;2;1;2
19372; 25.5 ; 127.3 ; 5.6 ;5;34;11;0;5;1;4;5;0;3;2;0
19373; 19.5 ; 97.7 ; 0.6 ;5;21;6;0;5;2;3;5;0;5;0;0
19374; 50.3 ; 151.0 ; 6.6 ;3;13;173;0;3;0;3;3;0;0;2;1
19375; 49.4 ; 395.1 ; 5.0 ;8;28;5;0;8;0;8;7;1;0;8;0
19376; 53.3 ; 319.6 ; 49.6 ;6;62;59;0;6;4;2;5;1;2;2;2
19377; 28.4 ; 1,504.2 ; 13.4 ;53;5;13;0;53;26;27;19;34;35;18;0
19378; 32.3 ; 64.6 ; 3.2 ;2;19;31;0;2;0;2;1;1;1;1;0
19379; 46.9 ; 187.5 ; 21.1 ;4;78;24;0;4;3;1;2;2;1;2;1
19380; 48.6 ; 97.1 ; 11.5 ;2;38;183;0;2;0;2;2;0;0;1;1
19381; 34.5 ; 69.0 ; 22.2 ;2;12;78;0;2;0;2;2;0;1;0;1
19382; 21.5 ; 258.0 ; 10.1 ;12;22;0;0;12;2;10;9;3;8;4;0
19383; 36.8 ; 661.9 ; 24.1 ;18;14;8;0;18;5;13;13;5;6;6;6
19384; 32.4 ; 64.8 ; 21.5 ;2;37;121;0;2;0;2;1;1;1;1;0
19385; 20.4 ; 163.2 ; 11.8 ;8;34;38;0;8;2;6;1;7;5;3;0
19386; 70.1 ; 140.3 ; 14.7 ;2;113;5;0;2;0;2;2;0;0;0;2
19387; 33.0 ; 66.0 ; 11.9 ;2;54;99;0;2;1;1;1;1;1;1;0
19388; 71.1 ; 142.2 ; 32.7 ;2;24;89;0;2;0;2;2;0;0;0;2
19389; 63.3 ; 1,266.7 ; 35.6 ;20;5;54;0;20;17;3;17;3;7;0;13
19390; 29.2 ; 175.0 ; 2.5 ;6;36;0;0;6;0;6;4;2;4;2;0
19391; 42.9 ; 128.8 ; 26.2 ;3;47;75;0;3;1;2;2;1;1;1;1
19392; 30.9 ; 61.7 ; 23.8 ;2;14;261;0;2;1;1;2;0;1;1;0
19393; 19.3 ; 57.9 ; 3.1 ;3;41;195;0;3;2;1;1;2;3;0;0
19394; 26.5 ; 79.5 ; 13.0 ;3;83;123;0;3;2;1;1;2;2;1;0
19395; 26.4 ; 131.8 ; 6.6 ;5;28;25;0;5;0;5;2;3;3;2;0
19396; 33.8 ; 406.1 ; 18.6 ;12;28;99;0;12;8;4;8;4;4;8;0
19397; 24.7 ; 49.4 ; 6.4 ;2;71;179;0;2;1;1;1;1;1;1;0
19398; 18.0 ; 36.0 ; -   ;2;4;134;0;2;1;1;2;0;2;0;0
19399; 93.5 ; 187.0 ; -   ;2;7;330;0;2;0;2;2;0;0;0;2
19400; 89.5 ; 447.4 ; 23.3 ;5;59;20;0;5;0;5;2;3;0;0;5
19401; 81.2 ; 487.3 ; 84.1 ;6;6;2;0;6;1;5;4;2;2;0;4
19402; 38.2 ; 496.3 ; 12.4 ;13;22;103;0;13;8;5;9;4;4;9;0
19403; 38.3 ; 76.6 ; -   ;2;12;52;0;2;0;2;1;1;0;2;0
19404; 55.4 ; 221.4 ; 27.4 ;4;69;49;0;4;4;0;4;0;1;0;3
19405; 38.6 ; 424.3 ; 12.3 ;11;24;15;0;11;2;9;9;2;4;7;0
19406; 15.8 ; 174.1 ; 3.1 ;11;16;5;0;11;2;9;5;6;11;0;0
19407; 52.9 ; 105.8 ; 0.5 ;2;64;62;0;2;0;2;1;1;0;2;0
19408; 29.9 ; 179.4 ; 16.7 ;6;26;68;0;6;4;2;5;1;4;2;0
19409; 34.7 ; 173.7 ; 5.8 ;5;18;36;0;5;0;5;4;1;2;3;0
19410; 17.1 ; 34.3 ; 3.2 ;2;10;17;0;2;1;1;0;2;2;0;0
19411; 36.9 ; 73.8 ; 17.7 ;2;5;232;0;2;0;2;1;1;1;1;0
19412; 19.8 ; 158.8 ; 12.0 ;8;37;22;0;8;2;6;2;6;5;3;0
19413; 35.8 ; 71.5 ; 23.7 ;2;2;212;0;2;2;0;1;1;1;0;1
19414; 46.8 ; 140.3 ; -   ;3;45;197;0;3;2;1;3;0;0;3;0
19415; 60.9 ; 182.8 ; 17.2 ;3;41;5;0;3;0;3;2;1;0;0;3
19416; 84.5 ; 168.9 ; 32.9 ;2;18;36;1;1;0;2;2;0;0;0;2
19417; 66.0 ; 461.9 ; 19.4 ;7;37;10;0;7;0;7;7;0;0;0;7
19418; 18.6 ; 55.7 ; -   ;3;94;108;0;3;3;0;3;0;3;0;0
19419; 46.8 ; 93.5 ; -   ;2;93;247;0;2;0;2;1;1;0;2;0
19420; 18.3 ; 55.0 ; 6.2 ;3;171;57;0;3;1;2;1;2;3;0;0
19421; 63.9 ; 191.8 ; 19.1 ;3;86;227;0;3;2;1;3;0;0;0;3
19422; 46.1 ; 276.4 ; 4.2 ;6;24;17;6;0;5;1;1;5;0;6;0
19423; 20.8 ; 104.0 ; 9.6 ;5;49;135;0;5;3;2;3;2;3;2;0
19424; 70.1 ; 140.3 ; 35.0 ;2;6;110;2;0;0;2;2;0;0;0;2
19425; 69.1 ; 207.3 ; 9.3 ;3;101;220;0;3;0;3;2;1;0;0;3
19426; 33.0 ; 66.0 ; 11.9 ;2;212;99;0;2;1;1;0;2;1;1;0
19427; 15.0 ; 30.0 ; -   ;2;26;230;0;2;0;2;1;1;2;0;0
19428; 22.6 ; 158.0 ; 13.6 ;7;41;15;0;7;3;4;2;5;5;2;0
19429; 23.8 ; 71.5 ; 8.3 ;3;93;24;0;3;1;2;0;3;2;1;0
19430; 39.2 ; 549.4 ; 30.4 ;14;5;54;14;0;11;3;1;13;5;4;5
19431; 43.9 ; 87.8 ; 4.5 ;2;139;151;0;2;2;0;0;2;0;2;0
19432; 40.8 ; 122.3 ; 3.8 ;3;97;36;0;3;0;3;2;1;0;3;0
19433; 48.0 ; 192.0 ; 2.2 ;4;103;96;0;4;3;1;2;2;0;4;0
19434; 71.8 ; 143.6 ; -   ;2;27;137;0;2;1;1;1;1;0;0;2
19435; 38.7 ; 193.5 ; 18.3 ;5;50;160;0;5;4;1;3;2;2;1;2
19436; 21.1 ; 401.3 ; 5.6 ;19;10;107;0;19;17;2;19;0;19;0;0
19437; 58.8 ; 235.1 ; 33.7 ;4;59;98;0;4;3;1;3;1;1;0;3
19438; 15.0 ; 30.0 ; -   ;2;7;261;0;2;1;1;1;1;2;0;0
19439; 22.5 ; 44.9 ; 11.2 ;2;1;267;0;2;0;2;0;2;1;1;0
19440; 42.9 ; 85.7 ; -   ;2;42;160;2;0;1;1;1;1;0;2;0
19441; 16.8 ; 33.6 ; 2.7 ;2;54;200;0;2;0;2;1;1;2;0;0
19442; 30.9 ; 216.0 ; 6.1 ;7;3;241;0;7;3;4;5;2;2;5;0
19443; 49.5 ; 99.1 ; 3.1 ;2;353;99;0;2;0;2;2;0;0;2;0
19444; 70.5 ; 141.0 ; 3.1 ;2;169;11;0;2;0;2;0;2;0;0;2
19445; 33.5 ; 334.9 ; 27.2 ;10;22;13;10;0;2;8;6;4;3;4;3
19446; 38.6 ; 887.2 ; 11.9 ;23;14;10;0;23;3;20;7;16;8;15;0
19447; 39.9 ; 79.7 ; 14.5 ;2;232;100;0;2;0;2;0;2;1;1;0
19448; 22.7 ; 249.2 ; 5.2 ;11;32;17;0;11;3;8;5;6;11;0;0
19449; 35.3 ; 1,166.0 ; 9.7 ;33;11;7;0;33;2;31;33;0;11;22;0
19450; 49.6 ; 198.4 ; 2.5 ;4;82;121;0;4;0;4;3;1;0;4;0
19451; 36.2 ; 108.5 ; 22.2 ;3;48;304;0;3;0;3;2;1;1;1;1
19452; 41.7 ; 83.4 ; 17.3 ;2;100;48;0;2;0;2;1;1;1;0;1
19453; 51.2 ; 1,637.4 ; 33.7 ;32;10;0;0;32;15;17;22;10;11;10;11
19454; 20.6 ; 205.8 ; 1.3 ;10;17;2;1;9;7;3;8;2;10;0;0
19455; 48.1 ; 144.3 ; 5.9 ;3;67;15;1;2;0;3;1;2;0;3;0
19456; 51.3 ; 1,180.2 ; 27.3 ;23;14;20;0;23;10;13;11;12;8;7;8
19457; 36.6 ; 73.3 ; 17.3 ;2;39;5;0;2;0;2;0;2;1;1;0
19458; 56.2 ; 168.6 ; 28.8 ;3;46;100;0;3;2;1;1;2;1;0;2
19459; 25.1 ; 50.1 ; -   ;2;25;289;0;2;0;2;0;2;2;0;0
19460; 19.1 ; 114.8 ; 5.2 ;6;8;198;0;6;5;1;3;3;6;0;0
19461; 72.9 ; 291.7 ; 21.8 ;4;90;52;1;3;1;3;4;0;0;0;4
19462; 27.6 ; 55.3 ; 3.8 ;2;45;230;0;2;0;2;0;2;1;1;0
19463; 77.8 ; 700.3 ; 69.1 ;9;36;53;0;9;1;8;7;2;3;0;6
19464; 47.7 ; 286.5 ; 16.4 ;6;51;11;0;6;0;6;5;1;0;4;2
19465; 35.4 ; 176.8 ; 16.3 ;5;41;107;4;1;4;1;2;3;2;3;0
19466; 28.5 ; 1,026.3 ; 16.2 ;36;9;3;0;36;11;25;24;12;24;12;0
19467; 29.8 ; 59.6 ; 7.1 ;2;323;89;0;2;1;1;1;1;1;1;0
19468; 80.1 ; 400.6 ; 70.8 ;5;43;152;0;5;1;4;4;1;2;0;3
19469; 67.3 ; 807.8 ; 21.6 ;12;15;47;0;12;4;8;10;2;0;0;12
19470; 22.6 ; 45.2 ; 11.4 ;2;393;65;0;2;1;1;1;1;1;1;0
19471; 26.3 ; 131.7 ; 8.4 ;5;38;160;0;5;1;4;3;2;3;2;0
19472; 35.8 ; 178.9 ; 16.4 ;5;7;258;0;5;2;3;4;1;2;3;0
19473; 28.5 ; 85.4 ; 3.1 ;3;119;110;0;3;1;2;1;2;2;1;0
19474; 54.5 ; 163.4 ; 12.4 ;3;18;257;0;3;2;1;1;2;0;2;1
19475; 80.7 ; 403.4 ; 39.9 ;5;41;83;0;5;0;5;5;0;0;0;5
19476; 38.2 ; 267.3 ; 3.3 ;7;54;25;0;7;3;4;1;6;0;7;0
19477; 68.9 ; 206.7 ; 11.9 ;3;97;5;3;0;0;3;3;0;0;0;3
19478; 22.5 ; 157.3 ; 7.9 ;7;45;20;0;7;4;3;3;4;5;2;0
19479; 22.4 ; 44.7 ; 4.6 ;2;88;188;0;2;0;2;2;0;2;0;0
19480; 33.5 ; 67.0 ; 3.5 ;2;83;20;0;2;1;1;2;0;0;2;0
19481; 48.6 ; 145.7 ; 2.7 ;3;82;31;3;0;0;3;2;1;0;3;0
19482; 22.5 ; 90.1 ; 10.2 ;4;3;201;0;4;4;0;2;2;3;1;0
19483; 48.6 ; 97.2 ; -   ;2;21;131;0;2;1;1;0;2;0;2;0
19484; 40.2 ; 120.5 ; 9.6 ;3;40;78;0;3;1;2;1;2;0;3;0
19485; 29.1 ; 145.6 ; 11.0 ;5;17;92;0;5;3;2;3;2;3;2;0
19486; 48.2 ; 96.3 ; 2.1 ;2;50;110;0;2;0;2;2;0;0;2;0
19487; 40.9 ; 245.2 ; 19.0 ;6;38;99;0;6;0;6;4;2;2;2;2
19488; 33.0 ; 164.9 ; 9.3 ;5;36;203;0;5;4;1;0;5;2;3;0
19489; 16.7 ; 133.2 ; 5.3 ;8;17;35;8;0;4;4;2;6;8;0;0
19490; 18.2 ; 109.3 ; 5.9 ;6;32;116;0;6;1;5;3;3;6;0;0
19491; 17.6 ; 702.1 ; 7.5 ;40;9;17;0;40;25;15;27;13;40;0;0
19492; 33.0 ; 99.0 ; 17.5 ;3;3;43;3;0;1;2;2;1;1;2;0
19493; 26.2 ; 52.4 ; 12.6 ;2;6;173;0;2;0;2;1;1;1;1;0
19494; 22.1 ; 221.4 ; 12.9 ;10;17;117;0;10;8;2;10;0;7;3;0
19495; 63.5 ; 508.4 ; 35.1 ;8;25;105;0;8;0;8;8;0;3;0;5
19496; 68.3 ; 683.1 ; 36.0 ;10;31;10;0;10;1;9;8;2;0;0;10
19497; 68.1 ; 204.3 ; 9.3 ;3;88;47;0;3;0;3;3;0;0;0;3
19498; 25.0 ; 125.2 ; 7.7 ;5;93;16;0;5;1;4;3;2;3;2;0
19499; 41.2 ; 164.8 ; 13.7 ;4;95;68;0;4;0;4;2;2;1;3;0
19500; 53.5 ; 160.5 ; 9.9 ;3;110;68;1;2;0;3;3;0;0;2;1
19501; 38.1 ; 114.2 ; 7.1 ;3;162;119;0;3;2;1;1;2;0;3;0
19502; 38.0 ; 76.1 ; 19.4 ;2;110;134;0;2;1;1;1;1;1;0;1
19503; 49.3 ; 98.7 ; 36.4 ;2;147;89;0;2;1;1;0;2;1;0;1
19504; 47.5 ; 142.4 ; -   ;3;13;59;1;2;2;1;1;2;0;3;0
19505; 41.6 ; 249.5 ; 15.4 ;6;31;0;0;6;1;5;0;6;2;2;2
19506; 46.8 ; 93.5 ; -   ;2;63;209;0;2;0;2;2;0;0;2;0
19507; 44.8 ; 89.6 ; 2.9 ;2;37;110;0;2;0;2;1;1;0;2;0
19508; 24.7 ; 74.1 ; 12.6 ;3;88;96;0;3;3;0;2;1;2;1;0
19509; 63.0 ; 126.1 ; 6.7 ;2;309;141;0;2;0;2;0;2;0;0;2
19510; 44.6 ; 580.0 ; 9.3 ;13;14;0;0;13;3;10;5;8;0;13;0
19511; 66.7 ; 200.2 ; 8.3 ;3;9;246;0;3;0;3;3;0;0;0;3
19512; 43.4 ; 130.1 ; 16.8 ;3;23;75;0;3;1;2;1;2;1;1;1
19513; 52.0 ; 104.0 ; 40.3 ;2;7;336;0;2;0;2;0;2;1;0;1
19514; 51.9 ; 103.8 ; 12.7 ;2;27;239;0;2;1;1;0;2;0;1;1
19515; 60.8 ; 121.6 ; 49.0 ;2;10;106;2;0;0;2;2;0;1;0;1
19516; 30.1 ; 631.4 ; 14.3 ;21;17;44;0;21;10;11;10;11;7;14;0
19517; 42.1 ; 84.3 ; 2.2 ;2;8;72;0;2;1;1;0;2;0;2;0
19518; 15.0 ; 404.6 ; -   ;27;13;23;0;27;15;12;16;11;27;0;0
19519; 52.3 ; 209.3 ; 7.7 ;4;76;89;0;4;1;3;3;1;0;3;1
19520; 61.4 ; 306.8 ; 23.8 ;5;36;1;0;5;0;5;3;2;0;0;5
19521; 24.7 ; 345.9 ; 1.5 ;14;14;11;0;14;0;14;2;12;14;0;0
19522; 52.5 ; 210.1 ; -   ;4;94;124;0;4;2;2;1;3;0;4;0
19523; 60.8 ; 243.3 ; 27.8 ;4;37;5;4;0;1;3;1;3;0;0;4
19524; 15.0 ; 59.9 ; -   ;4;28;78;0;4;0;4;2;2;4;0;0
19525; 38.3 ; 114.9 ; 18.1 ;3;41;204;0;3;0;3;3;0;1;1;1
19526; 50.8 ; 152.5 ; 32.2 ;3;94;10;0;3;1;2;2;1;1;1;1
19527; 20.1 ; 80.4 ; 0.9 ;4;14;225;0;4;0;4;1;3;4;0;0
19528; 30.5 ; 152.3 ; 11.4 ;5;59;62;0;5;2;3;3;2;2;3;0
19529; 21.0 ; 105.2 ; 6.4 ;5;32;100;0;5;2;3;1;4;5;0;0
19530; 46.0 ; 137.9 ; 9.2 ;3;61;68;0;3;1;2;0;3;0;2;1
19531; 47.7 ; 238.6 ; 0.4 ;5;11;14;0;5;3;2;0;5;0;5;0
19532; 33.0 ; 330.1 ; 12.7 ;10;13;65;0;10;3;7;10;0;3;7;0
19533; 33.4 ; 66.8 ; 4.8 ;2;164;21;0;2;0;2;1;1;1;1;0
19534; 38.3 ; 76.6 ; 15.6 ;2;45;214;0;2;1;1;2;0;1;1;0
19535; 50.4 ; 251.8 ; 3.7 ;5;44;163;0;5;0;5;5;0;0;5;0
19536; 39.1 ; 273.6 ; 11.3 ;7;39;28;0;7;2;5;2;5;2;5;0
19537; 45.9 ; 229.3 ; 12.9 ;5;16;37;0;5;2;3;2;3;0;3;2
19538; 92.7 ; 185.5 ; 1.6 ;2;45;178;0;2;0;2;2;0;0;0;2
19539; 58.7 ; 469.7 ; 15.3 ;8;25;100;0;8;3;5;1;7;0;0;8
19540; 69.2 ; 138.4 ; 13.7 ;2;25;20;0;2;0;2;2;0;0;0;2
19541; 22.5 ; 44.9 ; 11.2 ;2;25;204;0;2;0;2;2;0;1;1;0
19542; 23.7 ; 94.7 ; 10.2 ;4;11;99;0;4;0;4;4;0;3;1;0
19543; 58.0 ; 290.2 ; 11.6 ;5;76;73;1;4;1;4;3;2;0;0;5
19544; 66.6 ; 199.7 ; 18.9 ;3;41;129;0;3;3;0;1;2;0;0;3
19545; 15.0 ; 30.0 ; -   ;2;66;148;0;2;1;1;1;1;2;0;0
19546; 15.0 ; 74.9 ; -   ;5;16;250;0;5;3;2;5;0;5;0;0
19547; 26.4 ; 105.5 ; 8.0 ;4;2;248;0;4;1;3;4;0;3;1;0
19548; 48.7 ; 146.0 ; 3.5 ;3;164;120;0;3;0;3;1;2;0;3;0
19549; 38.0 ; 76.1 ; 19.4 ;2;6;110;0;2;0;2;2;0;1;0;1
19550; 30.2 ; 60.4 ; -   ;2;289;26;1;1;0;2;1;1;0;2;0
19551; 19.3 ; 77.1 ; 2.1 ;4;69;94;0;4;0;4;1;3;4;0;0
19552; 48.6 ; 145.9 ; 43.0 ;3;16;250;0;3;3;0;1;2;1;1;1
19553; 80.8 ; 403.8 ; 35.1 ;5;8;3;0;5;2;3;4;1;0;0;5
19554; 20.3 ; 162.4 ; 5.0 ;8;51;8;0;8;1;7;5;3;8;0;0
19555; 33.9 ; 441.2 ; 10.5 ;13;25;6;0;13;7;6;6;7;4;9;0
19556; 38.5 ; 307.7 ; 8.8 ;8;23;15;1;7;0;8;7;1;3;5;0
19557; 70.6 ; 353.0 ; 35.5 ;5;51;104;0;5;3;2;1;4;0;0;5
19558; 31.6 ; 253.2 ; 6.6 ;8;32;1;0;8;3;5;3;5;3;5;0
19559; 24.8 ; 247.8 ; 7.7 ;10;7;5;0;10;3;7;8;2;7;3;0
19560; 58.7 ; 117.5 ; 18.0 ;2;1;142;2;0;0;2;1;1;0;0;2
19561; 27.8 ; 111.0 ; 16.1 ;4;21;186;0;4;2;2;1;3;3;1;0
19562; 15.9 ; 31.8 ; 1.4 ;2;5;14;0;2;2;0;2;0;2;0;0
19563; 32.6 ; 293.1 ; 19.4 ;9;41;38;0;9;2;7;3;6;3;6;0
19564; 65.7 ; 131.3 ; 25.5 ;2;12;267;0;2;0;2;2;0;0;0;2
19565; 38.1 ; 76.3 ; 13.2 ;2;125;171;0;2;2;0;1;1;1;1;0
19566; 72.0 ; 1,008.2 ; 24.5 ;14;13;11;0;14;6;8;5;9;0;0;14
19567; 90.4 ; 451.9 ; 41.7 ;5;57;31;1;4;1;4;4;1;0;0;5
19568; 15.0 ; 30.0 ; -   ;2;2;261;0;2;1;1;1;1;2;0;0
19569; 27.3 ; 54.6 ; 3.3 ;2;230;80;0;2;1;1;1;1;1;1;0
19570; 30.9 ; 61.7 ; 23.8 ;2;77;115;0;2;1;1;0;2;1;1;0
19571; 21.7 ; 86.9 ; 2.8 ;4;22;27;0;4;3;1;3;1;4;0;0
19572; 31.6 ; 63.2 ; 24.9 ;2;23;11;0;2;0;2;2;0;1;0;1
19573; 21.4 ; 42.9 ; 5.4 ;2;18;194;0;2;0;2;1;1;2;0;0
19574; 53.8 ; 161.3 ; 16.4 ;3;32;5;0;3;0;3;2;1;0;2;1
19575; 41.8 ; 83.6 ; 2.1 ;2;8;169;0;2;1;1;1;1;0;2;0
19576; 31.6 ; 63.2 ; 24.9 ;2;6;5;0;2;0;2;1;1;1;0;1
19577; 43.5 ; 217.5 ; 10.9 ;5;23;193;0;5;2;3;4;1;0;5;0
19578; 27.5 ; 55.0 ; 18.8 ;2;35;201;0;2;1;1;0;2;1;1;0
19579; 21.3 ; 85.2 ; 6.3 ;4;41;16;0;4;2;2;3;1;4;0;0
19580; 23.0 ; 137.9 ; 4.0 ;6;34;17;0;6;0;6;0;6;6;0;0
19581; 28.8 ; 144.2 ; 9.4 ;5;81;33;0;5;3;2;3;2;3;2;0
19582; 16.8 ; 50.4 ; 3.3 ;3;121;73;0;3;1;2;1;2;3;0;0
19583; 21.6 ; 86.2 ; 8.6 ;4;40;8;0;4;4;0;3;1;3;1;0
19584; 29.2 ; 905.1 ; 22.4 ;31;10;44;0;31;14;17;15;16;21;10;0
19585; 95.7 ; 191.3 ; 1.1 ;2;57;20;0;2;0;2;2;0;0;0;2
19586; 21.1 ; 126.5 ; 8.4 ;6;41;56;0;6;3;3;3;3;6;0;0
19587; 61.1 ; 183.4 ; 17.2 ;3;7;277;0;3;1;2;2;1;0;0;3
19588; 24.5 ; 49.1 ; 0.8 ;2;1;122;0;2;1;1;1;1;2;0;0
19589; 47.2 ; 141.7 ; 0.4 ;3;89;85;0;3;1;2;1;2;0;3;0
19590; 45.3 ; 317.2 ; 41.4 ;7;52;93;0;7;1;6;5;2;2;3;2
19591; 48.2 ; 96.4 ; -   ;2;7;5;0;2;0;2;2;0;0;2;0
19592; 22.5 ; 44.9 ; 11.2 ;2;5;260;0;2;2;0;0;2;1;1;0
19593; 41.0 ; 81.9 ; 15.0 ;2;12;5;0;2;0;2;2;0;1;0;1
19594; 38.0 ; 190.2 ; 16.0 ;5;30;41;0;5;1;4;3;2;2;3;0
19595; 34.0 ; 204.2 ; 19.3 ;6;77;32;1;5;1;5;2;4;2;4;0
19596; 20.2 ; 40.5 ; 0.8 ;2;322;10;0;2;0;2;2;0;2;0;0
19597; 15.0 ; 30.0 ; -   ;2;24;213;0;2;2;0;1;1;2;0;0
19598; 55.7 ; 111.4 ; 12.3 ;2;20;25;0;2;1;1;1;1;0;0;2
19599; 53.9 ; 107.9 ; -   ;2;21;1;0;2;1;1;1;1;0;2;0
19600; 30.6 ; 366.7 ; 7.7 ;12;14;137;0;12;6;6;3;9;4;8;0
19601; 30.0 ; 89.9 ; -   ;3;4;244;0;3;2;1;1;2;3;0;0
19602; 68.0 ; 272.0 ; 26.5 ;4;19;79;0;4;0;4;2;2;0;0;4
19603; 50.0 ; 550.1 ; 18.5 ;11;11;5;0;11;8;3;10;1;0;7;4
19604; 22.8 ; 730.3 ; 9.2 ;32;14;5;0;32;18;14;20;12;21;11;0
19605; 55.7 ; 111.4 ; 7.0 ;2;52;116;0;2;1;1;2;0;0;0;2
19606; 61.3 ; 122.5 ; 14.3 ;2;297;74;0;2;0;2;2;0;0;0;2
19607; 18.9 ; 56.6 ; 5.5 ;3;103;22;1;2;1;2;1;2;3;0;0
19608; 41.1 ; 164.3 ; 6.0 ;4;32;222;0;4;2;2;1;3;0;4;0
19609; 39.5 ; 118.5 ; 6.7 ;3;56;17;0;3;2;1;3;0;0;3;0
19610; 17.9 ; 125.2 ; 4.8 ;7;47;1;0;7;4;3;4;3;7;0;0
19611; 81.4 ; 244.3 ; 32.0 ;3;88;10;0;3;0;3;3;0;0;0;3
19612; 47.8 ; 95.7 ; 0.5 ;2;42;17;2;0;0;2;0;2;0;2;0
19613; 35.9 ; 71.8 ; 19.2 ;2;30;242;0;2;0;2;2;0;1;0;1
19614; 21.3 ; 106.6 ; 10.2 ;5;3;63;0;5;3;2;5;0;3;2;0
19615; 31.4 ; 156.9 ; 6.2 ;5;5;6;0;5;0;5;2;3;2;3;0
19616; 31.7 ; 316.6 ; 17.3 ;10;38;6;0;10;2;8;7;3;3;7;0
19617; 47.7 ; 95.4 ; 1.4 ;2;12;262;0;2;0;2;2;0;0;2;0
19618; 44.9 ; 539.2 ; 27.8 ;12;11;2;0;12;0;12;10;2;4;4;4
19619; 15.0 ; 74.9 ; -   ;5;32;242;0;5;0;5;1;4;5;0;0
19620; 22.6 ; 67.9 ; 5.6 ;3;7;111;0;3;2;1;1;2;3;0;0
19621; 49.6 ; 148.7 ; 22.2 ;3;108;78;0;3;2;1;3;0;1;1;1
19622; 38.8 ; 77.7 ; 12.9 ;2;34;50;2;0;1;1;1;1;1;1;0
19623; 64.9 ; 324.7 ; 45.8 ;5;43;22;0;5;2;3;3;2;2;0;3
19624; 23.1 ; 392.3 ; 5.9 ;17;5;2;0;17;9;8;6;11;17;0;0
19625; 43.0 ; 129.0 ; 28.8 ;3;44;104;0;3;0;3;1;2;1;1;1
19626; 44.7 ; 178.8 ; 24.7 ;4;113;37;0;4;1;3;2;2;1;2;1
19627; 77.0 ; 154.0 ; 30.3 ;2;5;158;0;2;0;2;1;1;0;0;2
19628; 26.0 ; 207.6 ; 6.8 ;8;25;6;0;8;4;4;1;7;5;3;0
19629; 30.3 ; 575.6 ; 17.8 ;19;16;23;0;19;6;13;8;11;6;13;0
19630; 50.9 ; 254.5 ; 8.8 ;5;50;110;0;5;2;3;5;0;0;3;2
19631; 52.8 ; 105.6 ; 4.9 ;2;118;234;0;2;2;0;1;1;0;1;1
19632; 39.8 ; 199.2 ; 9.2 ;5;20;207;0;5;3;2;1;4;0;5;0
19633; 37.9 ; 151.6 ; 15.3 ;4;76;11;3;1;1;3;4;0;1;3;0
19634; 43.3 ; 129.8 ; 3.5 ;3;77;168;0;3;1;2;0;3;0;3;0
19635; 39.3 ; 628.3 ; 25.3 ;16;21;10;0;16;2;14;14;2;5;6;5
19636; 34.7 ; 104.0 ; 7.9 ;3;2;340;0;3;1;2;2;1;1;2;0
19637; 18.1 ; 488.4 ; 2.9 ;27;5;18;0;27;7;20;5;22;27;0;0
19638; 58.7 ; 176.0 ; 11.3 ;3;13;215;0;3;0;3;2;1;0;0;3
19639; 18.6 ; 55.7 ; -   ;3;7;35;0;3;1;2;0;3;3;0;0
19640; 17.5 ; 70.0 ; 5.3 ;4;64;10;0;4;2;2;2;2;4;0;0
19641; 40.7 ; 244.5 ; 10.6 ;6;50;15;0;6;2;4;3;3;0;6;0
19642; 57.5 ; 172.6 ; 24.7 ;3;92;167;0;3;0;3;3;0;0;0;3
19643; 16.0 ; 48.0 ; 1.9 ;3;22;63;0;3;1;2;0;3;3;0;0
19644; 20.1 ; 60.3 ; 2.6 ;3;44;68;3;0;0;3;1;2;3;0;0
19645; 47.5 ; 94.9 ; -   ;2;20;42;0;2;0;2;0;2;0;2;0
19646; 36.1 ; 180.7 ; 10.3 ;5;14;60;0;5;1;4;3;2;2;3;0
19647; 36.3 ; 181.4 ; 7.2 ;5;7;325;0;5;1;4;3;2;2;3;0
19648; 20.0 ; 40.1 ; 7.6 ;2;17;25;0;2;2;0;0;2;2;0;0
19649; 37.4 ; 186.8 ; 17.3 ;5;36;26;0;5;1;4;4;1;2;3;0
19650; 29.8 ; 59.5 ; 0.6 ;2;112;51;0;2;2;0;2;0;1;1;0
19651; 47.2 ; 235.9 ; 14.8 ;5;54;20;0;5;0;5;5;0;0;3;2
19652; 46.8 ; 93.5 ; -   ;2;9;207;0;2;1;1;0;2;0;2;0
19653; 15.1 ; 30.3 ; 0.2 ;2;13;149;0;2;2;0;2;0;2;0;0
19654; 20.2 ; 647.4 ; 3.5 ;32;12;18;0;32;26;6;5;27;32;0;0
19655; 28.8 ; 57.6 ; 5.1 ;2;104;11;0;2;0;2;0;2;1;1;0
19656; 33.5 ; 67.1 ; 1.4 ;2;131;0;0;2;0;2;2;0;0;2;0
19657; 25.1 ; 100.3 ; -   ;4;93;104;0;4;4;0;1;3;4;0;0
19658; 15.0 ; 30.0 ; -   ;2;114;273;0;2;0;2;1;1;2;0;0
19659; 49.6 ; 99.3 ; 4.3 ;2;29;227;0;2;0;2;0;2;0;2;0
19660; 47.8 ; 95.7 ; 0.5 ;2;12;15;0;2;0;2;2;0;0;2;0
19661; 25.6 ; 128.1 ; 0.6 ;5;44;110;0;5;4;1;4;1;5;0;0
19662; 30.7 ; 123.0 ; 18.6 ;4;50;93;0;4;4;0;2;2;1;3;0
19663; 25.2 ; 176.4 ; 12.6 ;7;37;64;0;7;4;3;1;6;5;2;0
19664; 29.7 ; 89.0 ; 7.0 ;3;5;6;0;3;2;1;1;2;2;1;0
19665; 25.8 ; 438.1 ; 15.3 ;17;7;6;0;17;8;9;3;14;11;6;0
19666; 41.0 ; 205.2 ; 10.8 ;5;56;52;0;5;2;3;1;4;0;5;0
19667; 54.5 ; 6,703.7 ; 27.6 ;123;3;4;0;123;53;70;29;94;41;41;41
19668; 17.3 ; 103.8 ; 4.4 ;6;4;337;0;6;1;5;2;4;6;0;0
19669; 39.3 ; 432.4 ; 4.6 ;11;23;4;0;11;7;4;8;3;0;11;0
19670; 25.4 ; 101.7 ; 9.4 ;4;70;29;0;4;1;3;2;2;3;1;0
19671; 21.7 ; 152.0 ; 12.5 ;7;5;10;0;7;5;2;2;5;5;2;0
19672; 25.4 ; 101.7 ; 0.8 ;4;8;78;0;4;0;4;1;3;4;0;0
19673; 17.5 ; 70.0 ; 5.3 ;4;18;239;0;4;1;3;2;2;4;0;0
19674; 46.4 ; 139.3 ; 6.2 ;3;43;47;0;3;0;3;1;2;0;3;0
19675; 19.9 ; 59.8 ; 3.7 ;3;45;166;0;3;1;2;1;2;3;0;0
19676; 47.7 ; 95.5 ; 1.5 ;2;14;158;2;0;1;1;2;0;0;2;0
19677; 42.9 ; 128.6 ; -   ;3;57;115;0;3;0;3;2;1;0;3;0
19678; 22.7 ; 136.0 ; 7.8 ;6;27;5;0;6;0;6;3;3;4;2;0
19679; 54.2 ; 162.7 ; 7.1 ;3;82;125;0;3;0;3;3;0;0;2;1
19680; 36.9 ; 110.8 ; 17.2 ;3;34;63;0;3;0;3;2;1;1;2;0
19681; 52.1 ; 104.2 ; 8.0 ;2;14;120;0;2;0;2;1;1;0;1;1
19682; 17.6 ; 105.8 ; 5.9 ;6;32;84;0;6;2;4;2;4;6;0;0
19683; 29.1 ; 261.6 ; 11.5 ;9;34;5;0;9;5;4;5;4;6;3;0
19684; 32.9 ; 131.8 ; 18.9 ;4;122;33;0;4;2;2;1;3;1;3;0
19685; 23.1 ; 46.2 ; 3.0 ;2;28;164;2;0;2;0;0;2;2;0;0
19686; 19.0 ; 75.9 ; 8.4 ;4;4;15;0;4;1;3;2;2;4;0;0
19687; 51.3 ; 205.2 ; 5.7 ;4;31;195;0;4;0;4;3;1;0;3;1
19688; 65.2 ; 195.6 ; 23.8 ;3;31;131;0;3;0;3;2;1;0;0;3
19689; 26.5 ; 158.7 ; 17.5 ;6;36;0;0;6;3;3;2;4;4;2;0
19690; 28.0 ; 56.0 ; 3.3 ;2;104;233;0;2;1;1;0;2;1;1;0
19691; 45.2 ; 90.3 ; 2.4 ;2;91;31;1;1;1;1;0;2;0;2;0
19692; 35.5 ; 603.3 ; 19.3 ;17;15;23;0;17;7;10;8;9;6;11;0
19693; 15.0 ; 30.0 ; -   ;2;121;181;0;2;2;0;2;0;2;0;0
19694; 43.3 ; 216.7 ; 20.0 ;5;25;161;0;5;3;2;1;4;2;1;2
19695; 59.3 ; 296.4 ; 10.6 ;5;71;31;0;5;1;4;4;1;0;0;5
19696; 24.7 ; 49.4 ; 14.6 ;2;100;175;0;2;1;1;0;2;1;1;0
19697; 36.9 ; 516.6 ; 21.3 ;14;24;11;0;14;5;9;6;8;5;4;5
19698; 17.5 ; 87.6 ; 1.5 ;5;65;115;0;5;0;5;4;1;5;0;0
19699; 43.2 ; 173.0 ; 5.1 ;4;25;99;4;0;0;4;0;4;0;4;0
19700; 32.3 ; 64.6 ; 3.2 ;2;5;215;2;0;0;2;2;0;1;1;0
19701; 15.0 ; 59.9 ; -   ;4;14;153;0;4;0;4;1;3;4;0;0
19702; 79.3 ; 158.6 ; 23.4 ;2;94;70;0;2;2;0;2;0;0;0;2
19703; 61.5 ; 553.9 ; 46.8 ;9;6;7;0;9;1;8;7;2;3;0;6
19704; 40.9 ; 81.8 ; -   ;2;67;194;0;2;1;1;2;0;0;2;0
19705; 42.9 ; 128.6 ; -   ;3;32;204;0;3;2;1;3;0;0;3;0
19706; 61.5 ; 307.4 ; 30.1 ;5;55;83;3;2;0;5;5;0;0;0;5
19707; 87.2 ; 261.7 ; 27.1 ;3;101;73;0;3;0;3;1;2;0;0;3
19708; 23.5 ; 93.8 ; 9.8 ;4;15;242;0;4;3;1;2;2;3;1;0
19709; 159.3 ; 478.0 ; 144.5 ;3;1;251;0;3;1;2;2;1;1;0;2
19710; 42.7 ; 85.4 ; 8.2 ;2;30;5;0;2;1;1;2;0;0;2;0
19711; 41.9 ; 125.6 ; 10.7 ;3;5;273;0;3;1;2;1;2;0;3;0
19712; 45.4 ; 227.0 ; 12.0 ;5;76;15;0;5;1;4;4;1;0;3;2
19713; 41.9 ; 125.8 ; 10.1 ;3;45;19;3;0;1;2;2;1;0;3;0
19714; 26.6 ; 79.7 ; 18.6 ;3;68;43;2;1;1;2;1;2;2;1;0
19715; 42.8 ; 856.6 ; 35.1 ;20;12;42;0;20;11;9;8;12;7;6;7
19716; 36.5 ; 145.9 ; 6.3 ;4;48;74;0;4;0;4;4;0;0;4;0
19717; 54.4 ; 598.4 ; 19.2 ;11;19;26;0;11;5;6;5;6;0;7;4
19718; 47.6 ; 333.1 ; 8.4 ;7;17;2;0;7;2;5;5;2;0;5;2
19719; 53.6 ; 482.7 ; 15.4 ;9;27;89;0;9;0;9;6;3;0;6;3
19720; 24.0 ; 719.1 ; 23.7 ;30;7;5;0;30;11;19;8;22;20;10;0
19721; 46.8 ; 93.5 ; -   ;2;50;267;0;2;0;2;1;1;0;2;0
19722; 57.1 ; 114.3 ; 15.5 ;2;241;124;0;2;1;1;2;0;0;0;2
19723; 38.4 ; 153.4 ; 24.0 ;4;97;23;0;4;3;1;1;3;1;2;1
19724; 33.6 ; 235.0 ; 13.3 ;7;38;47;0;7;4;3;4;3;2;5;0
19725; 62.5 ; 125.1 ; 4.8 ;2;27;140;0;2;1;1;2;0;0;0;2
19726; 52.1 ; 156.2 ; 22.0 ;3;32;2;0;3;3;0;1;2;0;2;1
19727; 46.1 ; 276.6 ; 8.2 ;6;70;9;0;6;3;3;5;1;0;6;0
19728; 18.4 ; 128.8 ; 2.3 ;7;16;77;7;0;6;1;7;0;7;0;0
19729; 98.5 ; 197.1 ; 68.9 ;2;320;1;0;2;0;2;0;2;1;0;1
19730; 15.0 ; 104.9 ; -   ;7;37;107;0;7;5;2;1;6;7;0;0
19731; 23.1 ; 277.1 ; 4.3 ;12;7;132;0;12;7;5;2;10;12;0;0
19732; 27.0 ; 377.6 ; 10.2 ;14;11;7;1;13;9;5;12;2;9;5;0
19733; 56.4 ; 225.5 ; 19.3 ;4;6;0;0;4;1;3;2;2;0;0;4
19734; 49.8 ; 99.6 ; 4.6 ;2;55;257;0;2;1;1;2;0;0;2;0
19735; 24.7 ; 99.0 ; 6.7 ;4;35;28;0;4;3;1;2;2;3;1;0
19736; 30.9 ; 61.7 ; 23.8 ;2;320;52;1;1;0;2;2;0;1;1;0
19737; 46.8 ; 93.5 ; -   ;2;5;307;0;2;2;0;0;2;0;2;0
19738; 32.2 ; 128.8 ; 11.9 ;4;74;11;0;4;2;2;4;0;1;3;0
19739; 23.1 ; 92.3 ; 7.2 ;4;32;48;0;4;2;2;1;3;3;1;0
19740; 43.8 ; 87.7 ; 4.4 ;2;3;250;0;2;1;1;0;2;0;2;0
19741; 21.4 ; 811.7 ; 8.6 ;38;10;9;0;38;24;14;10;28;25;13;0
19742; 37.7 ; 188.5 ; 19.5 ;5;65;64;0;5;3;2;3;2;2;1;2
19743; 19.8 ; 1,883.9 ; 2.8 ;95;4;0;0;95;41;54;39;56;95;0;0
19744; 19.0 ; 266.1 ; 9.5 ;14;16;17;0;14;7;7;3;11;14;0;0
19745; 59.3 ; 118.6 ; 18.8 ;2;302;115;0;2;0;2;1;1;0;0;2
19746; 38.1 ; 228.6 ; 10.9 ;6;58;45;1;5;5;1;3;3;2;4;0
19747; 62.1 ; 682.7 ; 24.9 ;11;13;141;0;11;0;11;7;4;0;0;11
19748; 45.7 ; 91.4 ; 10.2 ;2;169;135;0;2;2;0;2;0;0;1;1
19749; 48.9 ; 342.2 ; 16.2 ;7;34;99;0;7;3;4;1;6;0;5;2
19750; 24.3 ; 632.1 ; 9.3 ;26;12;6;0;26;6;20;8;18;17;9;0
19751; 30.9 ; 340.0 ; 14.8 ;11;25;2;0;11;2;9;11;0;4;7;0
19752; 47.8 ; 334.4 ; 13.4 ;7;12;162;0;7;0;7;6;1;0;5;2
19753; 51.9 ; 207.6 ; 23.5 ;4;29;136;0;4;0;4;3;1;1;2;1
19754; 47.6 ; 95.2 ; 16.5 ;2;86;95;2;0;0;2;2;0;0;1;1
19755; 62.2 ; 186.7 ; 15.5 ;3;9;52;0;3;1;2;1;2;0;0;3
19756; 25.9 ; 155.5 ; 9.2 ;6;32;15;0;6;1;5;2;4;4;2;0
19757; 57.1 ; 114.1 ; 11.2 ;2;11;356;0;2;1;1;0;2;0;0;2
19758; 16.9 ; 67.4 ; 2.4 ;4;93;28;0;4;3;1;2;2;4;0;0
19759; 37.2 ; 74.3 ; 18.8 ;2;50;262;0;2;0;2;2;0;1;0;1
19760; 101.5 ; 203.0 ; 6.4 ;2;13;199;0;2;0;2;2;0;0;0;2
19761; 44.6 ; 312.1 ; 7.2 ;7;40;39;0;7;4;3;5;2;0;7;0
19762; 44.1 ; 88.2 ; 7.8 ;2;6;228;0;2;2;0;1;1;0;2;0
19763; 53.6 ; 375.2 ; 27.5 ;7;42;0;0;7;0;7;5;2;2;3;2
19764; 22.5 ; 44.9 ; 11.2 ;2;36;177;2;0;2;0;0;2;1;1;0
19765; 43.1 ; 172.6 ; 9.6 ;4;14;2;0;4;2;2;1;3;0;4;0
19766; 36.6 ; 109.8 ; -   ;3;68;96;0;3;1;2;2;1;0;3;0
19767; 50.3 ; 100.6 ; 5.3 ;2;32;248;0;2;1;1;2;0;0;1;1
19768; 126.4 ; 379.3 ; 60.0 ;3;14;13;3;0;2;1;2;1;0;0;3
19769; 32.6 ; 130.3 ; 15.7 ;4;65;8;0;4;4;0;2;2;1;3;0
19770; 33.5 ; 670.3 ; 21.9 ;20;10;3;0;20;9;11;12;8;7;6;7
19771; 64.3 ; 257.2 ; 28.4 ;4;68;92;0;4;2;2;4;0;0;0;4
19772; 31.6 ; 94.7 ; 18.4 ;3;59;137;0;3;0;3;1;2;1;2;0
19773; 19.9 ; 99.5 ; 5.3 ;5;66;42;0;5;2;3;3;2;5;0;0
19774; 23.7 ; 355.7 ; 9.2 ;15;12;5;0;15;9;6;7;8;10;5;0
19775; 93.3 ; 186.6 ; 47.3 ;2;9;248;0;2;1;1;2;0;0;0;2
19776; 54.3 ; 271.7 ; 32.3 ;5;64;23;0;5;2;3;2;3;2;1;2
19777; 38.8 ; 116.3 ; 18.7 ;3;38;204;0;3;0;3;3;0;1;1;1
19778; 58.5 ; 116.9 ; 40.9 ;2;56;105;0;2;0;2;2;0;1;0;1
19779; 34.0 ; 373.7 ; 12.3 ;11;33;27;0;11;2;9;3;8;4;7;0
19780; 30.8 ; 246.5 ; 18.3 ;8;15;72;0;8;3;5;6;2;3;5;0
19781; 19.4 ; 58.3 ; 5.2 ;3;9;17;3;0;0;3;2;1;3;0;0
19782; 53.7 ; 1,019.5 ; 17.8 ;19;22;11;0;19;0;19;19;0;0;13;6
19783; 64.5 ; 774.3 ; 24.8 ;12;32;0;0;12;6;6;2;10;0;0;12
19784; 28.6 ; 57.2 ; 5.3 ;2;59;262;0;2;1;1;1;1;1;1;0
19785; 19.9 ; 179.4 ; 11.2 ;9;32;154;0;9;4;5;7;2;6;3;0
19786; 49.6 ; 99.3 ; 2.9 ;2;1;163;0;2;0;2;1;1;0;2;0
19787; 37.9 ; 416.8 ; 14.0 ;11;38;20;0;11;5;6;10;1;4;7;0
19788; 21.9 ; 109.4 ; 7.6 ;5;27;56;0;5;2;3;4;1;5;0;0
19789; 27.6 ; 55.3 ; 3.8 ;2;117;99;2;0;1;1;2;0;1;1;0
19790; 37.7 ; 113.2 ; 16.6 ;3;9;242;0;3;2;1;3;0;1;2;0
19791; 40.8 ; 204.1 ; 10.6 ;5;27;15;0;5;0;5;5;0;0;5;0
19792; 15.0 ; 30.0 ; -   ;2;80;160;0;2;2;0;0;2;2;0;0
19793; 50.1 ; 250.5 ; 6.9 ;5;13;197;0;5;4;1;5;0;0;3;2
19794; 39.2 ; 156.6 ; 11.3 ;4;47;8;1;3;1;3;1;3;1;3;0
19795; 19.5 ; 39.0 ; 6.7 ;2;367;36;0;2;0;2;2;0;2;0;0
19796; 36.5 ; 73.0 ; 9.5 ;2;7;209;0;2;0;2;1;1;1;1;0
19797; 35.4 ; 247.6 ; 10.6 ;7;38;5;0;7;1;6;6;1;2;5;0
19798; 35.8 ; 357.8 ; 15.5 ;10;32;17;0;10;3;7;5;5;3;7;0
19799; 48.4 ; 96.9 ; 35.0 ;2;226;79;0;2;0;2;1;1;1;0;1
19800; 18.1 ; 126.4 ; 4.9 ;7;40;10;0;7;0;7;3;4;7;0;0
19801; 30.6 ; 61.2 ; 8.3 ;2;58;5;0;2;0;2;0;2;1;1;0
19802; 24.2 ; 193.7 ; 11.8 ;8;35;33;0;8;2;6;5;3;5;3;0
19803; 38.3 ; 153.2 ; 25.5 ;4;57;209;0;4;3;1;1;3;1;2;1
19804; 16.4 ; 65.6 ; 1.0 ;4;36;1;0;4;2;2;4;0;4;0;0
19805; 28.1 ; 140.4 ; 19.0 ;5;59;104;0;5;0;5;1;4;3;2;0
19806; 15.0 ; 59.9 ; -   ;4;41;31;0;4;1;3;1;3;4;0;0
19807; 16.5 ; 49.6 ; 2.9 ;3;14;237;0;3;0;3;2;1;3;0;0
19808; 20.8 ; 145.4 ; 11.6 ;7;15;19;0;7;5;2;4;3;5;2;0
19809; 24.6 ; 147.7 ; 13.4 ;6;59;72;0;6;3;3;4;2;4;2;0
19810; 20.0 ; 40.1 ; 7.6 ;2;10;32;0;2;1;1;2;0;2;0;0
19811; 53.4 ; 106.8 ; 0.3 ;2;43;6;0;2;0;2;1;1;0;2;0
19812; 46.8 ; 93.5 ; -   ;2;5;238;0;2;1;1;0;2;0;2;0
19813; 44.8 ; 537.3 ; 15.8 ;12;32;5;0;12;1;11;5;7;4;4;4
19814; 121.1 ; 605.3 ; 74.7 ;5;71;32;0;5;3;2;2;3;0;0;5
19815; 18.1 ; 108.4 ; 2.2 ;6;36;80;0;6;4;2;2;4;6;0;0
19816; 52.1 ; 521.1 ; 31.7 ;10;30;5;0;10;0;10;7;3;3;4;3
19817; 29.0 ; 406.3 ; 22.3 ;14;28;16;0;14;0;14;5;9;9;5;0
19818; 45.5 ; 409.6 ; 13.2 ;9;8;15;0;9;0;9;6;3;0;6;3
19819; 36.7 ; 183.4 ; 15.7 ;5;45;72;4;1;3;2;4;1;2;3;0
19820; 33.5 ; 167.5 ; 7.8 ;5;12;161;2;3;3;2;2;3;2;3;0
19821; 22.4 ; 268.6 ; 9.1 ;12;10;51;0;12;12;0;8;4;8;4;0
19822; 62.3 ; 1,307.3 ; 59.2 ;21;19;2;0;21;15;6;20;1;7;0;14
19823; 61.0 ; 183.1 ; 29.8 ;3;49;173;0;3;1;2;2;1;0;0;3
19824; 89.4 ; 268.3 ; 30.0 ;3;140;62;1;2;1;2;2;1;0;0;3
19825; 19.7 ; 78.9 ; 3.9 ;4;129;106;0;4;3;1;4;0;4;0;0
19826; 25.1 ; 50.1 ; -   ;2;262;77;0;2;2;0;2;0;2;0;0
19827; 22.9 ; 114.4 ; 6.7 ;5;1;258;0;5;2;3;3;2;5;0;0
19828; 21.1 ; 42.1 ; 4.6 ;2;132;36;0;2;0;2;0;2;2;0;0
19829; 15.0 ; 45.0 ; -   ;3;7;277;0;3;3;0;1;2;3;0;0
19830; 42.1 ; 126.3 ; 6.1 ;3;25;158;0;3;1;2;2;1;0;3;0
19831; 43.5 ; 391.2 ; 40.7 ;9;23;95;0;9;0;9;6;3;3;3;3
19832; 48.7 ; 243.5 ; -   ;5;5;5;0;5;0;5;3;2;0;5;0
19833; 31.0 ; 309.6 ; 11.5 ;10;30;15;1;9;0;10;8;2;3;7;0
19834; 18.3 ; 73.3 ; 5.0 ;4;5;71;4;0;2;2;1;3;4;0;0
19835; 61.0 ; 183.0 ; 22.4 ;3;22;158;0;3;1;2;2;1;0;0;3
19836; 46.9 ; 1,314.5 ; 16.2 ;28;15;24;0;28;9;19;13;15;0;19;9
19837; 19.5 ; 234.3 ; 2.6 ;12;33;0;1;11;1;11;8;4;12;0;0
19838; 30.2 ; 90.6 ; -   ;3;76;143;0;3;2;1;1;2;0;3;0
19839; 83.7 ; 167.5 ; 54.3 ;2;13;73;0;2;0;2;1;1;1;0;1
19840; 20.0 ; 40.1 ; 7.6 ;2;19;167;0;2;0;2;0;2;2;0;0
19841; 49.6 ; 99.3 ; 4.3 ;2;31;209;0;2;0;2;2;0;0;2;0
19842; 34.8 ; 69.5 ; 23.1 ;2;15;5;1;1;1;1;1;1;1;0;1
19843; 24.5 ; 97.8 ; 20.1 ;4;8;230;0;4;4;0;1;3;3;1;0
19844; 49.5 ; 692.7 ; 16.7 ;14;19;20;0;14;0;14;12;2;0;9;5
19845; 59.0 ; 472.1 ; 18.1 ;8;23;48;0;8;0;8;7;1;0;0;8
19846; 33.7 ; 573.1 ; 21.4 ;17;16;28;0;17;11;6;17;0;6;5;6
19847; 65.2 ; 261.0 ; 23.8 ;4;68;20;0;4;1;3;4;0;0;0;4
19848; 67.6 ; 1,148.8 ; 32.1 ;17;23;15;0;17;5;12;8;9;0;0;17
19849; 63.6 ; 826.9 ; 25.4 ;13;32;12;0;13;5;8;8;5;0;0;13
19850; 52.5 ; 262.3 ; 29.5 ;5;69;29;0;5;5;0;5;0;2;1;2
19851; 27.5 ; 55.0 ; 9.6 ;2;1;239;0;2;2;0;0;2;1;1;0
19852; 23.0 ; 69.1 ; 6.8 ;3;28;162;0;3;0;3;1;2;3;0;0
19853; 40.6 ; 81.2 ; 15.6 ;2;64;94;0;2;0;2;0;2;1;0;1
19854; 22.6 ; 90.2 ; 5.3 ;4;70;1;0;4;1;3;2;2;4;0;0
19855; 59.6 ; 119.3 ; 44.1 ;2;126;162;0;2;0;2;2;0;1;0;1
19856; 16.2 ; 145.6 ; 1.9 ;9;14;15;0;9;0;9;3;6;9;0;0
19857; 25.1 ; 452.3 ; 7.6 ;18;15;10;0;18;3;15;16;2;12;6;0
19858; 59.2 ; 355.0 ; 9.3 ;6;38;22;0;6;1;5;3;3;0;0;6
19859; 48.0 ; 528.0 ; 16.5 ;11;23;68;0;11;0;11;9;2;0;7;4
19860; 28.1 ; 56.3 ; 3.1 ;2;144;141;0;2;0;2;1;1;1;1;0
19861; 52.9 ; 105.8 ; 7.5 ;2;7;104;2;0;0;2;2;0;0;1;1
19862; 23.6 ; 141.8 ; 10.5 ;6;1;33;0;6;5;1;3;3;4;2;0
19863; 22.2 ; 310.9 ; 5.8 ;14;14;0;0;14;3;11;6;8;14;0;0
19864; 35.0 ; 139.8 ; 12.0 ;4;71;33;0;4;2;2;3;1;1;3;0
19865; 30.2 ; 60.4 ; -   ;2;106;131;1;1;0;2;1;1;0;2;0
19866; 121.5 ; 729.2 ; 29.7 ;6;39;73;0;6;0;6;4;2;0;0;6
19867; 22.3 ; 111.4 ; 14.3 ;5;58;74;0;5;1;4;0;5;3;2;0
19868; 22.6 ; 45.2 ; 11.4 ;2;149;259;0;2;1;1;0;2;1;1;0
19869; 16.5 ; 33.0 ; 2.3 ;2;136;146;0;2;1;1;2;0;2;0;0
19870; 32.2 ; 160.9 ; 15.4 ;5;58;68;0;5;3;2;1;4;2;3;0
19871; 15.0 ; 30.0 ; -   ;2;87;83;2;0;2;0;2;0;2;0;0
19872; 62.7 ; 125.3 ; 1.5 ;2;113;162;0;2;0;2;2;0;0;0;2
19873; 51.9 ; 726.5 ; 21.8 ;14;16;0;0;14;0;14;14;0;0;9;5
19874; 24.8 ; 1,214.5 ; 12.6 ;49;7;14;0;49;31;18;26;23;33;16;0
19875; 41.4 ; 165.7 ; 16.1 ;4;48;0;0;4;0;4;4;0;1;2;1
19876; 72.6 ; 871.5 ; 21.8 ;12;23;15;0;12;0;12;12;0;0;0;12
19877; 36.7 ; 110.0 ; 5.8 ;3;18;57;0;3;2;1;2;1;0;3;0
19878; 22.6 ; 45.2 ; 11.4 ;2;5;303;0;2;2;0;1;1;1;1;0
19879; 43.4 ; 86.8 ; 14.7 ;2;107;99;0;2;0;2;2;0;1;0;1
19880; 32.0 ; 671.5 ; 15.2 ;21;16;5;0;21;0;21;12;9;7;14;0
19881; 83.4 ; 166.8 ; 52.7 ;2;201;15;2;0;0;2;2;0;0;0;2
19882; 37.5 ; 112.5 ; 19.4 ;3;57;143;0;3;3;0;1;2;1;1;1
19883; 16.4 ; 32.8 ; -   ;2;14;10;2;0;0;2;2;0;2;0;0
19884; 75.6 ; 151.2 ; 12.2 ;2;133;257;0;2;0;2;1;1;0;0;2
19885; 40.9 ; 204.6 ; 9.8 ;5;23;201;1;4;4;1;3;2;0;5;0
19886; 15.9 ; 63.5 ; 1.9 ;4;14;178;0;4;1;3;2;2;4;0;0
19887; 63.8 ; 318.8 ; 19.7 ;5;25;47;0;5;1;4;1;4;0;0;5
19888; 36.7 ; 183.4 ; 21.0 ;5;97;9;0;5;5;0;5;0;2;1;2
19889; 50.1 ; 100.2 ; 2.2 ;2;108;205;0;2;1;1;2;0;0;2;0
19890; 62.2 ; 124.3 ; 23.1 ;2;71;243;0;2;2;0;2;0;0;0;2
19891; 46.0 ; 138.1 ; 32.5 ;3;20;359;0;3;1;2;3;0;1;1;1
19892; 63.2 ; 252.6 ; 9.1 ;4;109;52;0;4;0;4;4;0;0;0;4
19893; 22.5 ; 112.6 ; 6.5 ;5;34;89;0;5;2;3;0;5;5;0;0
19894; 27.0 ; 81.0 ; 22.0 ;3;11;188;0;3;1;2;3;0;2;1;0
19895; 33.1 ; 165.5 ; 14.0 ;5;74;15;0;5;1;4;4;1;2;3;0
19896; 26.6 ; 53.2 ; 2.3 ;2;12;146;0;2;2;0;2;0;2;0;0
19897; 32.2 ; 96.5 ; 27.0 ;3;63;216;0;3;1;2;3;0;1;1;1
19898; 46.8 ; 93.5 ; -   ;2;1;196;0;2;2;0;1;1;0;2;0
19899; 39.4 ; 78.9 ; 13.9 ;2;50;53;2;0;0;2;1;1;1;1;0
19900; 20.3 ; 162.8 ; 11.8 ;8;23;40;0;8;1;7;1;7;5;3;0
19901; 75.5 ; 226.6 ; 13.0 ;3;15;31;0;3;1;2;2;1;0;0;3
19902; 18.7 ; 74.8 ; 1.3 ;4;35;67;4;0;4;0;4;0;4;0;0
19903; 76.1 ; 228.4 ; 27.5 ;3;11;21;0;3;2;1;0;3;0;0;3
19904; 24.0 ; 48.0 ; -   ;2;164;215;0;2;0;2;2;0;2;0;0
19905; 51.9 ; 311.6 ; 1.0 ;6;19;15;0;6;0;6;6;0;0;6;0
19906; 25.0 ; 349.4 ; 10.0 ;14;21;0;0;14;2;12;3;11;9;5;0
19907; 23.2 ; 92.8 ; 8.1 ;4;5;7;3;1;1;3;2;2;3;1;0
19908; 75.8 ; 227.3 ; 38.7 ;3;12;152;0;3;1;2;1;2;0;0;3
19909; 26.1 ; 104.3 ; 9.7 ;4;11;175;0;4;3;1;2;2;3;1;0
19910; 49.2 ; 147.5 ; 21.5 ;3;40;93;3;0;1;2;3;0;1;1;1
19911; 57.2 ; 286.1 ; 24.0 ;5;52;5;2;3;1;4;2;3;0;0;5
19912; 31.5 ; 94.4 ; 7.6 ;3;72;83;1;2;0;3;1;2;1;2;0
19913; 15.6 ; 77.8 ; 0.8 ;5;9;42;0;5;2;3;2;3;5;0;0
19914; 36.9 ; 73.8 ; 17.7 ;2;23;159;0;2;1;1;1;1;1;1;0
19915; 64.9 ; 2,662.2 ; 33.8 ;41;8;14;0;41;17;24;30;11;0;0;41
19916; 40.2 ; 200.8 ; 8.1 ;5;37;95;0;5;1;4;3;2;0;5;0
19917; 27.5 ; 55.0 ; 3.7 ;2;149;137;1;1;1;1;1;1;1;1;0
19918; 34.4 ; 344.3 ; 25.2 ;10;36;26;0;10;3;7;9;1;3;4;3
19919; 27.8 ; 111.0 ; 16.1 ;4;122;26;0;4;2;2;2;2;3;1;0
19920; 40.7 ; 163.0 ; 5.4 ;4;50;5;0;4;1;3;2;2;0;4;0
19921; 32.5 ; 64.9 ; 19.0 ;2;47;353;0;2;1;1;0;2;1;1;0
19922; 77.9 ; 233.6 ; 30.4 ;3;47;274;0;3;0;3;2;1;0;0;3
19923; 92.3 ; 184.6 ; 1.1 ;2;5;225;0;2;1;1;1;1;0;0;2
19924; 53.8 ; 107.6 ; 9.4 ;2;24;73;0;2;0;2;2;0;0;1;1
19925; 15.7 ; 63.0 ; 1.6 ;4;51;152;0;4;0;4;2;2;4;0;0
19926; 70.4 ; 140.8 ; 25.1 ;2;30;63;0;2;0;2;2;0;0;0;2
19927; 42.9 ; 128.8 ; 24.3 ;3;135;6;0;3;0;3;2;1;1;1;1
19928; 24.3 ; 218.3 ; 17.5 ;9;31;3;0;9;6;3;4;5;6;3;0
19929; 44.1 ; 572.9 ; 8.7 ;13;19;2;0;13;7;6;5;8;0;13;0
19930; 48.6 ; 145.7 ; 7.2 ;3;58;104;0;3;1;2;3;0;0;2;1
19931; 78.2 ; 312.6 ; 33.1 ;4;41;157;0;4;1;3;3;1;0;0;4
19932; 22.0 ; 131.8 ; 6.2 ;6;35;99;0;6;0;6;3;3;6;0;0
19933; 15.0 ; 45.0 ; -   ;3;149;18;0;3;2;1;3;0;3;0;0
19934; 41.4 ; 82.7 ; 16.7 ;2;28;137;0;2;1;1;1;1;1;0;1
19935; 36.7 ; 146.7 ; 26.1 ;4;18;216;0;4;0;4;2;2;1;2;1
19936; 47.0 ; 235.1 ; 20.3 ;5;28;157;2;3;0;5;4;1;2;1;2
19937; 53.0 ; 317.7 ; 13.4 ;6;54;57;0;6;0;6;6;0;0;4;2
19938; 70.3 ; 1,194.9 ; 10.9 ;17;21;44;0;17;2;15;6;11;0;0;17
19939; 23.4 ; 116.8 ; 5.4 ;5;13;224;0;5;2;3;2;3;5;0;0
19940; 49.9 ; 149.6 ; 5.7 ;3;29;167;0;3;1;2;3;0;0;2;1
19941; 42.7 ; 897.0 ; 13.7 ;21;14;0;0;21;4;17;6;15;7;7;7
19942; 24.7 ; 49.5 ; 8.1 ;2;113;160;0;2;2;0;1;1;1;1;0
19943; 31.5 ; 157.7 ; 5.0 ;5;63;10;0;5;2;3;2;3;2;3;0
19944; 18.2 ; 36.4 ; 0.5 ;2;24;271;0;2;2;0;0;2;2;0;0
19945; 96.8 ; 580.5 ; 69.1 ;6;16;136;0;6;0;6;5;1;2;0;4
19946; 70.1 ; 140.3 ; 35.0 ;2;8;314;0;2;1;1;2;0;0;0;2
19947; 39.8 ; 198.8 ; 22.6 ;5;61;63;0;5;0;5;5;0;2;1;2
19948; 16.4 ; 98.5 ; 4.0 ;6;36;41;0;6;0;6;3;3;6;0;0
19949; 41.1 ; 82.2 ; 14.8 ;2;14;104;0;2;1;1;1;1;1;0;1
19950; 31.5 ; 157.4 ; 12.5 ;5;45;87;0;5;2;3;1;4;2;3;0
19951; 38.3 ; 76.5 ; 12.1 ;2;26;88;2;0;1;1;0;2;1;1;0
19952; 54.3 ; 162.9 ; 63.1 ;3;4;257;0;3;1;2;3;0;1;1;1
19953; 49.5 ; 396.0 ; 15.2 ;8;39;22;0;8;1;7;6;2;0;5;3
19954; 38.8 ; 77.6 ; 20.5 ;2;89;93;0;2;1;1;2;0;1;0;1
19955; 35.2 ; 211.3 ; 9.8 ;6;8;130;3;3;3;3;0;6;2;4;0
19956; 47.8 ; 95.7 ; 2.6 ;2;80;212;0;2;1;1;0;2;0;2;0
19957; 32.3 ; 226.4 ; 8.2 ;7;53;0;0;7;5;2;0;7;2;5;0
19958; 29.6 ; 59.2 ; 0.9 ;2;53;116;0;2;1;1;0;2;1;1;0
19959; 38.8 ; 271.3 ; 13.1 ;7;14;5;0;7;1;6;4;3;2;5;0
19960; 18.7 ; 112.1 ; 0.3 ;6;32;4;1;5;1;5;4;2;6;0;0
19961; 29.2 ; 116.8 ; 19.0 ;4;67;89;0;4;3;1;3;1;3;1;0
19962; 59.5 ; 118.9 ; 0.8 ;2;11;5;0;2;0;2;2;0;0;0;2
19963; 69.2 ; 138.3 ; 33.5 ;2;4;206;0;2;1;1;0;2;0;0;2
19964; 31.6 ; 569.5 ; 9.5 ;18;14;71;0;18;7;11;7;11;6;12;0
19965; 24.1 ; 48.3 ; -   ;2;33;125;0;2;0;2;2;0;2;0;0
19966; 27.2 ; 81.5 ; 2.5 ;3;152;110;0;3;0;3;1;2;3;0;0
19967; 24.3 ; 266.8 ; 4.1 ;11;22;18;0;11;1;10;9;2;11;0;0
19968; 49.6 ; 99.3 ; 4.3 ;2;157;141;0;2;0;2;2;0;0;2;0
19969; 27.5 ; 137.4 ; 8.7 ;5;59;67;0;5;2;3;1;4;3;2;0
19970; 52.6 ; 894.7 ; 18.0 ;17;21;5;0;17;3;14;11;6;0;11;6
19971; 57.1 ; 171.2 ; 15.3 ;3;47;41;0;3;0;3;0;3;0;0;3
19972; 21.1 ; 63.2 ; 8.5 ;3;12;152;0;3;0;3;3;0;3;0;0
19973; 38.7 ; 77.4 ; 3.2 ;2;23;64;2;0;0;2;1;1;0;2;0
19974; 30.2 ; 60.4 ; -   ;2;31;325;0;2;0;2;2;0;0;2;0
19975; 27.1 ; 54.1 ; 18.1 ;2;87;206;0;2;2;0;1;1;1;1;0
19976; 38.2 ; 343.6 ; 27.1 ;9;32;123;0;9;9;0;7;2;3;3;3
19977; 23.1 ; 161.5 ; 7.9 ;7;24;89;0;7;0;7;7;0;5;2;0
19978; 15.0 ; 30.0 ; -   ;2;9;288;0;2;1;1;2;0;2;0;0
19979; 44.1 ; 220.5 ; 16.2 ;5;48;157;0;5;0;5;0;5;2;1;2
19980; 84.3 ; 337.3 ; 34.0 ;4;77;22;0;4;1;3;4;0;0;0;4
19981; 45.5 ; 136.5 ; 4.2 ;3;9;196;3;0;1;2;3;0;0;3;0
19982; 62.7 ; 125.5 ; 15.6 ;2;27;257;0;2;0;2;1;1;0;0;2
19983; 43.7 ; 218.5 ; 16.0 ;5;80;38;1;4;2;3;5;0;2;1;2
19984; 55.2 ; 220.9 ; 32.3 ;4;60;2;0;4;1;3;3;1;1;0;3
19985; 33.3 ; 100.0 ; 8.4 ;3;104;41;0;3;0;3;2;1;1;2;0
19986; 27.8 ; 55.5 ; 4.1 ;2;13;266;0;2;2;0;1;1;1;1;0
19987; 19.3 ; 77.1 ; 7.6 ;4;50;56;4;0;1;3;3;1;4;0;0
19988; 52.4 ; 262.1 ; 10.7 ;5;11;52;0;5;0;5;2;3;0;3;2
19989; 36.6 ; 73.2 ; -   ;2;25;5;0;2;0;2;0;2;0;2;0
19990; 48.0 ; 240.0 ; 0.6 ;5;78;0;0;5;1;4;2;3;0;5;0
19991; 15.0 ; 45.0 ; -   ;3;50;330;0;3;2;1;2;1;3;0;0
19992; 78.2 ; 703.6 ; 32.4 ;9;40;3;0;9;4;5;2;7;0;0;9
19993; 36.5 ; 511.2 ; 12.3 ;14;17;7;0;14;9;5;5;9;5;9;0
19994; 61.2 ; 122.5 ; 54.2 ;2;5;2;0;2;2;0;0;2;1;0;1
19995; 51.0 ; 102.0 ; -   ;2;167;138;0;2;1;1;1;1;0;2;0
19996; 24.1 ; 144.7 ; 6.7 ;6;8;105;0;6;0;6;0;6;4;2;0
19997; 37.3 ; 111.9 ; 13.1 ;3;9;265;0;3;3;0;1;2;1;2;0
19998; 17.4 ; 87.0 ; 1.4 ;5;10;34;5;0;2;3;1;4;5;0;0
19999; 48.2 ; 96.4 ; -   ;2;5;2;2;0;1;1;2;0;0;2;0
20000; 52.5 ; 105.0 ; -   ;2;77;220;0;2;1;1;1;1;0;2;0
20001; 21.8 ; 109.1 ; -   ;5;75;20;0;5;2;3;1;4;5;0;0
20002; 23.3 ; 46.6 ; 11.8 ;2;32;131;0;2;0;2;2;0;1;1;0
20003; 32.4 ; 421.2 ; 16.2 ;13;6;328;0;13;5;8;7;6;4;9;0
20004; 61.8 ; 123.7 ; 22.6 ;2;19;125;0;2;0;2;2;0;0;0;2
20005; 60.2 ; 180.7 ; 13.4 ;3;89;14;0;3;2;1;0;3;0;0;3
20006; 53.8 ; 107.7 ; 22.4 ;2;114;166;0;2;1;1;1;1;0;1;1
20007; 36.6 ; 292.7 ; -   ;8;15;41;0;8;4;4;2;6;0;8;0
20008; 37.7 ; 75.4 ; 22.2 ;2;112;80;0;2;0;2;1;1;1;0;1
20009; 22.6 ; 45.2 ; 11.4 ;2;70;39;2;0;2;0;2;0;1;1;0
20010; 21.7 ; 108.3 ; 8.0 ;5;16;12;0;5;2;3;1;4;5;0;0
20011; 37.6 ; 488.2 ; 33.0 ;13;30;67;0;13;2;11;6;7;4;5;4
20012; 27.6 ; 55.3 ; 3.8 ;2;20;214;0;2;1;1;1;1;1;1;0
20013; 57.6 ; 115.3 ; 2.9 ;2;16;241;0;2;1;1;1;1;0;0;2
20014; 15.6 ; 109.4 ; 1.7 ;7;22;191;0;7;7;0;7;0;7;0;0
20015; 33.3 ; 300.0 ; 7.1 ;9;28;63;5;4;4;5;2;7;3;6;0
20016; 80.8 ; 242.4 ; 45.2 ;3;11;49;3;0;3;0;0;3;0;0;3
20017; 26.3 ; 105.2 ; 13.3 ;4;11;2;0;4;2;2;4;0;3;1;0
20018; 22.5 ; 44.9 ; 11.2 ;2;157;163;0;2;0;2;1;1;1;1;0
20019; 34.3 ; 171.5 ; 11.1 ;5;55;70;0;5;0;5;2;3;2;3;0
20020; 73.1 ; 146.2 ; 16.3 ;2;3;265;0;2;1;1;0;2;0;0;2
20021; 15.0 ; 30.0 ; -   ;2;1;57;0;2;0;2;0;2;2;0;0
20022; 40.4 ; 161.5 ; 9.7 ;4;15;238;0;4;3;1;2;2;0;4;0
20023; 57.5 ; 172.5 ; 9.2 ;3;22;262;0;3;0;3;3;0;0;0;3
20024; 124.4 ; 248.9 ; 0.8 ;2;81;78;1;1;0;2;2;0;0;0;2
20025; 23.6 ; 118.0 ; 14.9 ;5;93;11;0;5;1;4;2;3;3;2;0
20026; 88.3 ; 441.3 ; 41.4 ;5;19;16;0;5;0;5;3;2;0;0;5
20027; 33.6 ; 403.7 ; 11.8 ;12;26;29;0;12;10;2;2;10;4;8;0
20028; 36.2 ; 867.6 ; 8.8 ;24;13;0;0;24;9;15;7;17;8;16;0
20029; 45.7 ; 91.3 ; 2.7 ;2;56;12;2;0;2;0;0;2;0;2;0
20030; 24.8 ; 74.4 ; 0.5 ;3;22;206;0;3;2;1;1;2;3;0;0
20031; 81.9 ; 245.8 ; 14.2 ;3;54;16;0;3;0;3;3;0;0;0;3
20032; 52.2 ; 260.9 ; 30.2 ;5;9;7;0;5;3;2;3;2;2;1;2
20033; 20.8 ; 83.1 ; 5.6 ;4;23;99;0;4;1;3;3;1;4;0;0
20034; 15.0 ; 30.0 ; -   ;2;104;35;0;2;1;1;0;2;2;0;0
20035; 32.3 ; 64.7 ; 18.4 ;2;131;133;0;2;1;1;1;1;1;1;0
20036; 41.7 ; 83.4 ; 7.6 ;2;12;104;0;2;0;2;2;0;0;2;0
20037; 61.6 ; 246.4 ; 16.7 ;4;18;38;4;0;2;2;1;3;0;0;4
20038; 20.1 ; 120.5 ; 4.2 ;6;50;0;0;6;0;6;2;4;6;0;0
20039; 15.0 ; 74.9 ; -   ;5;50;5;0;5;1;4;3;2;5;0;0
20040; 33.0 ; 99.0 ; 2.6 ;3;171;83;1;2;1;2;2;1;0;3;0
20041; 52.4 ; 104.8 ; 5.6 ;2;6;252;0;2;0;2;2;0;0;1;1
20042; 19.4 ; 97.1 ; 6.5 ;5;26;5;0;5;4;1;3;2;5;0;0
20043; 28.5 ; 114.0 ; 13.6 ;4;21;99;4;0;0;4;4;0;3;1;0
20044; 15.0 ; 59.9 ; -   ;4;21;251;0;4;1;3;3;1;4;0;0
20045; 22.4 ; 44.8 ; 11.1 ;2;82;204;0;2;0;2;2;0;1;1;0
20046; 25.7 ; 231.3 ; 12.4 ;9;36;8;0;9;8;1;5;4;6;3;0
20047; 15.0 ; 30.0 ; -   ;2;37;325;0;2;0;2;1;1;2;0;0
20048; 94.9 ; 189.9 ; -   ;2;19;71;2;0;2;0;2;0;0;0;2
20049; 50.4 ; 100.7 ; 11.2 ;2;53;285;0;2;1;1;1;1;0;1;1
20050; 35.8 ; 143.1 ; 8.6 ;4;53;164;0;4;2;2;2;2;1;3;0
20051; 37.9 ; 189.4 ; 8.3 ;5;39;160;0;5;3;2;3;2;2;3;0
20052; 47.5 ; 94.9 ; 1.1 ;2;148;17;0;2;1;1;0;2;0;2;0
20053; 18.4 ; 36.8 ; 5.1 ;2;103;53;0;2;1;1;0;2;2;0;0
20054; 15.9 ; 47.8 ; 1.7 ;3;43;194;0;3;0;3;0;3;3;0;0
20055; 26.1 ; 234.6 ; 8.8 ;9;45;74;0;9;0;9;8;1;6;3;0
20056; 59.8 ; 239.2 ; 24.8 ;4;74;5;4;0;0;4;4;0;0;0;4
20057; 21.0 ; 63.1 ; 5.5 ;3;59;71;0;3;2;1;3;0;3;0;0
20058; 16.3 ; 81.7 ; 2.8 ;5;41;90;0;5;0;5;3;2;5;0;0
20059; 27.9 ; 55.8 ; 13.9 ;2;25;288;0;2;0;2;0;2;1;1;0
20060; 42.2 ; 126.7 ; 17.9 ;3;68;155;0;3;2;1;1;2;1;1;1
20061; 32.1 ; 160.4 ; 27.5 ;5;25;220;0;5;2;3;1;4;2;1;2
20062; 85.6 ; 1,625.8 ; 30.4 ;19;13;68;0;19;5;14;6;13;0;0;19
20063; 46.8 ; 93.5 ; -   ;2;63;120;0;2;0;2;2;0;0;2;0
20064; 52.4 ; 104.7 ; 26.9 ;2;7;212;0;2;2;0;1;1;1;0;1
20065; 39.5 ; 118.6 ; 13.3 ;3;124;61;0;3;1;2;3;0;1;2;0
20066; 55.9 ; 279.5 ; 6.9 ;5;59;10;0;5;0;5;5;0;0;0;5
20067; 84.3 ; 252.8 ; 6.6 ;3;41;177;0;3;2;1;3;0;0;0;3
20068; 67.0 ; 267.8 ; 34.9 ;4;13;164;0;4;1;3;2;2;0;0;4
20069; 52.3 ; 157.0 ; 29.2 ;3;24;296;0;3;1;2;1;2;1;1;1
20070; 37.8 ; 189.0 ; 40.5 ;5;42;47;0;5;2;3;3;2;2;1;2
20071; 17.6 ; 123.3 ; 1.5 ;7;23;106;0;7;0;7;1;6;7;0;0
20072; 24.9 ; 49.8 ; 9.4 ;2;17;223;0;2;1;1;1;1;1;1;0
20073; 46.3 ; 92.6 ; 9.3 ;2;401;65;0;2;1;1;0;2;0;1;1
20074; 77.1 ; 231.2 ; 30.8 ;3;36;152;1;2;1;2;3;0;0;0;3
20075; 61.8 ; 1,422.5 ; 15.0 ;23;16;5;0;23;1;22;23;0;0;0;23
20076; 73.5 ; 146.9 ; 0.4 ;2;68;200;0;2;0;2;0;2;0;0;2
20077; 41.3 ; 247.6 ; 20.8 ;6;25;124;0;6;2;4;1;5;2;2;2
20078; 22.6 ; 45.2 ; 11.4 ;2;36;284;0;2;0;2;1;1;1;1;0
20079; 36.7 ; 146.9 ; 8.1 ;4;126;74;0;4;3;1;1;3;1;3;0
20080; 37.6 ; 75.1 ; 11.1 ;2;86;26;1;1;0;2;2;0;1;1;0
20081; 47.8 ; 286.7 ; 0.4 ;6;14;14;0;6;1;5;6;0;0;6;0
20082; 47.0 ; 141.0 ; 0.4 ;3;72;80;0;3;2;1;1;2;0;3;0
20083; 32.0 ; 96.0 ; 15.4 ;3;142;61;0;3;1;2;3;0;1;2;0
20084; 53.9 ; 377.1 ; 22.2 ;7;32;74;0;7;2;5;4;3;0;5;2
20085; 40.2 ; 160.9 ; 22.6 ;4;13;99;4;0;0;4;4;0;1;2;1
20086; 43.7 ; 87.3 ; 15.4 ;2;106;200;0;2;0;2;0;2;1;0;1
20087; 37.0 ; 73.9 ; 0.5 ;2;6;294;0;2;0;2;0;2;0;2;0
20088; 23.0 ; 529.6 ; 14.7 ;23;16;1;0;23;13;10;20;3;15;8;0
20089; 46.8 ; 140.3 ; -   ;3;53;167;0;3;0;3;3;0;0;3;0
20090; 26.6 ; 79.7 ; 9.7 ;3;102;49;0;3;2;1;3;0;2;1;0
20091; 49.6 ; 198.5 ; 3.5 ;4;14;115;0;4;0;4;4;0;0;4;0
20092; 26.5 ; 53.0 ; 2.1 ;2;62;194;0;2;0;2;1;1;2;0;0
20093; 15.0 ; 30.0 ; -   ;2;209;92;0;2;2;0;2;0;2;0;0
20094; 61.6 ; 246.4 ; 10.3 ;4;37;33;0;4;2;2;4;0;0;0;4
20095; 52.9 ; 211.5 ; 13.0 ;4;20;160;0;4;2;2;1;3;0;3;1
20096; 33.9 ; 67.9 ; 19.2 ;2;58;239;0;2;2;0;1;1;1;1;0
20097; 36.8 ; 110.4 ; 31.4 ;3;122;59;0;3;1;2;1;2;1;1;1
20098; 37.2 ; 297.3 ; 14.8 ;8;25;61;0;8;7;1;5;3;3;5;0
20099; 80.7 ; 242.2 ; 62.3 ;3;50;161;0;3;2;1;3;0;1;0;2
20100; 67.6 ; 338.2 ; 22.0 ;5;63;9;0;5;5;0;0;5;0;0;5
20101; 77.5 ; 232.6 ; 32.9 ;3;67;152;0;3;0;3;2;1;0;0;3
20102; 27.2 ; 217.9 ; 16.3 ;8;23;30;2;6;7;1;3;5;5;3;0
20103; 39.7 ; 79.5 ; 4.7 ;2;19;136;0;2;0;2;1;1;0;2;0
20104; 17.3 ; 86.3 ; 4.3 ;5;40;5;0;5;0;5;4;1;5;0;0
20105; 45.3 ; 181.2 ; 14.6 ;4;111;6;0;4;0;4;2;2;0;3;1
20106; 51.8 ; 207.0 ; 22.0 ;4;16;114;0;4;4;0;2;2;1;2;1
20107; 46.4 ; 648.9 ; 27.5 ;14;16;8;0;14;4;10;14;0;5;4;5
20108; 47.1 ; 94.2 ; 0.5 ;2;335;72;1;1;1;1;2;0;0;2;0
20109; 45.9 ; 229.5 ; 3.1 ;5;32;100;0;5;1;4;4;1;0;5;0
20110; 38.7 ; 116.0 ; 15.6 ;3;41;21;0;3;1;2;3;0;1;2;0
20111; 23.3 ; 232.9 ; 9.8 ;10;15;3;0;10;6;4;2;8;7;3;0
20112; 46.9 ; 187.7 ; 0.4 ;4;54;99;1;3;1;3;4;0;0;4;0
20113; 36.5 ; 73.0 ; 9.5 ;2;163;34;0;2;2;0;1;1;1;1;0
20114; 22.6 ; 45.2 ; 11.4 ;2;62;99;0;2;0;2;0;2;1;1;0
20115; 15.0 ; 30.0 ; -   ;2;19;202;0;2;2;0;2;0;2;0;0
20116; 31.7 ; 126.9 ; 18.2 ;4;7;132;0;4;3;1;2;2;1;3;0
20117; 22.7 ; 90.8 ; 16.3 ;4;46;71;0;4;2;2;2;2;3;1;0
20118; 48.2 ; 96.3 ; 2.1 ;2;107;160;0;2;2;0;2;0;0;2;0
20119; 48.6 ; 97.1 ; 17.0 ;2;47;232;0;2;1;1;0;2;0;1;1
20120; 25.1 ; 75.2 ; -   ;3;25;120;0;3;0;3;1;2;3;0;0
20121; 15.0 ; 30.0 ; -   ;2;166;33;0;2;2;0;0;2;2;0;0
20122; 74.7 ; 149.3 ; 41.8 ;2;69;62;0;2;0;2;2;0;0;0;2
20123; 21.8 ; 65.4 ; 12.5 ;3;191;20;0;3;1;2;1;2;2;1;0
20124; 63.6 ; 127.3 ; 4.4 ;2;18;288;0;2;0;2;0;2;0;0;2
20125; 46.9 ; 328.6 ; 14.1 ;7;46;74;0;7;0;7;3;4;0;5;2
20126; 26.2 ; 78.7 ; 1.3 ;3;67;161;0;3;3;0;0;3;3;0;0
20127; 29.6 ; 1,182.2 ; 7.9 ;40;10;5;0;40;20;20;11;29;27;13;0
20128; 26.5 ; 79.6 ; 10.8 ;3;70;22;0;3;2;1;1;2;2;1;0
20129; 37.8 ; 189.0 ; 9.2 ;5;24;57;4;1;2;3;4;1;2;3;0
20130; 49.0 ; 392.1 ; 6.9 ;8;23;3;2;6;2;6;4;4;0;5;3
20131; 37.0 ; 148.0 ; 13.7 ;4;31;3;0;4;2;2;4;0;1;3;0
20132; 30.3 ; 121.3 ; 12.6 ;4;36;6;4;0;2;2;3;1;1;3;0
20133; 56.6 ; 226.2 ; 22.8 ;4;74;1;3;1;1;3;3;1;0;0;4
20134; 22.9 ; 298.1 ; 6.9 ;13;25;5;0;13;4;9;4;9;13;0;0
20135; 27.9 ; 55.8 ; 11.9 ;2;5;1;0;2;0;2;1;1;1;1;0
20136; 111.0 ; 222.0 ; 26.2 ;2;50;226;0;2;0;2;0;2;0;0;2
20137; 33.6 ; 235.1 ; 15.8 ;7;17;98;0;7;3;4;4;3;2;5;0
20138; 41.4 ; 82.7 ; 16.7 ;2;4;160;0;2;1;1;1;1;1;0;1
20139; 40.9 ; 122.8 ; 24.1 ;3;49;257;0;3;2;1;1;2;1;1;1
20140; 26.3 ; 316.0 ; 11.6 ;12;24;23;1;11;10;2;8;4;8;4;0
20141; 41.7 ; 83.4 ; 7.6 ;2;53;276;0;2;1;1;1;1;0;2;0
20142; 50.3 ; 251.6 ; 7.2 ;5;17;47;0;5;0;5;2;3;0;3;2
20143; 25.6 ; 51.2 ; 0.8 ;2;5;262;0;2;0;2;1;1;2;0;0
20144; 62.4 ; 312.2 ; 24.2 ;5;50;5;0;5;3;2;2;3;0;0;5
20145; 34.1 ; 307.0 ; 27.5 ;9;31;4;0;9;7;2;6;3;3;3;3
20146; 17.4 ; 226.1 ; 9.5 ;13;26;2;0;13;7;6;2;11;13;0;0
20147; 57.1 ; 342.7 ; 33.9 ;6;58;32;1;5;1;5;0;6;2;0;4
20148; 22.4 ; 111.9 ; 15.0 ;5;71;43;0;5;3;2;4;1;3;2;0
20149; 51.4 ; 102.9 ; 7.0 ;2;127;256;0;2;1;1;0;2;0;1;1
20150; 51.5 ; 669.7 ; 41.6 ;13;25;1;0;13;5;8;8;5;4;5;4
20151; 67.1 ; 134.2 ; 10.5 ;2;188;10;0;2;0;2;2;0;0;0;2
20152; 37.3 ; 335.4 ; 9.8 ;9;14;283;0;9;0;9;9;0;3;6;0
20153; 28.1 ; 56.3 ; 3.1 ;2;57;188;0;2;0;2;1;1;1;1;0
20154; 57.0 ; 798.0 ; 13.2 ;14;22;9;0;14;8;6;12;2;0;0;14
20155; 56.5 ; 678.2 ; 15.9 ;12;18;62;0;12;3;9;6;6;0;0;12
20156; 46.9 ; 187.6 ; 21.8 ;4;34;20;0;4;1;3;1;3;1;2;1
20157; 15.0 ; 30.0 ; -   ;2;3;265;0;2;1;1;0;2;2;0;0
20158; 48.5 ; 291.1 ; 13.1 ;6;18;262;0;6;0;6;2;4;0;4;2
20159; 16.3 ; 146.5 ; 3.4 ;9;36;5;0;9;2;7;6;3;9;0;0
20160; 111.8 ; 894.3 ; 40.6 ;8;32;21;0;8;0;8;7;1;0;0;8
20161; 15.0 ; 30.0 ; -   ;2;81;241;0;2;0;2;1;1;2;0;0
20162; 22.6 ; 45.2 ; 11.4 ;2;1;291;0;2;2;0;0;2;1;1;0
20163; 41.2 ; 123.7 ; 10.1 ;3;6;294;0;3;0;3;1;2;0;3;0
20164; 32.3 ; 290.9 ; 10.4 ;9;36;2;0;9;5;4;7;2;3;6;0
20165; 47.7 ; 95.5 ; 1.5 ;2;50;225;0;2;0;2;2;0;0;2;0
20166; 60.2 ; 1,023.6 ; 26.8 ;17;25;13;0;17;2;15;16;1;0;0;17
20167; 15.0 ; 45.0 ; -   ;3;31;158;3;0;0;3;1;2;3;0;0
20168; 60.2 ; 241.0 ; 20.3 ;4;41;94;0;4;0;4;2;2;0;0;4
20169; 35.4 ; 70.9 ; 25.2 ;2;177;46;0;2;1;1;0;2;1;0;1
20170; 47.1 ; 94.2 ; 0.5 ;2;308;63;0;2;0;2;2;0;0;2;0
20171; 73.9 ; 147.9 ; 40.7 ;2;19;257;0;2;0;2;1;1;0;0;2
20172; 32.3 ; 355.4 ; 13.8 ;11;22;201;0;11;5;6;3;8;4;7;0
20173; 33.7 ; 168.7 ; 13.1 ;5;43;212;0;5;2;3;2;3;2;3;0
20174; 55.6 ; 278.0 ; 13.7 ;5;77;1;0;5;1;4;3;2;0;0;5
20175; 36.3 ; 581.0 ; 9.9 ;16;12;0;0;16;12;4;12;4;5;11;0
20176; 60.0 ; 179.9 ; 56.9 ;3;50;85;0;3;1;2;2;1;1;0;2
20177; 28.5 ; 85.4 ; 3.1 ;3;80;123;0;3;1;2;1;2;2;1;0
20178; 22.1 ; 1,058.8 ; 9.8 ;48;7;6;0;48;23;25;21;27;32;16;0
20179; 42.9 ; 85.8 ; 11.0 ;2;240;188;0;2;0;2;1;1;0;2;0
20180; 43.8 ; 87.7 ; 4.4 ;2;171;120;0;2;0;2;0;2;0;2;0
20181; 25.6 ; 51.2 ; 0.8 ;2;4;112;0;2;1;1;2;0;2;0;0
20182; 22.3 ; 44.5 ; 10.9 ;2;89;196;0;2;2;0;0;2;1;1;0
20183; 172.2 ; 344.5 ; 36.2 ;2;63;43;2;0;0;2;2;0;0;0;2
20184; 46.8 ; 187.0 ; -   ;4;17;263;0;4;2;2;2;2;0;4;0
20185; 78.6 ; 314.5 ; 8.3 ;4;19;167;4;0;4;0;1;3;0;0;4
20186; 74.2 ; 297.0 ; 19.3 ;4;99;32;0;4;0;4;1;3;0;0;4
20187; 47.7 ; 238.6 ; 0.4 ;5;13;5;0;5;2;3;2;3;0;5;0
20188; 53.0 ; 159.0 ; 0.4 ;3;85;73;0;3;0;3;3;0;0;3;0
20189; 36.3 ; 145.2 ; 20.0 ;4;26;242;0;4;2;2;3;1;1;2;1
20190; 30.7 ; 276.2 ; 13.2 ;9;23;5;5;4;5;4;8;1;3;6;0
20191; 81.2 ; 406.2 ; 56.3 ;5;14;81;5;0;5;0;0;5;2;0;3
20192; 15.0 ; 119.9 ; -   ;8;9;16;0;8;5;3;2;6;8;0;0
20193; 34.6 ; 69.2 ; 3.4 ;2;1;236;0;2;0;2;0;2;0;2;0
20194; 15.0 ; 30.0 ; -   ;2;50;8;0;2;2;0;1;1;2;0;0
20195; 66.0 ; 131.9 ; 49.9 ;2;30;194;0;2;1;1;1;1;1;0;1
20196; 15.0 ; 30.0 ; -   ;2;3;371;0;2;2;0;0;2;2;0;0
20197; 35.7 ; 178.5 ; 10.2 ;5;39;31;0;5;2;3;1;4;2;3;0
20198; 32.6 ; 358.1 ; 17.1 ;11;41;21;0;11;4;7;11;0;4;7;0
20199; 21.8 ; 43.7 ; 4.9 ;2;2;2;2;0;2;0;2;0;2;0;0
20200; 16.9 ; 220.1 ; 4.0 ;13;11;6;0;13;7;6;11;2;13;0;0
20201; 39.3 ; 196.3 ; 25.3 ;5;9;262;0;5;2;3;5;0;2;1;2
20202; 15.2 ; 288.6 ; 1.0 ;19;11;4;0;19;10;9;13;6;19;0;0
20203; 35.5 ; 71.0 ; 15.6 ;2;17;236;0;2;0;2;2;0;1;1;0
20204; 21.5 ; 43.1 ; 5.3 ;2;95;88;0;2;1;1;1;1;2;0;0
20205; 20.4 ; 244.9 ; 6.3 ;12;7;5;0;12;3;9;11;1;12;0;0
20206; 35.9 ; 143.4 ; 4.4 ;4;104;4;0;4;3;1;4;0;0;4;0
20207; 78.4 ; 392.1 ; 35.2 ;5;61;4;0;5;1;4;5;0;0;0;5
20208; 70.8 ; 141.6 ; 22.0 ;2;5;370;0;2;2;0;1;1;0;0;2
20209; 56.4 ; 676.3 ; 44.5 ;12;24;16;0;12;7;5;8;4;4;0;8
20210; 58.2 ; 291.0 ; 24.7 ;5;32;68;0;5;0;5;5;0;0;0;5
20211; 31.6 ; 63.2 ; 24.9 ;2;23;3;0;2;2;0;2;0;1;0;1
20212; 25.0 ; 75.1 ; 9.2 ;3;131;17;2;1;0;3;3;0;2;1;0
20213; 37.7 ; 151.0 ; 21.3 ;4;68;120;0;4;2;2;4;0;1;2;1
20214; 32.4 ; 194.6 ; 12.2 ;6;50;14;0;6;1;5;2;4;2;4;0
20215; 75.3 ; 1,279.4 ; 27.8 ;17;17;26;0;17;2;15;10;7;0;0;17
20216; 36.6 ; 73.2 ; -   ;2;100;5;0;2;0;2;1;1;0;2;0
20217; 34.8 ; 174.2 ; 19.1 ;5;7;5;0;5;1;4;2;3;2;3;0
20218; 46.9 ; 187.7 ; 0.4 ;4;78;57;0;4;1;3;4;0;0;4;0
20219; 19.3 ; 174.1 ; 2.0 ;9;22;0;0;9;5;4;4;5;9;0;0
20220; 47.4 ; 94.8 ; 25.8 ;2;12;89;0;2;0;2;2;0;1;0;1
20221; 32.3 ; 549.0 ; 22.6 ;17;23;10;0;17;8;9;6;11;6;11;0
20222; 38.0 ; 75.9 ; 2.1 ;2;86;183;0;2;1;1;0;2;0;2;0
20223; 73.0 ; 146.0 ; 39.3 ;2;69;291;0;2;2;0;1;1;0;0;2
20224; 46.0 ; 91.9 ; -   ;2;171;132;0;2;1;1;0;2;0;2;0
20225; 51.8 ; 155.4 ; 19.3 ;3;54;14;3;0;1;2;3;0;0;2;1
20226; 25.1 ; 50.1 ; -   ;2;26;177;0;2;1;1;1;1;2;0;0
20227; 78.3 ; 156.6 ; 6.6 ;2;14;101;0;2;2;0;0;2;0;0;2
20228; 71.2 ; 569.8 ; 19.3 ;8;23;57;0;8;0;8;7;1;0;0;8
20229; 51.7 ; 103.4 ; 32.2 ;2;212;176;1;1;1;1;1;1;1;0;1
20230; 38.3 ; 191.4 ; 14.1 ;5;26;113;4;1;3;2;3;2;2;3;0
20231; 19.0 ; 265.7 ; 9.4 ;14;14;149;0;14;10;4;11;3;14;0;0
20232; 40.5 ; 243.0 ; 16.0 ;6;48;20;0;6;6;0;2;4;2;2;2
20233; 16.2 ; 48.6 ; 2.2 ;3;40;264;0;3;2;1;1;2;3;0;0
20234; 42.1 ; 84.1 ; 17.8 ;2;39;5;0;2;0;2;1;1;1;0;1
20235; 47.1 ; 94.2 ; 0.5 ;2;26;99;0;2;0;2;2;0;0;2;0
20236; 80.7 ; 322.9 ; 51.8 ;4;53;261;0;4;2;2;3;1;1;0;3
20237; 44.3 ; 620.8 ; 9.9 ;14;23;33;0;14;8;6;6;8;0;14;0
20238; 41.7 ; 83.4 ; 7.6 ;2;5;153;0;2;0;2;1;1;0;2;0
20239; 70.0 ; 140.0 ; 7.0 ;2;62;179;0;2;0;2;2;0;0;0;2
20240; 41.5 ; 415.5 ; 58.0 ;10;33;0;0;10;4;6;5;5;3;4;3
20241; 50.0 ; 150.0 ; 25.2 ;3;85;138;0;3;1;2;1;2;1;1;1
20242; 31.7 ; 95.0 ; 13.8 ;3;100;104;0;3;1;2;1;2;1;2;0
20243; 36.9 ; 73.8 ; 17.7 ;2;12;263;0;2;0;2;2;0;1;1;0
20244; 15.9 ; 63.5 ; 1.9 ;4;23;321;0;4;1;3;2;2;4;0;0
20245; 17.3 ; 483.4 ; 6.5 ;28;9;0;0;28;20;8;13;15;28;0;0
20246; 64.9 ; 324.5 ; 28.7 ;5;34;230;0;5;2;3;3;2;0;0;5
20247; 60.2 ; 361.3 ; 24.7 ;6;65;20;0;6;0;6;4;2;0;0;6
20248; 29.8 ; 149.0 ; 13.0 ;5;54;82;0;5;4;1;5;0;3;2;0
20249; 46.4 ; 139.2 ; 4.3 ;3;140;32;0;3;1;2;0;3;0;3;0
20250; 34.5 ; 310.2 ; 13.2 ;9;24;1;0;9;7;2;3;6;3;6;0
20251; 57.7 ; 173.0 ; 17.7 ;3;108;58;2;1;1;2;2;1;0;0;3
20252; 96.4 ; 1,060.5 ; 58.9 ;11;30;74;0;11;3;8;4;7;0;0;11
20253; 46.2 ; 138.6 ; 8.8 ;3;85;22;2;1;0;3;3;0;0;2;1
20254; 19.4 ; 97.1 ; 7.2 ;5;21;65;5;0;4;1;1;4;5;0;0
20255; 62.1 ; 124.2 ; 18.8 ;2;12;181;1;1;2;0;0;2;0;0;2
20256; 37.5 ; 187.3 ; 15.5 ;5;34;152;0;5;2;3;0;5;2;3;0
20257; 22.1 ; 44.2 ; 5.3 ;2;45;4;0;2;1;1;0;2;2;0;0
20258; 37.2 ; 74.3 ; 23.0 ;2;40;269;0;2;1;1;1;1;1;0;1
20259; 47.5 ; 190.2 ; 0.9 ;4;78;10;0;4;1;3;4;0;0;4;0
20260; 19.6 ; 137.4 ; 7.7 ;7;55;7;0;7;6;1;7;0;7;0;0
20261; 46.9 ; 234.5 ; 2.9 ;5;64;12;0;5;1;4;5;0;0;5;0
20262; 80.6 ; 403.0 ; 34.6 ;5;75;19;0;5;4;1;2;3;0;0;5
20263; 55.8 ; 223.2 ; 22.9 ;4;39;5;0;4;3;1;1;3;0;0;4
20264; 46.9 ; 234.5 ; 0.3 ;5;64;41;0;5;3;2;4;1;0;5;0
20265; 32.4 ; 129.7 ; 16.1 ;4;82;9;0;4;1;3;1;3;1;3;0
20266; 23.1 ; 46.2 ; 12.1 ;2;3;91;0;2;2;0;0;2;1;1;0
20267; 21.1 ; 169.0 ; 3.6 ;8;5;16;0;8;4;4;1;7;8;0;0
20268; 57.8 ; 173.5 ; 17.5 ;3;47;283;0;3;1;2;3;0;0;0;3
20269; 22.5 ; 67.4 ; 1.1 ;3;4;57;3;0;0;3;1;2;3;0;0
20270; 61.0 ; 366.1 ; 18.6 ;6;54;0;0;6;0;6;1;5;0;0;6
20271; 30.4 ; 455.6 ; 13.0 ;15;14;2;0;15;9;6;5;10;5;10;0
20272; 46.8 ; 93.5 ; -   ;2;11;128;0;2;1;1;0;2;0;2;0
20273; 52.9 ; 158.8 ; 6.5 ;3;31;48;0;3;0;3;2;1;0;2;1
20274; 44.6 ; 89.1 ; 11.9 ;2;16;272;0;2;2;0;2;0;0;1;1
20275; 36.6 ; 109.8 ; -   ;3;9;99;0;3;0;3;3;0;0;3;0
20276; 34.4 ; 103.1 ; 4.1 ;3;50;16;0;3;0;3;1;2;0;3;0
20277; 34.6 ; 173.0 ; 15.4 ;5;29;15;0;5;0;5;4;1;2;3;0
20278; 56.3 ; 112.5 ; 18.5 ;2;50;20;2;0;0;2;2;0;0;0;2
20279; 47.4 ; 284.3 ; 32.7 ;6;50;26;0;6;3;3;2;4;2;2;2
20280; 48.2 ; 241.2 ; 37.7 ;5;67;11;0;5;3;2;3;2;2;1;2
20281; 25.1 ; 75.2 ; -   ;3;18;0;0;3;0;3;0;3;3;0;0
20282; 66.9 ; 133.8 ; 14.1 ;2;20;5;0;2;0;2;2;0;0;0;2
20283; 29.1 ; 349.1 ; 16.5 ;12;36;32;0;12;0;12;12;0;8;4;0
20284; 23.3 ; 93.4 ; 10.3 ;4;29;22;0;4;0;4;3;1;3;1;0
20285; 65.9 ; 593.2 ; 14.7 ;9;33;9;0;9;4;5;9;0;0;0;9
20286; 34.5 ; 103.4 ; 3.9 ;3;67;57;0;3;1;2;0;3;0;3;0
20287; 15.0 ; 45.0 ; -   ;3;13;15;0;3;2;1;1;2;3;0;0
20288; 15.0 ; 30.0 ; -   ;2;23;60;0;2;2;0;2;0;2;0;0
20289; 55.5 ; 110.9 ; 12.2 ;2;23;243;0;2;1;1;0;2;0;0;2
20290; 40.6 ; 121.7 ; 25.6 ;3;72;110;0;3;1;2;3;0;1;1;1
20291; 77.4 ; 387.0 ; 47.6 ;5;65;31;0;5;0;5;5;0;2;0;3
20292; 50.9 ; 254.5 ; 9.8 ;5;8;158;0;5;3;2;2;3;0;3;2
20293; 47.0 ; 93.9 ; 20.9 ;2;21;81;0;2;1;1;2;0;1;0;1
20294; 27.2 ; 54.3 ; 10.7 ;2;35;158;0;2;0;2;1;1;1;1;0
20295; 34.8 ; 104.4 ; 14.0 ;3;120;21;0;3;1;2;2;1;1;2;0
20296; 85.8 ; 171.7 ; 6.3 ;2;27;316;0;2;1;1;0;2;0;0;2
20297; 46.8 ; 421.1 ; 30.7 ;9;21;45;0;9;3;6;4;5;3;3;3
20298; 40.6 ; 81.2 ; 9.2 ;2;13;120;0;2;0;2;2;0;0;2;0
20299; 51.1 ; 204.4 ; 17.1 ;4;104;11;0;4;0;4;4;0;0;3;1
20300; 38.5 ; 538.8 ; 14.6 ;14;19;10;0;14;5;9;3;11;5;9;0
20301; 24.7 ; 222.5 ; 9.6 ;9;35;5;0;9;3;6;7;2;6;3;0
20302; 26.1 ; 156.5 ; 13.8 ;6;29;24;0;6;4;2;0;6;4;2;0
20303; 48.9 ; 1,124.7 ; 22.6 ;23;12;1;0;23;3;20;12;11;8;7;8
20304; 46.8 ; 93.5 ; -   ;2;196;104;0;2;0;2;2;0;0;2;0
20305; 39.5 ; 197.5 ; 7.6 ;5;61;125;0;5;1;4;5;0;0;5;0
20306; 32.5 ; 260.2 ; 8.1 ;8;29;31;0;8;0;8;8;0;3;5;0
20307; 31.6 ; 63.2 ; 24.9 ;2;299;23;1;1;2;0;1;1;1;0;1
20308; 44.6 ; 89.2 ; 20.1 ;2;87;126;0;2;0;2;1;1;1;0;1
20309; 60.6 ; 121.2 ; 20.7 ;2;68;89;0;2;0;2;1;1;0;0;2
20310; 45.7 ; 822.8 ; 9.1 ;18;19;7;0;18;11;7;4;14;0;18;0
20311; 32.1 ; 96.4 ; 14.6 ;3;58;250;0;3;3;0;2;1;1;2;0
20312; 38.6 ; 154.4 ; 11.2 ;4;10;264;0;4;3;1;4;0;1;3;0
20313; 31.2 ; 62.5 ; 24.3 ;2;5;94;2;0;0;2;2;0;1;0;1
20314; 53.8 ; 215.0 ; 2.2 ;4;48;89;0;4;0;4;1;3;0;3;1
20315; 43.4 ; 86.7 ; 20.1 ;2;12;225;0;2;0;2;0;2;1;0;1
20316; 38.4 ; 268.7 ; 15.0 ;7;57;26;0;7;1;6;4;3;2;5;0
20317; 48.1 ; 144.4 ; 29.8 ;3;83;109;0;3;1;2;3;0;1;1;1
20318; 41.0 ; 533.3 ; 28.8 ;13;23;16;0;13;4;9;2;11;4;5;4
20319; 23.4 ; 163.9 ; 13.1 ;7;32;125;0;7;6;1;6;1;5;2;0
20320; 24.6 ; 638.5 ; 10.9 ;26;7;17;0;26;12;14;4;22;17;9;0
20321; 35.9 ; 71.8 ; 16.2 ;2;239;93;0;2;1;1;1;1;1;1;0
20322; 29.8 ; 119.4 ; 9.1 ;4;26;25;4;0;2;2;2;2;3;1;0
20323; 69.9 ; 139.8 ; 26.0 ;2;25;185;2;0;0;2;2;0;0;0;2
20324; 38.5 ; 115.4 ; 13.3 ;3;167;2;0;3;2;1;3;0;1;2;0
20325; 25.1 ; 75.2 ; -   ;3;26;78;0;3;0;3;2;1;3;0;0
20326; 30.4 ; 700.1 ; 23.4 ;23;12;36;0;23;3;20;17;6;8;15;0
20327; 46.8 ; 93.5 ; -   ;2;28;197;0;2;1;1;0;2;0;2;0
20328; 35.4 ; 176.8 ; 19.8 ;5;45;113;0;5;3;2;2;3;2;1;2
20329; 15.8 ; 173.3 ; 1.0 ;11;28;5;0;11;1;10;4;7;11;0;0
20330; 35.6 ; 178.1 ; 26.8 ;5;41;50;5;0;5;0;5;0;2;1;2
20331; 35.0 ; 174.8 ; 18.0 ;5;29;11;0;5;0;5;4;1;2;3;0
20332; 27.3 ; 109.0 ; 8.7 ;4;63;50;0;4;2;2;4;0;3;1;0
20333; 36.9 ; 73.8 ; 17.7 ;2;214;65;0;2;2;0;1;1;1;1;0
20334; 61.6 ; 184.7 ; 10.0 ;3;56;128;0;3;3;0;1;2;0;0;3
20335; 17.3 ; 345.3 ; 5.4 ;20;5;233;0;20;6;14;13;7;20;0;0
20336; 30.3 ; 121.2 ; 13.8 ;4;14;263;0;4;2;2;1;3;1;3;0
20337; 43.8 ; 87.7 ; 4.4 ;2;8;205;0;2;1;1;0;2;0;2;0
20338; 41.0 ; 204.9 ; 31.2 ;5;27;160;0;5;1;4;2;3;2;1;2
20339; 54.9 ; 713.5 ; 8.1 ;13;14;89;0;13;2;11;9;4;0;9;4
20340; 27.4 ; 137.2 ; 2.8 ;5;34;230;0;5;4;1;4;1;3;2;0
20341; 15.0 ; 30.0 ; -   ;2;113;180;0;2;2;0;1;1;2;0;0
20342; 61.7 ; 370.0 ; 21.1 ;6;20;1;0;6;0;6;1;5;0;0;6
20343; 46.8 ; 233.8 ; -   ;5;65;146;0;5;1;4;3;2;0;5;0
20344; 52.4 ; 576.4 ; 21.8 ;11;31;8;0;11;1;10;1;10;0;7;4
20345; 28.1 ; 280.7 ; 5.5 ;10;13;252;0;10;4;6;5;5;7;3;0
20346; 25.5 ; 204.3 ; 22.3 ;8;27;14;0;8;2;6;8;0;5;3;0
20347; 20.1 ; 180.6 ; 5.7 ;9;24;160;0;9;1;8;7;2;9;0;0
20348; 78.3 ; 1,096.5 ; 43.9 ;14;26;0;0;14;6;8;9;5;0;0;14
20349; 32.9 ; 98.8 ; 14.4 ;3;32;112;0;3;3;0;1;2;1;2;0
20350; 45.0 ; 314.9 ; 37.8 ;7;34;5;0;7;2;5;1;6;2;3;2
20351; 77.3 ; 386.5 ; 26.2 ;5;43;126;0;5;3;2;4;1;0;0;5
20352; 39.8 ; 199.0 ; 11.6 ;5;65;5;0;5;0;5;3;2;2;3;0
20353; 52.1 ; 104.2 ; 8.0 ;2;19;280;0;2;2;0;1;1;0;1;1
20354; 36.6 ; 73.1 ; 15.3 ;2;11;211;0;2;0;2;0;2;1;1;0
20355; 50.3 ; 251.7 ; 3.0 ;5;12;224;0;5;0;5;5;0;0;5;0
20356; 16.0 ; 96.1 ; 1.9 ;6;54;12;6;0;5;1;2;4;6;0;0
20357; 38.8 ; 77.7 ; 12.9 ;2;6;60;2;0;2;0;2;0;1;1;0
20358; 40.3 ; 201.6 ; 16.6 ;5;39;63;0;5;0;5;5;0;2;1;2
20359; 31.9 ; 127.6 ; 8.5 ;4;7;44;4;0;4;0;2;2;1;3;0
20360; 37.5 ; 75.1 ; 0.5 ;2;23;191;0;2;1;1;1;1;0;2;0
20361; 35.7 ; 107.1 ; 10.1 ;3;11;202;0;3;2;1;3;0;1;2;0
20362; 26.2 ; 524.6 ; 14.6 ;20;16;15;0;20;6;14;10;10;13;7;0
20363; 30.9 ; 61.7 ; 23.8 ;2;4;253;0;2;0;2;2;0;1;1;0
20364; 31.8 ; 190.9 ; 9.1 ;6;18;56;0;6;4;2;1;5;2;4;0
20365; 22.5 ; 44.9 ; 11.2 ;2;184;128;0;2;2;0;1;1;1;1;0
20366; 18.8 ; 56.5 ; 5.8 ;3;145;26;0;3;0;3;3;0;3;0;0
20367; 19.8 ; 59.4 ; 8.8 ;3;1;107;0;3;3;0;0;3;3;0;0
20368; 41.7 ; 208.3 ; 16.5 ;5;13;109;0;5;2;3;3;2;2;1;2
20369; 57.0 ; 228.0 ; 20.1 ;4;84;79;0;4;1;3;0;4;0;0;4
20370; 36.7 ; 183.5 ; 13.3 ;5;42;62;0;5;2;3;4;1;2;3;0
20371; 45.7 ; 503.1 ; 8.9 ;11;20;6;0;11;5;6;7;4;0;11;0
20372; 29.7 ; 148.3 ; 16.2 ;5;6;272;0;5;0;5;4;1;3;2;0
20373; 56.3 ; 731.6 ; 32.8 ;13;11;173;0;13;0;13;11;2;4;0;9
20374; 73.4 ; 146.8 ; 39.9 ;2;48;169;1;1;0;2;1;1;0;0;2
20375; 51.6 ; 464.0 ; 18.5 ;9;23;97;0;9;2;7;4;5;0;6;3
20376; 36.4 ; 72.9 ; 28.9 ;2;58;223;0;2;2;0;0;2;1;0;1
20377; 20.1 ; 60.2 ; 9.3 ;3;89;40;0;3;1;2;3;0;3;0;0
20378; 33.4 ; 66.8 ; 4.8 ;2;49;164;0;2;1;1;1;1;1;1;0
20379; 55.6 ; 277.9 ; 15.2 ;5;77;22;0;5;0;5;5;0;0;0;5
20380; 66.2 ; 132.5 ; 2.6 ;2;29;228;0;2;1;1;2;0;0;0;2
20381; 28.7 ; 114.7 ; 15.0 ;4;29;232;0;4;1;3;2;2;3;1;0
20382; 31.6 ; 63.2 ; 24.9 ;2;120;20;0;2;0;2;1;1;1;0;1
20383; 47.5 ; 94.9 ; 1.1 ;2;221;10;2;0;0;2;2;0;0;2;0
20384; 60.6 ; 242.3 ; 34.0 ;4;86;79;0;4;0;4;3;1;1;0;3
20385; 62.3 ; 374.0 ; 12.5 ;6;20;220;0;6;0;6;6;0;0;0;6
20386; 21.1 ; 42.2 ; -   ;2;5;152;0;2;1;1;0;2;2;0;0
20387; 62.7 ; 125.3 ; 51.8 ;2;146;42;1;1;0;2;2;0;1;0;1
20388; 63.2 ; 189.7 ; 41.9 ;3;3;105;0;3;1;2;1;2;1;0;2
20389; 36.9 ; 184.4 ; 13.7 ;5;26;5;0;5;0;5;3;2;2;3;0
20390; 58.4 ; 233.8 ; 24.8 ;4;14;107;0;4;1;3;2;2;0;0;4
20391; 25.1 ; 50.1 ; -   ;2;8;75;0;2;2;0;1;1;2;0;0
20392; 36.6 ; 109.8 ; -   ;3;18;102;1;2;1;2;1;2;0;3;0
20393; 28.5 ; 113.8 ; 15.1 ;4;38;205;0;4;2;2;2;2;3;1;0
20394; 26.3 ; 341.6 ; 9.9 ;13;26;21;0;13;6;7;8;5;9;4;0
20395; 51.8 ; 362.4 ; 15.0 ;7;47;5;0;7;1;6;5;2;0;5;2
20396; 26.5 ; 450.3 ; 10.4 ;17;9;3;1;16;6;11;9;8;11;6;0
20397; 74.7 ; 224.1 ; 23.6 ;3;131;41;0;3;1;2;1;2;0;0;3
20398; 47.8 ; 1,578.1 ; 22.9 ;33;9;28;0;33;11;22;31;2;11;11;11
20399; 53.2 ; 212.8 ; 13.7 ;4;66;35;0;4;1;3;2;2;0;3;1
20400; 25.1 ; 50.1 ; -   ;2;23;110;0;2;0;2;1;1;2;0;0
20401; 69.2 ; 346.2 ; 17.1 ;5;74;80;0;5;2;3;2;3;0;0;5
20402; 64.7 ; 129.3 ; 42.0 ;2;17;372;0;2;1;1;1;1;1;0;1
20403; 58.6 ; 234.3 ; 27.4 ;4;72;68;0;4;1;3;3;1;0;0;4
20404; 44.5 ; 178.1 ; 22.5 ;4;114;20;0;4;1;3;3;1;1;2;1
20405; 20.7 ; 62.1 ; 5.7 ;3;45;78;0;3;0;3;1;2;3;0;0
20406; 41.2 ; 164.8 ; 23.8 ;4;63;5;4;0;0;4;3;1;1;2;1
20407; 46.5 ; 139.4 ; 29.9 ;3;1;246;0;3;2;1;0;3;1;1;1
20408; 45.3 ; 90.6 ; 22.6 ;2;140;43;2;0;1;1;0;2;1;0;1
20409; 42.8 ; 471.0 ; 11.6 ;11;26;11;0;11;2;9;3;8;0;11;0
20410; 25.1 ; 50.1 ; -   ;2;8;212;0;2;1;1;2;0;2;0;0
20411; 39.8 ; 596.6 ; 19.1 ;15;25;41;0;15;9;6;5;10;5;5;5
20412; 38.3 ; 153.4 ; 3.7 ;4;74;47;0;4;2;2;2;2;0;4;0
20413; 31.9 ; 191.1 ; 9.1 ;6;8;140;0;6;1;5;4;2;2;4;0
20414; 20.6 ; 61.7 ; 2.4 ;3;52;126;0;3;1;2;2;1;3;0;0
20415; 32.1 ; 224.6 ; 16.2 ;7;19;68;0;7;3;4;5;2;2;5;0
20416; 33.8 ; 202.8 ; 11.6 ;6;18;42;0;6;1;5;6;0;2;4;0
20417; 55.2 ; 110.4 ; 27.8 ;2;31;63;0;2;0;2;1;1;1;0;1
20418; 33.4 ; 200.5 ; 19.7 ;6;17;283;0;6;3;3;5;1;2;4;0
20419; 87.5 ; 175.0 ; 14.8 ;2;9;234;0;2;1;1;0;2;0;0;2
20420; 21.7 ; 65.1 ; 6.2 ;3;47;23;0;3;1;2;1;2;3;0;0
20421; 29.7 ; 89.0 ; 15.7 ;3;25;164;0;3;0;3;1;2;2;1;0
20422; 32.7 ; 621.6 ; 14.2 ;19;23;1;0;19;12;7;5;14;6;13;0
20423; 53.8 ; 376.4 ; 17.0 ;7;42;18;0;7;4;3;3;4;0;5;2
20424; 67.1 ; 201.3 ; 22.5 ;3;72;156;0;3;3;0;0;3;0;0;3
20425; 25.9 ; 363.1 ; 12.4 ;14;17;7;0;14;4;10;9;5;9;5;0
20426; 27.6 ; 55.3 ; 3.8 ;2;139;57;0;2;0;2;0;2;1;1;0
20427; 30.6 ; 91.9 ; 16.8 ;3;17;255;0;3;1;2;1;2;1;2;0
20428; 40.2 ; 80.5 ; 5.4 ;2;92;22;1;1;0;2;0;2;0;2;0
20429; 36.6 ; 73.2 ; -   ;2;14;251;0;2;1;1;1;1;0;2;0
20430; 34.2 ; 171.2 ; 22.6 ;5;23;333;0;5;4;1;3;2;2;1;2
20431; 58.6 ; 585.9 ; 18.8 ;10;14;106;0;10;4;6;4;6;0;0;10
20432; 35.2 ; 527.7 ; 21.8 ;15;9;80;0;15;4;11;7;8;5;5;5
20433; 48.2 ; 96.3 ; 2.1 ;2;8;226;0;2;1;1;2;0;0;2;0
20434; 87.7 ; 175.3 ; 67.1 ;2;106;105;0;2;0;2;2;0;1;0;1
20435; 38.0 ; 152.2 ; 15.8 ;4;60;131;0;4;1;3;4;0;1;3;0
20436; 56.1 ; 505.1 ; 33.0 ;9;33;2;0;9;6;3;8;1;3;0;6
20437; 35.5 ; 71.1 ; 18.9 ;2;6;15;2;0;0;2;2;0;1;1;0
20438; 68.5 ; 821.8 ; 18.3 ;12;38;5;0;12;0;12;7;5;0;0;12
20439; 33.6 ; 470.8 ; 13.1 ;14;25;11;0;14;4;10;7;7;5;9;0
20440; 35.1 ; 175.6 ; 31.3 ;5;32;75;0;5;0;5;1;4;2;1;2
20441; 37.5 ; 112.4 ; 28.7 ;3;16;65;0;3;2;1;1;2;1;1;1
20442; 61.0 ; 305.1 ; 19.3 ;5;34;153;0;5;4;1;5;0;0;0;5
20443; 20.1 ; 562.2 ; 7.7 ;28;11;5;0;28;6;22;13;15;28;0;0
20444; 46.8 ; 187.0 ; -   ;4;43;262;0;4;3;1;1;3;0;4;0
20445; 50.6 ; 101.1 ; 2.9 ;2;12;356;0;2;0;2;2;0;0;2;0
20446; 50.6 ; 1,113.0 ; 17.2 ;22;16;83;0;22;6;16;15;7;0;15;7
20447; 20.0 ; 40.1 ; 7.6 ;2;115;265;0;2;2;0;1;1;2;0;0
20448; 28.8 ; 86.4 ; 8.8 ;3;23;53;3;0;1;2;3;0;2;1;0
20449; 22.9 ; 1,098.7 ; 10.2 ;48;7;2;0;48;28;20;21;27;32;16;0
20450; 49.4 ; 197.7 ; 2.8 ;4;29;47;0;4;0;4;2;2;0;4;0
20451; 31.7 ; 412.6 ; 13.6 ;13;18;6;0;13;6;7;7;6;4;9;0
20452; 37.9 ; 606.6 ; 14.3 ;16;19;43;0;16;5;11;12;4;5;11;0
20453; 39.2 ; 156.7 ; 16.2 ;4;33;73;0;4;1;3;4;0;1;2;1
20454; 17.2 ; 34.4 ; 3.3 ;2;141;158;0;2;1;1;0;2;2;0;0
20455; 27.1 ; 81.3 ; 3.7 ;3;30;160;0;3;2;1;1;2;2;1;0
20456; 27.8 ; 111.3 ; 18.2 ;4;23;274;0;4;1;3;1;3;3;1;0
20457; 46.0 ; 368.3 ; 8.8 ;8;41;10;0;8;1;7;4;4;0;8;0
20458; 16.7 ; 283.8 ; 4.2 ;17;20;1;0;17;6;11;6;11;17;0;0
20459; 38.7 ; 77.4 ; 13.1 ;2;81;57;0;2;0;2;1;1;1;1;0
20460; 16.2 ; 227.3 ; 5.3 ;14;24;8;0;14;5;9;2;12;14;0;0
20461; 15.0 ; 30.0 ; -   ;2;14;133;0;2;2;0;1;1;2;0;0
20462; 90.9 ; 181.8 ; 10.2 ;2;131;20;2;0;2;0;2;0;0;0;2
20463; 44.8 ; 89.6 ; 2.9 ;2;57;205;0;2;0;2;0;2;0;2;0
20464; 18.2 ; 90.8 ; 2.2 ;5;42;137;0;5;0;5;4;1;5;0;0
20465; 40.9 ; 449.9 ; 17.3 ;11;23;5;0;11;3;8;4;7;4;3;4
20466; 70.1 ; 140.3 ; 35.0 ;2;196;122;0;2;1;1;2;0;0;0;2
20467; 66.6 ; 599.1 ; 11.1 ;9;33;8;0;9;9;0;9;0;0;0;9
20468; 33.4 ; 66.8 ; 20.0 ;2;168;79;0;2;1;1;1;1;1;1;0
20469; 33.2 ; 99.6 ; 3.6 ;3;66;16;0;3;1;2;1;2;1;2;0
20470; 43.4 ; 86.7 ; 0.8 ;2;203;9;0;2;1;1;2;0;0;2;0
20471; 39.7 ; 793.7 ; 9.1 ;20;14;13;0;20;14;6;5;15;0;20;0
20472; 31.2 ; 125.0 ; 2.3 ;4;9;164;0;4;1;3;1;3;1;3;0
20473; 47.5 ; 94.9 ; -   ;2;18;52;2;0;0;2;2;0;0;2;0
20474; 37.5 ; 112.6 ; 3.3 ;3;5;260;0;3;1;2;1;2;0;3;0
20475; 30.2 ; 60.4 ; -   ;2;63;104;2;0;0;2;2;0;0;2;0
20476; 36.9 ; 73.8 ; 17.7 ;2;10;234;0;2;1;1;0;2;1;1;0
20477; 38.5 ; 76.9 ; 12.4 ;2;51;233;0;2;2;0;2;0;1;1;0
20478; 27.8 ; 83.3 ; 19.3 ;3;92;99;0;3;0;3;1;2;2;1;0
20479; 69.4 ; 555.3 ; 34.4 ;8;25;64;0;8;3;5;5;3;0;0;8
20480; 40.6 ; 162.3 ; 12.1 ;4;68;111;0;4;2;2;4;0;1;3;0
20481; 45.3 ; 316.8 ; 14.9 ;7;44;5;0;7;1;6;6;1;0;5;2
20482; 43.6 ; 217.9 ; 11.7 ;5;30;230;0;5;0;5;2;3;0;3;2
20483; 49.3 ; 98.7 ; 4.8 ;2;15;256;0;2;2;0;1;1;0;2;0
20484; 34.4 ; 412.8 ; 10.1 ;12;23;129;0;12;7;5;6;6;4;8;0
20485; 38.1 ; 228.9 ; 32.4 ;6;50;2;0;6;2;4;1;5;2;2;2
20486; 31.3 ; 94.0 ; 9.2 ;3;117;5;0;3;2;1;2;1;1;2;0
20487; 25.8 ; 103.1 ; 1.5 ;4;30;193;0;4;1;3;4;0;4;0;0
20488; 22.9 ; 114.6 ; 17.5 ;5;9;239;0;5;3;2;4;1;3;2;0
20489; 46.9 ; 187.4 ; 0.5 ;4;128;73;2;2;0;4;4;0;0;4;0
20490; 55.3 ; 387.1 ; 8.6 ;7;19;53;0;7;4;3;6;1;0;0;7
20491; 22.5 ; 157.7 ; 10.0 ;7;21;52;0;7;0;7;4;3;5;2;0
20492; 53.3 ; 213.3 ; 19.0 ;4;40;47;0;4;0;4;1;3;0;3;1
20493; 59.5 ; 119.0 ; 19.1 ;2;38;178;0;2;0;2;2;0;0;0;2
20494; 76.5 ; 535.4 ; 42.3 ;7;47;1;0;7;3;4;3;4;0;0;7
20495; 57.4 ; 287.2 ; 5.3 ;5;47;7;0;5;1;4;5;0;0;0;5
20496; 37.6 ; 75.2 ; 18.8 ;2;29;197;2;0;1;1;0;2;1;0;1
20497; 33.7 ; 101.1 ; 18.5 ;3;29;179;0;3;1;2;2;1;1;2;0
20498; 40.0 ; 120.0 ; 13.7 ;3;39;37;0;3;1;2;1;2;1;2;0
20499; 23.7 ; 165.8 ; 2.8 ;7;35;85;0;7;0;7;0;7;7;0;0
20500; 18.4 ; 404.3 ; 8.7 ;22;12;2;1;21;7;15;5;17;22;0;0
20501; 32.0 ; 96.0 ; 5.5 ;3;48;125;0;3;0;3;3;0;1;2;0
20502; 32.8 ; 295.4 ; 17.0 ;9;15;11;0;9;5;4;3;6;3;6;0
20503; 47.7 ; 95.4 ; 7.2 ;2;50;351;0;2;0;2;1;1;0;2;0
20504; 30.2 ; 60.4 ; -   ;2;6;173;0;2;0;2;1;1;0;2;0
20505; 47.8 ; 239.0 ; 27.6 ;5;68;13;0;5;0;5;3;2;2;1;2
20506; 15.3 ; 61.4 ; 0.8 ;4;111;12;1;3;1;3;1;3;4;0;0
20507; 60.3 ; 120.6 ; 62.5 ;2;178;109;0;2;1;1;1;1;1;0;1
20508; 54.5 ; 272.4 ; 11.2 ;5;31;40;0;5;1;4;4;1;0;3;2
20509; 64.5 ; 128.9 ; 53.6 ;2;1;398;0;2;1;1;0;2;1;0;1
20510; 47.7 ; 95.4 ; 1.4 ;2;25;241;0;2;0;2;2;0;0;2;0
20511; 26.4 ; 105.6 ; 10.7 ;4;15;251;0;4;1;3;3;1;3;1;0
20512; 53.8 ; 161.5 ; 9.4 ;3;9;58;0;3;0;3;2;1;0;2;1
20513; 34.8 ; 173.8 ; 9.4 ;5;46;20;0;5;0;5;2;3;2;3;0
20514; 30.2 ; 60.4 ; -   ;2;50;220;0;2;0;2;2;0;0;2;0
20515; 15.0 ; 30.0 ; -   ;2;241;53;0;2;1;1;1;1;2;0;0
20516; 26.8 ; 80.3 ; 3.1 ;3;44;183;0;3;1;2;3;0;3;0;0
20517; 50.0 ; 99.9 ; 4.8 ;2;297;10;0;2;0;2;0;2;0;2;0
20518; 15.0 ; 30.0 ; -   ;2;105;62;2;0;2;0;0;2;2;0;0
20519; 32.9 ; 164.7 ; 2.2 ;5;9;64;0;5;3;2;3;2;0;5;0
20520; 45.2 ; 90.3 ; 2.4 ;2;82;45;2;0;2;0;0;2;0;2;0
20521; 45.6 ; 684.0 ; 15.5 ;15;11;5;0;15;1;14;10;5;0;10;5
20522; 40.2 ; 80.3 ; 16.2 ;2;125;104;1;1;0;2;2;0;1;0;1
20523; 47.2 ; 377.9 ; 20.4 ;8;17;191;0;8;7;1;1;7;3;2;3
20524; 31.8 ; 159.1 ; 21.7 ;5;6;6;0;5;2;3;3;2;2;3;0
20525; 44.8 ; 940.5 ; 17.8 ;21;20;1;0;21;12;9;4;17;7;7;7
20526; 75.1 ; 300.4 ; 41.5 ;4;28;137;0;4;2;2;1;3;0;0;4
20527; 46.8 ; 93.5 ; -   ;2;20;162;0;2;0;2;0;2;0;2;0
20528; 84.3 ; 168.6 ; 30.1 ;2;44;272;0;2;0;2;2;0;0;0;2
20529; 28.1 ; 168.3 ; 16.5 ;6;39;68;0;6;2;4;3;3;4;2;0
20530; 55.8 ; 111.5 ; 12.9 ;2;2;255;0;2;1;1;1;1;0;0;2
20531; 21.1 ; 189.9 ; 11.5 ;9;23;79;0;9;6;3;1;8;6;3;0
20532; 23.6 ; 1,157.9 ; 11.9 ;49;10;0;0;49;21;28;19;30;33;16;0
20533; 69.9 ; 209.7 ; 38.3 ;3;9;241;0;3;1;2;3;0;0;0;3
20534; 71.1 ; 142.2 ; 68.9 ;2;84;94;0;2;1;1;2;0;1;0;1
20535; 47.5 ; 189.9 ; 0.6 ;4;44;10;0;4;0;4;3;1;0;4;0
20536; 60.0 ; 120.0 ; 18.8 ;2;14;85;0;2;1;1;0;2;0;0;2
20537; 36.4 ; 109.3 ; 10.8 ;3;23;3;0;3;1;2;1;2;1;2;0
20538; 18.0 ; 144.4 ; 0.1 ;8;29;173;0;8;4;4;1;7;8;0;0
20539; 52.5 ; 157.5 ; 20.3 ;3;32;272;0;3;3;0;0;3;0;2;1
20540; 20.5 ; 102.4 ; 8.6 ;5;52;5;0;5;0;5;2;3;5;0;0
20541; 48.1 ; 240.3 ; 10.6 ;5;5;260;0;5;1;4;5;0;0;3;2
20542; 40.4 ; 161.4 ; 44.9 ;4;23;17;0;4;1;3;3;1;1;2;1
20543; 42.7 ; 256.4 ; 11.3 ;6;68;8;1;5;3;3;3;3;0;6;0
20544; 79.2 ; 158.5 ; 21.4 ;2;321;22;0;2;1;1;1;1;0;0;2
20545; 17.3 ; 86.7 ; 2.6 ;5;22;159;0;5;4;1;5;0;5;0;0
20546; 46.8 ; 140.3 ; -   ;3;81;227;0;3;0;3;1;2;0;3;0
20547; 60.2 ; 903.6 ; 33.9 ;15;17;48;0;15;0;15;1;14;5;0;10
20548; 24.9 ; 548.7 ; 12.6 ;22;15;2;0;22;12;10;5;17;15;7;0
20549; 18.8 ; 94.0 ; 2.4 ;5;29;26;0;5;0;5;3;2;5;0;0
20550; 63.8 ; 127.7 ; 25.6 ;2;53;125;1;1;1;1;1;1;0;0;2
20551; 16.2 ; 48.6 ; 2.2 ;3;9;108;3;0;2;1;3;0;3;0;0
20552; 52.2 ; 156.7 ; 26.3 ;3;16;10;0;3;0;3;3;0;1;1;1
20553; 42.4 ; 212.2 ; 44.7 ;5;42;23;0;5;3;2;3;2;2;1;2
20554; 61.8 ; 123.7 ; 47.4 ;2;13;99;0;2;0;2;2;0;1;0;1
20555; 84.9 ; 169.9 ; 15.0 ;2;203;99;0;2;0;2;2;0;0;0;2
20556; 54.5 ; 163.4 ; 7.2 ;3;59;31;3;0;1;2;1;2;0;2;1
20557; 39.1 ; 273.8 ; 13.7 ;7;41;31;0;7;2;5;5;2;2;5;0
20558; 188.6 ; 565.7 ; 117.4 ;3;5;260;0;3;3;0;2;1;0;0;3
20559; 49.0 ; 147.1 ; 17.9 ;3;52;116;0;3;0;3;1;2;0;2;1
20560; 52.6 ; 105.2 ; 8.7 ;2;141;160;0;2;1;1;1;1;0;1;1
20561; 39.7 ; 79.4 ; 9.2 ;2;13;38;0;2;0;2;2;0;0;2;0
20562; 17.7 ; 53.2 ; 2.6 ;3;140;57;0;3;1;2;3;0;3;0;0
20563; 22.0 ; 154.0 ; 5.7 ;7;32;17;7;0;5;2;2;5;7;0;0
20564; 54.4 ; 108.9 ; 36.3 ;2;16;266;0;2;2;0;0;2;1;0;1
20565; 30.3 ; 90.9 ; 19.5 ;3;69;176;0;3;3;0;1;2;1;2;0
20566; 79.4 ; 238.2 ; 30.7 ;3;63;275;0;3;3;0;3;0;0;0;3
20567; 28.5 ; 85.4 ; 3.1 ;3;81;146;0;3;2;1;1;2;2;1;0
20568; 33.9 ; 677.8 ; 17.7 ;20;19;15;0;20;4;16;16;4;7;13;0
20569; 15.6 ; 31.3 ; -   ;2;13;202;0;2;2;0;0;2;2;0;0
20570; 34.6 ; 345.7 ; 12.7 ;10;32;5;2;8;4;6;10;0;3;7;0
20571; 31.9 ; 63.8 ; 3.8 ;2;94;99;0;2;0;2;2;0;1;1;0
20572; 36.8 ; 110.4 ; 20.6 ;3;7;135;0;3;2;1;1;2;1;1;1
20573; 54.2 ; 108.4 ; 29.3 ;2;65;68;0;2;1;1;0;2;1;0;1
20574; 17.3 ; 34.7 ; 3.5 ;2;158;143;0;2;1;1;1;1;2;0;0
20575; 47.5 ; 94.9 ; -   ;2;9;28;2;0;1;1;1;1;0;2;0
20576; 36.0 ; 179.9 ; 9.6 ;5;50;5;0;5;1;4;3;2;2;3;0
20577; 38.2 ; 190.9 ; 24.1 ;5;64;7;5;0;3;2;2;3;2;1;2
20578; 49.1 ; 98.1 ; 2.9 ;2;28;240;0;2;1;1;0;2;0;2;0
20579; 51.5 ; 257.6 ; 5.9 ;5;26;78;5;0;0;5;1;4;0;3;2
20580; 48.5 ; 97.0 ; 7.0 ;2;13;0;0;2;0;2;2;0;0;1;1
20581; 25.8 ; 51.6 ; 16.2 ;2;69;94;0;2;0;2;2;0;1;1;0
20582; 15.0 ; 59.9 ; -   ;4;1;278;0;4;3;1;4;0;4;0;0
20583; 16.5 ; 66.1 ; 3.2 ;4;57;74;0;4;2;2;3;1;4;0;0
20584; 52.4 ; 261.9 ; 18.3 ;5;73;45;0;5;3;2;2;3;0;3;2
20585; 35.1 ; 105.3 ; 28.2 ;3;61;175;0;3;2;1;1;2;1;1;1
20586; 49.5 ; 148.6 ; 2.8 ;3;113;89;0;3;0;3;3;0;0;3;0
20587; 31.5 ; 157.3 ; 9.5 ;5;34;230;0;5;3;2;1;4;2;3;0
20588; 32.4 ; 810.5 ; 11.1 ;25;11;18;0;25;5;20;22;3;8;17;0
20589; 50.1 ; 100.3 ; 2.2 ;2;227;73;0;2;0;2;2;0;0;2;0
20590; 70.5 ; 141.0 ; 34.5 ;2;139;52;2;0;0;2;1;1;0;0;2
20591; 32.2 ; 225.6 ; 18.2 ;7;41;84;0;7;1;6;4;3;2;5;0
20592; 59.4 ; 1,127.9 ; 19.8 ;19;16;4;0;19;7;12;19;0;0;0;19
20593; 46.8 ; 93.5 ; -   ;2;174;128;0;2;1;1;2;0;0;2;0
20594; 18.8 ; 245.0 ; 4.1 ;13;22;5;0;13;0;13;9;4;13;0;0
20595; 65.3 ; 391.8 ; 17.2 ;6;39;11;2;4;0;6;6;0;0;0;6
20596; 39.8 ; 79.5 ; 8.0 ;2;71;101;0;2;2;0;0;2;0;2;0
20597; 110.2 ; 220.4 ; 27.4 ;2;6;183;2;0;0;2;2;0;0;0;2
20598; 42.1 ; 1,010.0 ; 15.5 ;24;13;0;0;24;8;16;22;2;8;8;8
20599; 30.2 ; 60.4 ; -   ;2;69;83;2;0;2;0;2;0;0;2;0
20600; 17.7 ; 177.2 ; 1.8 ;10;10;72;0;10;6;4;8;2;10;0;0
20601; 36.3 ; 72.5 ; 16.8 ;2;5;71;0;2;2;0;2;0;1;1;0
20602; 83.3 ; 166.7 ; 15.2 ;2;9;170;0;2;1;1;1;1;0;0;2
20603; 23.8 ; 404.7 ; 10.7 ;17;16;3;0;17;5;12;12;5;11;6;0
20604; 28.7 ; 86.1 ; 17.2 ;3;7;26;0;3;2;1;3;0;2;1;0
20605; 22.2 ; 111.2 ; 4.8 ;5;62;47;0;5;2;3;2;3;5;0;0
20606; 25.8 ; 103.0 ; 16.5 ;4;31;77;0;4;2;2;1;3;3;1;0
20607; 30.3 ; 182.0 ; 0.4 ;6;19;99;0;6;0;6;4;2;2;4;0
20608; 35.9 ; 71.8 ; 16.2 ;2;6;180;0;2;2;0;1;1;1;1;0
20609; 19.2 ; 95.8 ; 7.0 ;5;45;0;0;5;1;4;1;4;5;0;0
20610; 63.7 ; 127.4 ; 13.8 ;2;57;17;1;1;1;1;0;2;0;0;2
20611; 39.4 ; 788.6 ; 27.3 ;20;23;5;0;20;10;10;17;3;7;6;7
20612; 27.4 ; 82.3 ; 19.6 ;3;97;8;2;1;3;0;3;0;2;1;0
20613; 55.1 ; 165.4 ; 44.4 ;3;18;65;1;2;2;1;2;1;1;0;2
20614; 48.2 ; 144.5 ; 2.6 ;3;76;131;0;3;0;3;1;2;0;3;0
20615; 16.7 ; 83.3 ; 4.4 ;5;34;84;0;5;1;4;3;2;5;0;0
20616; 25.6 ; 76.7 ; 11.4 ;3;20;2;0;3;2;1;2;1;2;1;0
20617; 16.4 ; 32.9 ; 2.2 ;2;5;235;0;2;2;0;0;2;2;0;0
20618; 91.3 ; 182.7 ; 53.9 ;2;107;45;2;0;2;0;0;2;0;0;2
20619; 48.4 ; 96.8 ; 1.4 ;2;6;36;0;2;0;2;0;2;0;2;0
20620; 41.0 ; 574.7 ; 13.9 ;14;20;22;0;14;3;11;12;2;5;9;0
20621; 18.8 ; 93.8 ; 9.8 ;5;40;106;0;5;3;2;4;1;5;0;0
20622; 15.0 ; 45.0 ; -   ;3;106;1;3;0;0;3;2;1;3;0;0
20623; 18.7 ; 131.1 ; 7.3 ;7;7;142;0;7;2;5;7;0;7;0;0
20624; 46.3 ; 185.3 ; 7.9 ;4;61;136;0;4;0;4;3;1;0;4;0
20625; 30.1 ; 421.3 ; 12.3 ;14;24;74;0;14;4;10;7;7;5;9;0
20626; 67.0 ; 268.0 ; 13.7 ;4;40;10;0;4;1;3;4;0;0;0;4
20627; 85.0 ; 425.1 ; 26.4 ;5;22;215;0;5;1;4;4;1;0;0;5
20628; 19.6 ; 78.3 ; 6.2 ;4;36;182;0;4;4;0;3;1;4;0;0
20629; 24.0 ; 216.4 ; 6.3 ;9;23;16;0;9;3;6;6;3;6;3;0
20630; 101.6 ; 406.4 ; 9.3 ;4;58;152;1;3;1;3;2;2;0;0;4
20631; 20.7 ; 41.5 ; -   ;2;207;97;0;2;2;0;2;0;2;0;0
20632; 67.5 ; 135.0 ; -   ;2;5;242;0;2;0;2;2;0;0;0;2
20633; 24.7 ; 271.3 ; 9.4 ;11;17;5;0;11;2;9;8;3;7;4;0
20634; 58.2 ; 116.5 ; 14.4 ;2;145;31;0;2;0;2;2;0;0;0;2
20635; 47.3 ; 94.7 ; 33.9 ;2;151;38;0;2;0;2;2;0;1;0;1
20636; 57.2 ; 343.4 ; 9.4 ;6;59;63;0;6;0;6;4;2;0;0;6
20637; 19.1 ; 1,031.8 ; 4.1 ;54;6;2;0;54;26;28;13;41;54;0;0
20638; 24.6 ; 123.0 ; 14.1 ;5;74;0;0;5;1;4;4;1;3;2;0
20639; 52.0 ; 104.1 ; 1.8 ;2;37;74;0;2;0;2;2;0;0;2;0
20640; 92.4 ; 369.4 ; 41.7 ;4;29;12;0;4;1;3;1;3;0;0;4
20641; 20.2 ; 101.0 ; 7.7 ;5;77;11;0;5;0;5;1;4;5;0;0
20642; 60.6 ; 181.7 ; 52.7 ;3;19;15;0;3;0;3;2;1;1;0;2
20643; 80.3 ; 160.6 ; 12.7 ;2;194;126;0;2;0;2;2;0;0;0;2
20644; 37.9 ; 151.5 ; 11.3 ;4;30;93;0;4;2;2;4;0;1;3;0
20645; 18.0 ; 36.1 ; 4.6 ;2;12;61;1;1;2;0;2;0;2;0;0
20646; 44.3 ; 132.9 ; 7.2 ;3;9;230;0;3;1;2;0;3;0;3;0
20647; 76.8 ; 230.5 ; 53.0 ;3;38;78;0;3;0;3;2;1;1;0;2
20648; 43.6 ; 348.6 ; 29.0 ;8;29;10;0;8;1;7;3;5;3;2;3
20649; 18.6 ; 334.2 ; 9.6 ;18;21;12;0;18;6;12;7;11;18;0;0
20650; 49.6 ; 99.2 ; 3.2 ;2;55;53;2;0;0;2;2;0;0;2;0
20651; 32.4 ; 64.8 ; 3.0 ;2;4;346;0;2;1;1;0;2;1;1;0
20652; 15.0 ; 30.0 ; -   ;2;11;188;0;2;1;1;0;2;2;0;0
20653; 49.6 ; 347.2 ; 15.8 ;7;48;63;0;7;1;6;7;0;0;5;2
20654; 19.3 ; 77.2 ; 0.9 ;4;6;142;0;4;0;4;1;3;4;0;0
20655; 28.0 ; 168.1 ; 12.0 ;6;33;155;0;6;5;1;4;2;4;2;0
20656; 22.9 ; 182.9 ; 2.0 ;8;41;104;0;8;0;8;1;7;8;0;0
20657; 21.8 ; 43.7 ; 1.6 ;2;70;102;1;1;2;0;2;0;2;0;0
20658; 15.0 ; 30.0 ; -   ;2;71;152;0;2;1;1;2;0;2;0;0
20659; 82.8 ; 165.7 ; 72.5 ;2;61;137;0;2;0;2;1;1;1;0;1
20660; 15.0 ; 45.0 ; -   ;3;70;147;0;3;2;1;3;0;3;0;0
20661; 50.5 ; 101.1 ; 4.6 ;2;1;41;0;2;0;2;0;2;0;1;1
20662; 30.7 ; 184.1 ; 17.5 ;6;30;16;0;6;0;6;4;2;2;4;0
20663; 35.8 ; 178.9 ; 16.6 ;5;10;234;0;5;4;1;4;1;2;3;0
20664; 80.9 ; 323.6 ; 34.9 ;4;16;124;0;4;2;2;2;2;0;0;4
20665; 45.9 ; 91.8 ; 3.4 ;2;32;0;0;2;0;2;0;2;0;2;0
20666; 40.1 ; 361.0 ; 14.5 ;9;29;1;0;9;0;9;3;6;3;6;0
20667; 32.3 ; 64.6 ; 21.6 ;2;42;226;0;2;0;2;2;0;1;1;0
20668; 42.2 ; 126.5 ; 4.5 ;3;31;113;1;2;2;1;1;2;0;3;0
20669; 38.5 ; 76.9 ; 12.4 ;2;6;268;0;2;0;2;1;1;1;1;0
20670; 47.5 ; 189.9 ; -   ;4;29;26;2;2;0;4;1;3;0;4;0
20671; 15.0 ; 30.0 ; -   ;2;13;149;0;2;2;0;2;0;2;0;0
20672; 27.6 ; 55.3 ; 3.8 ;2;22;248;0;2;2;0;2;0;1;1;0
20673; 17.2 ; 343.1 ; 2.8 ;20;10;0;0;20;10;10;2;18;20;0;0
20674; 23.3 ; 93.4 ; 8.5 ;4;35;82;0;4;3;1;1;3;3;1;0
20675; 39.7 ; 79.5 ; 4.7 ;2;158;111;0;2;0;2;0;2;0;2;0
20676; 46.8 ; 140.3 ; 10.8 ;3;43;74;3;0;0;3;1;2;0;2;1
20677; 50.2 ; 452.2 ; 23.1 ;9;2;271;0;9;5;4;2;7;3;3;3
20678; 17.1 ; 85.7 ; 3.7 ;5;50;22;0;5;0;5;3;2;5;0;0
20679; 56.6 ; 226.5 ; 5.0 ;4;44;157;0;4;1;3;4;0;0;0;4
20680; 25.5 ; 76.6 ; 12.8 ;3;31;211;0;3;1;2;2;1;2;1;0
20681; 92.5 ; 277.5 ; 44.8 ;3;99;95;0;3;1;2;2;1;0;0;3
20682; 49.3 ; 492.7 ; 27.7 ;10;11;117;0;10;2;8;9;1;3;4;3
20683; 31.2 ; 62.5 ; 24.3 ;2;281;35;0;2;2;0;1;1;1;0;1
20684; 42.0 ; 294.2 ; 19.1 ;7;27;23;0;7;2;5;4;3;2;3;2
20685; 52.5 ; 105.0 ; -   ;2;28;238;0;2;1;1;0;2;0;2;0
20686; 35.1 ; 140.3 ; 12.6 ;4;59;116;1;3;1;3;3;1;1;3;0
20687; 42.4 ; 1,102.6 ; 23.9 ;26;14;47;0;26;10;16;15;11;9;8;9
20688; 65.8 ; 329.1 ; 18.8 ;5;23;94;0;5;0;5;5;0;0;0;5
20689; 46.8 ; 93.5 ; 2.7 ;2;47;235;0;2;1;1;2;0;0;2;0
20690; 15.0 ; 30.0 ; -   ;2;19;230;0;2;0;2;2;0;2;0;0
20691; 50.4 ; 252.1 ; 28.2 ;5;30;67;1;4;2;3;3;2;2;1;2
20692; 41.3 ; 206.5 ; 45.7 ;5;39;47;4;1;3;2;5;0;2;1;2
20693; 91.0 ; 182.0 ; 66.2 ;2;13;158;0;2;1;1;0;2;1;0;1
20694; 50.1 ; 250.7 ; 12.2 ;5;55;0;0;5;0;5;3;2;0;3;2
20695; 48.1 ; 240.3 ; 18.4 ;5;29;183;0;5;0;5;5;0;2;1;2
20696; 29.0 ; 86.9 ; 3.6 ;3;108;8;0;3;2;1;3;0;2;1;0
20697; 27.4 ; 109.4 ; 12.5 ;4;14;191;0;4;3;1;2;2;3;1;0
20698; 59.3 ; 118.6 ; 18.8 ;2;81;200;0;2;0;2;0;2;0;0;2
20699; 20.1 ; 60.2 ; 9.3 ;3;72;35;3;0;2;1;3;0;3;0;0
20700; 46.1 ; 138.2 ; 15.7 ;3;113;5;0;3;0;3;2;1;0;2;1
20701; 32.4 ; 162.1 ; 18.1 ;5;18;110;0;5;2;3;3;2;2;3;0
20702; 22.5 ; 44.9 ; 11.2 ;2;87;1;0;2;0;2;1;1;1;1;0
20703; 16.3 ; 97.8 ; 2.4 ;6;8;7;0;6;3;3;3;3;6;0;0
20704; 93.2 ; 186.4 ; 14.5 ;2;145;215;0;2;0;2;2;0;0;0;2
20705; 27.2 ; 54.3 ; 18.2 ;2;5;6;0;2;0;2;1;1;1;1;0
20706; 51.8 ; 622.0 ; 8.0 ;12;25;8;0;12;3;9;8;4;0;8;4
20707; 16.3 ; 97.7 ; 1.7 ;6;39;15;0;6;0;6;6;0;6;0;0
20708; 48.4 ; 532.6 ; 11.3 ;11;34;37;0;11;0;11;7;4;0;7;4
20709; 52.8 ; 211.3 ; 10.4 ;4;30;71;4;0;1;3;2;2;0;3;1
20710; 42.6 ; 85.3 ; 9.1 ;2;21;278;0;2;1;1;2;0;0;2;0
20711; 60.2 ; 120.3 ; 9.5 ;2;227;36;1;1;0;2;1;1;0;0;2
20712; 21.8 ; 43.7 ; 4.9 ;2;51;110;2;0;0;2;2;0;2;0;0
20713; 25.1 ; 125.3 ; -   ;5;41;14;0;5;5;0;5;0;5;0;0
20714; 50.9 ; 203.8 ; 11.0 ;4;64;116;0;4;2;2;2;2;0;3;1
20715; 55.6 ; 111.1 ; 13.4 ;2;126;5;0;2;0;2;2;0;0;0;2
20716; 21.5 ; 107.4 ; 4.1 ;5;8;311;0;5;1;4;1;4;5;0;0
20717; 22.3 ; 44.7 ; 2.9 ;2;343;79;1;1;1;1;1;1;2;0;0
20718; 28.1 ; 112.2 ; 11.2 ;4;23;154;0;4;1;3;2;2;3;1;0
20719; 64.0 ; 1,663.5 ; 41.1 ;26;14;2;0;26;2;24;14;12;9;0;17
20720; 21.0 ; 209.6 ; 4.8 ;10;21;42;0;10;3;7;8;2;10;0;0
20721; 44.7 ; 223.4 ; 2.6 ;5;28;0;0;5;0;5;1;4;0;5;0
20722; 57.9 ; 521.4 ; 25.9 ;9;19;110;0;9;3;6;7;2;0;0;9
20723; 30.9 ; 123.6 ; 14.0 ;4;36;16;3;1;1;3;1;3;1;3;0
20724; 46.8 ; 140.3 ; -   ;3;74;142;0;3;2;1;3;0;0;3;0
20725; 29.6 ; 207.3 ; 10.9 ;7;37;0;0;7;2;5;6;1;5;2;0
20726; 47.1 ; 235.7 ; 10.2 ;5;23;206;0;5;4;1;4;1;0;3;2
20727; 50.7 ; 152.1 ; 22.8 ;3;144;22;0;3;0;3;2;1;1;1;1
20728; 16.8 ; 33.6 ; 2.7 ;2;22;286;0;2;1;1;2;0;2;0;0
20729; 27.7 ; 221.2 ; 11.7 ;8;32;5;1;7;0;8;4;4;5;3;0
20730; 17.5 ; 70.0 ; 5.3 ;4;43;161;0;4;4;0;4;0;4;0;0
20731; 47.1 ; 141.3 ; 2.1 ;3;16;35;0;3;1;2;1;2;0;3;0
20732; 27.9 ; 55.8 ; 12.8 ;2;11;231;0;2;0;2;2;0;1;1;0
20733; 18.8 ; 37.6 ; 2.5 ;2;82;293;0;2;0;2;2;0;2;0;0
20734; 62.4 ; 187.3 ; 14.4 ;3;102;77;0;3;1;2;2;1;0;0;3
20735; 19.3 ; 77.2 ; 3.1 ;4;69;26;0;4;0;4;1;3;4;0;0
20736; 75.2 ; 977.8 ; 17.1 ;13;24;10;0;13;0;13;10;3;0;0;13
20737; 26.7 ; 106.8 ; 6.1 ;4;38;73;0;4;1;3;2;2;3;1;0
20738; 22.2 ; 133.0 ; 6.7 ;6;50;23;0;6;2;4;2;4;6;0;0
20739; 31.0 ; 155.1 ; 10.2 ;5;26;0;0;5;0;5;3;2;2;3;0
20740; 62.0 ; 433.8 ; 43.8 ;7;32;101;2;5;3;4;6;1;2;0;5
20741; 48.7 ; 243.3 ; 21.2 ;5;85;68;0;5;4;1;4;1;2;1;2
20742; 56.2 ; 168.7 ; 21.1 ;3;43;83;0;3;0;3;3;0;0;0;3
20743; 45.7 ; 137.2 ; 40.7 ;3;3;226;0;3;1;2;3;0;1;1;1
20744; 19.7 ; 39.5 ; -   ;2;7;272;0;2;0;2;2;0;2;0;0
20745; 21.6 ; 64.8 ; 1.8 ;3;175;106;1;2;1;2;3;0;3;0;0
20746; 24.7 ; 49.5 ; 8.1 ;2;131;173;0;2;1;1;0;2;1;1;0
20747; 130.5 ; 522.2 ; 52.7 ;4;64;91;0;4;2;2;4;0;0;0;4
20748; 69.8 ; 348.8 ; 48.7 ;5;68;27;0;5;1;4;2;3;2;0;3
20749; 29.7 ; 148.6 ; 16.4 ;5;14;43;0;5;1;4;1;4;3;2;0
20750; 28.3 ; 141.5 ; 4.5 ;5;21;18;0;5;3;2;3;2;3;2;0
20751; 31.3 ; 93.9 ; 17.9 ;3;117;68;0;3;1;2;2;1;1;2;0
20752; 30.9 ; 61.7 ; 23.8 ;2;56;106;0;2;0;2;1;1;1;1;0
20753; 44.6 ; 89.3 ; 21.6 ;2;272;114;0;2;1;1;1;1;1;0;1
20754; 30.4 ; 91.1 ; 9.7 ;3;34;204;0;3;0;3;3;0;1;2;0
20755; 53.8 ; 107.7 ; 6.4 ;2;12;20;0;2;0;2;2;0;0;1;1
20756; 30.9 ; 61.7 ; 23.8 ;2;42;133;0;2;1;1;1;1;1;1;0
20757; 17.3 ; 34.7 ; 3.5 ;2;80;14;0;2;2;0;2;0;2;0;0
20758; 27.7 ; 194.2 ; 13.0 ;7;18;30;0;7;2;5;4;3;5;2;0
20759; 45.0 ; 404.8 ; 24.2 ;9;33;26;0;9;2;7;3;6;3;3;3
20760; 15.0 ; 45.0 ; -   ;3;34;42;0;3;0;3;1;2;3;0;0
20761; 39.8 ; 198.9 ; 12.8 ;5;27;76;0;5;1;4;3;2;2;3;0
20762; 33.8 ; 202.6 ; 10.2 ;6;15;59;0;6;4;2;1;5;2;4;0
20763; 15.7 ; 47.1 ; 1.3 ;3;57;213;0;3;2;1;0;3;3;0;0
20764; 47.1 ; 94.2 ; 0.5 ;2;226;42;0;2;0;2;2;0;0;2;0
20765; 68.8 ; 206.3 ; 98.6 ;3;5;178;3;0;1;2;1;2;1;0;2
20766; 28.8 ; 201.4 ; 11.8 ;7;29;67;0;7;3;4;2;5;5;2;0
20767; 58.3 ; 174.9 ; 18.7 ;3;22;68;0;3;0;3;3;0;0;0;3
20768; 34.3 ; 68.6 ; -   ;2;63;337;0;2;0;2;0;2;0;2;0
20769; 57.9 ; 231.7 ; 22.4 ;4;17;152;0;4;1;3;3;1;0;0;4
20770; 38.4 ; 76.7 ; 12.6 ;2;13;199;0;2;0;2;2;0;1;1;0
20771; 49.7 ; 447.1 ; 25.7 ;9;7;254;0;9;1;8;6;3;3;3;3
20772; 52.1 ; 677.7 ; 10.3 ;13;14;11;0;13;9;4;4;9;0;9;4
20773; 35.1 ; 175.5 ; 15.7 ;5;15;47;0;5;2;3;5;0;2;3;0
20774; 26.6 ; 771.5 ; 14.3 ;29;8;5;0;29;4;25;17;12;19;10;0
20775; 25.1 ; 75.4 ; 9.3 ;3;43;285;0;3;1;2;2;1;2;1;0
20776; 44.4 ; 221.9 ; 50.3 ;5;34;74;0;5;1;4;2;3;2;1;2
20777; 26.0 ; 130.2 ; 7.9 ;5;70;54;0;5;4;1;5;0;3;2;0
20778; 30.2 ; 151.1 ; 8.0 ;5;14;140;0;5;3;2;0;5;2;3;0
20779; 22.7 ; 226.5 ; 4.5 ;10;4;239;0;10;5;5;4;6;10;0;0
20780; 45.4 ; 90.8 ; 2.1 ;2;19;226;0;2;0;2;1;1;0;2;0
20781; 53.5 ; 535.1 ; 24.1 ;10;32;22;0;10;4;6;9;1;3;4;3
20782; 53.6 ; 160.8 ; 7.9 ;3;46;184;0;3;1;2;0;3;0;2;1
20783; 18.8 ; 262.8 ; 5.3 ;14;9;99;0;14;1;13;10;4;14;0;0
20784; 52.7 ; 263.3 ; 20.1 ;5;52;89;0;5;1;4;4;1;0;3;2
20785; 44.3 ; 88.7 ; 28.9 ;2;64;167;0;2;1;1;0;2;1;0;1
20786; 34.5 ; 69.0 ; 24.7 ;2;112;137;0;2;0;2;0;2;1;0;1
20787; 28.5 ; 85.6 ; 6.3 ;3;50;23;0;3;3;0;1;2;2;1;0
20788; 20.3 ; 121.6 ; 2.8 ;6;59;10;0;6;4;2;0;6;6;0;0
20789; 56.9 ; 739.1 ; 23.8 ;13;31;36;0;13;3;10;6;7;0;0;13
20790; 26.2 ; 418.5 ; 11.2 ;16;14;133;0;16;10;6;9;7;11;5;0
20791; 36.5 ; 255.4 ; 10.9 ;7;14;287;0;7;3;4;1;6;2;5;0
20792; 134.1 ; 268.2 ; 21.1 ;2;42;57;0;2;1;1;2;0;0;0;2
20793; 77.3 ; 231.9 ; 19.6 ;3;114;59;0;3;1;2;3;0;0;0;3
20794; 46.8 ; 93.5 ; -   ;2;56;241;0;2;0;2;0;2;0;2;0
20795; 15.0 ; 30.0 ; -   ;2;37;5;2;0;0;2;2;0;2;0;0
20796; 80.5 ; 161.1 ; 53.1 ;2;38;230;0;2;0;2;2;0;1;0;1
20797; 16.4 ; 213.2 ; 3.2 ;13;12;5;0;13;0;13;7;6;13;0;0
20798; 46.3 ; 1,204.0 ; 9.4 ;26;16;2;0;26;12;14;14;12;0;17;9
20799; 45.1 ; 1,037.5 ; 16.7 ;23;11;0;1;22;11;12;9;14;8;7;8
20800; 46.8 ; 93.5 ; -   ;2;64;217;0;2;2;0;0;2;0;2;0
20801; 47.7 ; 95.5 ; 1.5 ;2;229;71;0;2;1;1;2;0;0;2;0
20802; 42.5 ; 85.1 ; 12.2 ;2;5;153;2;0;0;2;0;2;0;2;0
20803; 72.1 ; 144.2 ; 38.4 ;2;327;147;0;2;0;2;0;2;0;0;2
20804; 46.8 ; 93.5 ; -   ;2;18;137;0;2;0;2;2;0;0;2;0
20805; 76.8 ; 153.5 ; 43.8 ;2;8;64;0;2;1;1;2;0;0;0;2
20806; 55.6 ; 166.7 ; 16.2 ;3;51;179;0;3;1;2;2;1;0;0;3
20807; 50.3 ; 201.3 ; 5.6 ;4;27;23;4;0;3;1;2;2;0;3;1
20808; 34.5 ; 172.3 ; 7.7 ;5;10;0;0;5;0;5;5;0;2;3;0
20809; 17.7 ; 88.4 ; 1.2 ;5;23;68;0;5;0;5;5;0;5;0;0
20810; 15.0 ; 269.7 ; -   ;18;10;2;0;18;9;9;5;13;18;0;0
20811; 49.9 ; 99.7 ; 1.7 ;2;18;259;0;2;1;1;1;1;0;2;0
20812; 15.0 ; 30.0 ; -   ;2;31;136;0;2;0;2;0;2;2;0;0
20813; 39.8 ; 159.3 ; 17.6 ;4;17;54;0;4;3;1;1;3;1;2;1
20814; 42.9 ; 85.7 ; -   ;2;5;173;0;2;0;2;2;0;0;2;0
20815; 30.8 ; 61.7 ; 8.6 ;2;31;263;0;2;0;2;0;2;1;1;0
20816; 46.0 ; 91.9 ; -   ;2;372;83;0;2;0;2;0;2;0;2;0
20817; 48.9 ; 488.8 ; 18.3 ;10;22;33;0;10;4;6;5;5;0;7;3
20818; 52.5 ; 105.0 ; -   ;2;104;104;2;0;1;1;2;0;0;2;0
20819; 24.4 ; 48.8 ; 8.7 ;2;183;196;0;2;2;0;1;1;1;1;0
20820; 21.4 ; 428.2 ; 10.9 ;20;15;11;0;20;13;7;9;11;13;7;0
20821; 47.5 ; 94.9 ; 1.1 ;2;246;10;2;0;0;2;0;2;0;2;0
20822; 31.9 ; 63.8 ; 1.1 ;2;6;36;0;2;0;2;2;0;0;2;0
20823; 51.7 ; 155.2 ; 9.2 ;3;56;149;0;3;1;2;1;2;0;2;1
20824; 42.7 ; 981.8 ; 13.4 ;23;20;2;0;23;13;10;7;16;8;7;8
20825; 45.4 ; 863.5 ; 27.0 ;19;23;3;0;19;11;8;3;16;6;7;6
20826; 61.6 ; 246.3 ; 6.8 ;4;31;99;0;4;2;2;2;2;0;0;4
20827; 43.1 ; 215.5 ; 7.8 ;5;37;34;0;5;1;4;2;3;0;5;0
20828; 67.9 ; 271.6 ; 15.6 ;4;21;105;0;4;0;4;2;2;0;0;4
20829; 24.5 ; 48.9 ; 9.7 ;2;95;5;0;2;0;2;1;1;1;1;0
20830; 47.5 ; 94.9 ; 1.1 ;2;257;5;0;2;0;2;0;2;0;2;0
20831; 21.5 ; 667.4 ; 10.6 ;31;8;5;1;30;21;10;17;14;21;10;0
20832; 32.7 ; 392.0 ; 14.2 ;12;5;165;0;12;5;7;6;6;4;8;0
20833; 22.6 ; 45.2 ; 11.4 ;2;8;262;0;2;0;2;1;1;1;1;0
20834; 46.8 ; 93.5 ; -   ;2;95;267;0;2;0;2;2;0;0;2;0
20835; 25.1 ; 50.1 ; -   ;2;14;157;0;2;0;2;2;0;2;0;0
20836; 29.6 ; 207.0 ; 8.7 ;7;25;8;0;7;3;4;1;6;5;2;0
20837; 58.6 ; 117.1 ; 2.7 ;2;169;152;0;2;0;2;2;0;0;0;2
20838; 33.6 ; 134.3 ; 17.1 ;4;128;36;1;3;0;4;1;3;1;3;0
20839; 27.0 ; 81.0 ; 9.3 ;3;52;82;0;3;3;0;2;1;2;1;0
20840; 62.7 ; 439.1 ; 23.0 ;7;17;0;0;7;1;6;4;3;0;0;7
20841; 45.2 ; 632.7 ; 10.1 ;14;21;10;0;14;0;14;10;4;0;9;5
20842; 32.3 ; 290.8 ; 17.3 ;9;29;23;0;9;7;2;5;4;3;6;0
20843; 31.0 ; 61.9 ; 23.9 ;2;77;110;0;2;0;2;2;0;1;1;0
20844; 41.9 ; 502.7 ; 19.0 ;12;37;0;0;12;5;7;10;2;4;4;4
20845; 33.4 ; 133.5 ; 2.3 ;4;46;173;0;4;1;3;4;0;0;4;0
20846; 64.8 ; 129.6 ; 4.6 ;2;18;173;0;2;0;2;0;2;0;0;2
20847; 85.8 ; 428.8 ; 81.1 ;5;51;52;0;5;3;2;4;1;2;0;3
20848; 25.1 ; 50.1 ; -   ;2;122;73;1;1;1;1;2;0;2;0;0
20849; 63.6 ; 572.2 ; 31.1 ;9;26;63;0;9;1;8;5;4;0;0;9
20850; 41.7 ; 83.4 ; 7.6 ;2;3;274;0;2;1;1;0;2;0;2;0
20851; 31.1 ; 93.4 ; 16.0 ;3;26;215;0;3;2;1;1;2;1;2;0
20852; 42.6 ; 85.3 ; 3.4 ;2;82;97;2;0;2;0;0;2;0;2;0
20853; 47.7 ; 143.1 ; 1.7 ;3;20;113;0;3;1;2;1;2;0;3;0
20854; 70.7 ; 636.2 ; 19.8 ;9;41;5;0;9;0;9;8;1;0;0;9
20855; 15.0 ; 119.9 ; -   ;8;18;7;8;0;3;5;6;2;8;0;0
20856; 30.9 ; 370.9 ; 14.7 ;12;19;2;0;12;6;6;3;9;4;8;0
20857; 64.8 ; 453.3 ; 16.4 ;7;14;22;0;7;1;6;7;0;0;0;7
20858; 24.5 ; 147.2 ; 9.5 ;6;8;231;0;6;1;5;0;6;4;2;0
20859; 46.8 ; 140.3 ; 13.1 ;3;11;137;0;3;1;2;1;2;0;2;1
20860; 44.8 ; 179.1 ; 12.1 ;4;14;176;0;4;3;1;2;2;0;3;1
20861; 39.6 ; 118.8 ; 13.5 ;3;74;160;0;3;1;2;2;1;1;2;0
20862; 36.8 ; 73.7 ; 17.6 ;2;43;236;0;2;0;2;1;1;1;1;0
20863; 35.0 ; 105.1 ; 12.5 ;3;101;10;0;3;0;3;3;0;1;2;0
20864; 67.6 ; 608.7 ; 24.2 ;9;31;73;0;9;0;9;8;1;0;0;9
20865; 35.2 ; 140.8 ; 12.5 ;4;32;79;0;4;2;2;3;1;1;3;0
20866; 16.4 ; 65.4 ; 2.9 ;4;71;169;0;4;0;4;0;4;4;0;0
20867; 57.1 ; 171.2 ; 12.6 ;3;9;220;0;3;0;3;1;2;0;0;3
20868; 36.4 ; 109.3 ; 15.5 ;3;60;149;0;3;2;1;3;0;1;2;0
20869; 78.7 ; 551.2 ; 37.1 ;7;30;7;7;0;6;1;1;6;0;0;7
20870; 29.6 ; 88.9 ; 4.2 ;3;5;16;0;3;0;3;2;1;2;1;0
20871; 19.0 ; 608.7 ; 15.2 ;32;11;32;0;32;11;21;23;9;21;11;0
20872; 56.1 ; 504.7 ; 37.7 ;9;29;62;0;9;2;7;5;4;3;0;6
20873; 15.3 ; 61.4 ; 0.8 ;4;88;41;0;4;1;3;2;2;4;0;0
20874; 20.0 ; 40.1 ; 7.6 ;2;11;373;0;2;1;1;1;1;2;0;0
20875; 24.1 ; 48.3 ; 0.2 ;2;19;304;0;2;0;2;2;0;2;0;0
20876; 25.8 ; 232.1 ; 8.0 ;9;28;54;1;8;6;3;4;5;6;3;0
20877; 36.6 ; 73.2 ; -   ;2;14;258;0;2;1;1;0;2;0;2;0
20878; 36.9 ; 73.8 ; 17.7 ;2;29;242;0;2;1;1;0;2;1;1;0
20879; 35.7 ; 107.1 ; 10.1 ;3;40;110;0;3;0;3;3;0;1;2;0
20880; 35.0 ; 873.8 ; 13.8 ;25;12;53;0;25;18;7;14;11;8;17;0
20881; 49.5 ; 445.1 ; 21.8 ;9;50;3;0;9;5;4;4;5;3;3;3
20882; 16.8 ; 67.2 ; 2.2 ;4;15;238;0;4;4;0;2;2;4;0;0
20883; 49.6 ; 99.1 ; -   ;2;1;197;2;0;1;1;1;1;0;2;0
20884; 58.0 ; 116.0 ; 26.9 ;2;16;384;0;2;0;2;1;1;0;0;2
20885; 54.6 ; 109.3 ; 3.2 ;2;1;194;0;2;0;2;1;1;0;1;1
20886; 23.5 ; 1,103.8 ; 28.1 ;47;6;16;0;47;21;26;16;31;31;16;0
20887; 209.8 ; 839.3 ; 147.2 ;4;21;230;0;4;1;3;1;3;0;0;4
20888; 27.7 ; 55.5 ; 4.0 ;2;11;252;0;2;0;2;0;2;1;1;0
20889; 72.2 ; 360.8 ; 19.7 ;5;79;32;3;2;2;3;4;1;0;0;5
20890; 38.8 ; 77.7 ; 12.9 ;2;10;39;0;2;1;1;0;2;1;1;0
20891; 52.5 ; 105.0 ; -   ;2;18;210;0;2;0;2;0;2;0;2;0
20892; 25.4 ; 152.3 ; 3.5 ;6;6;193;0;6;1;5;0;6;6;0;0
20893; 39.2 ; 313.4 ; 20.9 ;8;25;10;0;8;3;5;1;7;3;2;3
20894; 45.2 ; 180.9 ; 20.9 ;4;36;227;0;4;3;1;3;1;1;2;1
20895; 18.6 ; 204.4 ; 2.3 ;11;29;83;0;11;7;4;11;0;11;0;0
20896; 33.4 ; 66.8 ; 4.8 ;2;66;233;0;2;1;1;0;2;1;1;0
20897; 30.9 ; 61.7 ; 23.8 ;2;207;141;0;2;1;1;1;1;1;1;0
20898; 16.8 ; 67.2 ; 2.2 ;4;27;299;0;4;0;4;4;0;4;0;0
20899; 28.5 ; 85.4 ; 3.1 ;3;23;81;0;3;3;0;2;1;2;1;0
20900; 129.6 ; 388.9 ; 29.9 ;3;13;99;1;2;0;3;2;1;0;0;3
20901; 52.5 ; 262.6 ; -   ;5;39;108;0;5;3;2;5;0;0;5;0
20902; 60.9 ; 121.8 ; 7.6 ;2;304;145;0;2;1;1;0;2;0;0;2
20903; 22.7 ; 136.4 ; 20.1 ;6;17;221;0;6;2;4;3;3;4;2;0
20904; 37.4 ; 74.9 ; 14.0 ;2;31;142;0;2;0;2;0;2;1;1;0
20905; 34.1 ; 102.4 ; 14.7 ;3;20;321;0;3;1;2;1;2;1;2;0
20906; 33.3 ; 66.6 ; 3.7 ;2;18;94;0;2;0;2;2;0;1;1;0
20907; 50.6 ; 455.0 ; 44.2 ;9;14;241;0;9;0;9;9;0;3;3;3
20908; 24.9 ; 273.9 ; 13.3 ;11;31;81;0;11;7;4;2;9;7;4;0
20909; 96.5 ; 385.8 ; 16.7 ;4;77;68;0;4;0;4;4;0;0;0;4
20910; 23.0 ; 69.1 ; 8.0 ;3;22;105;0;3;1;2;3;0;2;1;0
20911; 15.9 ; 63.5 ; 1.9 ;4;67;43;4;0;2;2;1;3;4;0;0
20912; 44.7 ; 89.4 ; 5.8 ;2;284;98;0;2;1;1;0;2;0;2;0
20913; 39.7 ; 198.5 ; 12.7 ;5;50;15;0;5;1;4;3;2;2;3;0
20914; 19.4 ; 77.7 ; 7.3 ;4;12;2;0;4;1;3;4;0;4;0;0
20915; 39.6 ; 277.3 ; 11.0 ;7;32;20;0;7;1;6;0;7;2;5;0
20916; 16.5 ; 396.8 ; 1.6 ;24;13;8;0;24;9;15;17;7;24;0;0
20917; 106.4 ; 319.1 ; 10.5 ;3;25;152;0;3;0;3;3;0;0;0;3
20918; 38.2 ; 229.4 ; 15.6 ;6;35;122;0;6;3;3;1;5;2;4;0
20919; 44.2 ; 132.5 ; 2.4 ;3;22;341;0;3;0;3;3;0;0;3;0
20920; 58.1 ; 232.3 ; 46.7 ;4;8;91;4;0;4;0;2;2;1;0;3
20921; 33.2 ; 66.4 ; 3.4 ;2;143;11;1;1;0;2;2;0;1;1;0
20922; 19.8 ; 217.3 ; 4.9 ;11;15;6;0;11;1;10;8;3;11;0;0
20923; 50.4 ; 100.8 ; 37.9 ;2;277;5;0;2;0;2;1;1;1;0;1
20924; 46.8 ; 140.3 ; -   ;3;7;228;0;3;1;2;1;2;0;3;0
20925; 44.2 ; 176.8 ; 5.4 ;4;17;110;2;2;0;4;4;0;0;4;0
20926; 16.9 ; 118.0 ; 4.0 ;7;12;269;0;7;6;1;6;1;7;0;0
20927; 28.9 ; 86.7 ; 7.0 ;3;11;188;0;3;1;2;1;2;2;1;0
20928; 43.2 ; 259.4 ; 20.6 ;6;48;71;0;6;2;4;1;5;2;2;2
20929; 21.0 ; 83.8 ; 2.2 ;4;113;33;0;4;3;1;2;2;4;0;0
20930; 37.3 ; 74.6 ; 30.2 ;2;1;296;0;2;2;0;0;2;1;0;1
20931; 38.5 ; 76.9 ; 12.4 ;2;29;144;0;2;1;1;0;2;1;1;0
20932; 55.2 ; 110.4 ; 12.6 ;2;149;138;0;2;1;1;1;1;0;0;2
20933; 51.9 ; 103.8 ; 17.5 ;2;27;241;0;2;0;2;2;0;0;1;1
20934; 25.1 ; 50.1 ; -   ;2;10;204;0;2;1;1;2;0;2;0;0
20935; 15.0 ; 59.9 ; -   ;4;18;34;0;4;3;1;1;3;4;0;0
20936; 28.1 ; 56.1 ; 2.9 ;2;20;248;0;2;1;1;2;0;1;1;0
20937; 15.0 ; 74.9 ; -   ;5;31;113;3;2;4;1;5;0;5;0;0
20938; 42.4 ; 84.8 ; 6.5 ;2;32;247;0;2;0;2;0;2;0;2;0
20939; 15.0 ; 59.9 ; -   ;4;62;104;0;4;3;1;2;2;4;0;0
20940; 55.9 ; 167.8 ; 39.7 ;3;64;28;0;3;3;0;2;1;1;0;2
20941; 41.8 ; 125.4 ; 9.7 ;3;131;26;0;3;1;2;2;1;0;3;0
20942; 22.5 ; 44.9 ; 11.2 ;2;290;21;0;2;0;2;1;1;1;1;0
20943; 49.6 ; 99.3 ; 4.3 ;2;49;201;0;2;1;1;0;2;0;2;0
20944; 38.4 ; 230.2 ; 15.4 ;6;36;86;1;5;5;1;5;1;2;4;0
20945; 18.3 ; 55.0 ; 6.2 ;3;88;22;0;3;0;3;2;1;3;0;0
20946; 28.0 ; 55.9 ; 19.4 ;2;230;68;0;2;1;1;2;0;1;1;0
20947; 50.8 ; 253.9 ; 10.8 ;5;49;142;0;5;2;3;3;2;0;3;2
20948; 27.1 ; 135.6 ; 6.7 ;5;15;100;0;5;2;3;1;4;3;2;0
20949; 36.5 ; 109.5 ; 10.6 ;3;9;5;0;3;0;3;3;0;1;2;0
20950; 37.4 ; 112.1 ; 25.1 ;3;4;42;0;3;1;2;2;1;1;1;1
20951; 24.5 ; 122.6 ; 6.1 ;5;21;78;5;0;3;2;3;2;3;2;0
20952; 17.6 ; 35.2 ; 0.6 ;2;169;34;0;2;2;0;2;0;2;0;0
20953; 43.7 ; 87.4 ; 0.2 ;2;50;20;0;2;0;2;2;0;0;2;0
20954; 25.1 ; 50.1 ; -   ;2;13;240;0;2;2;0;1;1;2;0;0
20955; 36.9 ; 73.8 ; 17.7 ;2;31;29;0;2;2;0;2;0;1;1;0
20956; 45.1 ; 225.4 ; 31.3 ;5;37;36;0;5;3;2;2;3;2;1;2
20957; 23.4 ; 117.2 ; 4.5 ;5;28;137;0;5;0;5;4;1;5;0;0
20958; 25.9 ; 77.8 ; 16.3 ;3;90;3;0;3;2;1;1;2;2;1;0
20959; 67.9 ; 203.7 ; 97.1 ;3;130;0;0;3;1;2;1;2;1;0;2
20960; 18.6 ; 55.7 ; -   ;3;161;5;0;3;0;3;1;2;3;0;0
20961; 75.4 ; 301.8 ; 38.6 ;4;70;128;0;4;1;3;3;1;0;0;4
20962; 30.6 ; 91.8 ; 16.5 ;3;144;25;0;3;3;0;3;0;1;2;0
20963; 30.2 ; 120.7 ; -   ;4;8;122;0;4;1;3;3;1;0;4;0
20964; 18.6 ; 37.2 ; -   ;2;70;203;0;2;2;0;2;0;2;0;0
20965; 91.3 ; 182.7 ; 4.8 ;2;38;246;0;2;0;2;2;0;0;0;2
20966; 23.3 ; 139.8 ; 8.4 ;6;42;11;6;0;1;5;3;3;4;2;0
20967; 20.2 ; 100.9 ; 7.0 ;5;3;134;0;5;3;2;2;3;5;0;0
20968; 40.1 ; 1,244.2 ; 15.5 ;31;13;10;0;31;7;24;21;10;10;11;10
20969; 48.6 ; 242.9 ; 0.7 ;5;77;41;0;5;0;5;4;1;0;5;0
20970; 143.5 ; 286.9 ; 140.6 ;2;120;52;0;2;0;2;2;0;1;0;1
20971; 35.2 ; 738.5 ; 17.9 ;21;20;57;0;21;7;14;15;6;7;14;0
20972; 45.1 ; 135.2 ; 14.6 ;3;88;94;0;3;0;3;2;1;0;2;1
20973; 40.3 ; 282.4 ; 11.5 ;7;42;2;0;7;3;4;7;0;2;5;0
20974; 61.8 ; 185.5 ; 25.7 ;3;23;7;0;3;3;0;1;2;0;0;3
20975; 29.1 ; 58.1 ; 1.7 ;2;3;216;0;2;1;1;2;0;1;1;0
20976; 28.1 ; 112.4 ; 7.4 ;4;40;191;0;4;3;1;3;1;3;1;0
20977; 59.5 ; 119.0 ; 15.2 ;2;261;50;0;2;1;1;1;1;0;0;2
20978; 60.7 ; 182.0 ; 28.5 ;3;5;99;3;0;2;1;3;0;0;0;3
20979; 29.3 ; 528.0 ; 18.1 ;18;5;185;0;18;7;11;10;8;12;6;0
20980; 39.3 ; 314.4 ; 10.4 ;8;41;65;0;8;5;3;1;7;3;5;0
20981; 87.7 ; 1,491.4 ; 39.8 ;17;22;26;0;17;1;16;9;8;0;0;17
20982; 17.7 ; 53.2 ; 2.6 ;3;86;128;0;3;3;0;2;1;3;0;0
20983; 31.3 ; 250.6 ; 6.8 ;8;40;6;0;8;0;8;5;3;3;5;0
20984; 40.8 ; 81.6 ; 34.1 ;2;11;95;0;2;0;2;2;0;1;0;1
20985; 78.7 ; 393.3 ; 44.7 ;5;41;6;0;5;0;5;4;1;0;0;5
20986; 52.5 ; 105.0 ; -   ;2;50;220;0;2;0;2;2;0;0;2;0
20987; 30.9 ; 61.7 ; 23.8 ;2;8;323;0;2;2;0;0;2;1;1;0
20988; 41.1 ; 82.1 ; 32.0 ;2;10;89;0;2;1;1;1;1;1;0;1
20989; 18.7 ; 74.7 ; 1.0 ;4;86;147;0;4;1;3;3;1;4;0;0
20990; 47.3 ; 708.9 ; 17.2 ;15;25;21;0;15;4;11;8;7;0;10;5
20991; 29.5 ; 88.5 ; 10.5 ;3;9;296;0;3;2;1;2;1;2;1;0
20992; 42.2 ; 252.9 ; 11.7 ;6;46;15;0;6;1;5;5;1;0;6;0
20993; 35.3 ; 317.3 ; 14.5 ;9;18;167;0;9;2;7;9;0;3;6;0
20994; 33.7 ; 67.4 ; 5.2 ;2;37;53;2;0;0;2;2;0;1;1;0
20995; 36.1 ; 72.2 ; 17.0 ;2;8;39;0;2;2;0;2;0;1;1;0
20996; 21.7 ; 43.4 ; 9.1 ;2;114;93;0;2;1;1;2;0;1;1;0
20997; 30.0 ; 89.9 ; 15.9 ;3;67;137;0;3;2;1;3;0;2;1;0
20998; 29.1 ; 174.3 ; 17.0 ;6;31;163;0;6;1;5;3;3;4;2;0
20999; 67.9 ; 339.7 ; 31.3 ;5;87;29;0;5;0;5;4;1;0;0;5
21000; 28.2 ; 56.3 ; 11.1 ;2;11;222;0;2;1;1;1;1;1;1;0
21001; 38.5 ; 76.9 ; 12.4 ;2;17;263;0;2;0;2;2;0;1;1;0
21002; 15.0 ; 30.0 ; -   ;2;1;263;0;2;1;1;2;0;2;0;0
21003; 31.8 ; 63.7 ; 25.2 ;2;53;250;0;2;1;1;1;1;1;0;1
21004; 80.4 ; 160.8 ; 42.1 ;2;252;64;0;2;0;2;1;1;0;0;2
21005; 28.1 ; 393.1 ; 8.9 ;14;25;16;0;14;3;11;1;13;9;5;0
21006; 59.5 ; 713.7 ; 30.9 ;12;17;8;0;12;8;4;10;2;4;0;8
21007; 50.4 ; 554.5 ; 17.4 ;11;32;4;0;11;4;7;6;5;0;7;4
21008; 29.2 ; 87.5 ; 17.6 ;3;65;52;0;3;1;2;2;1;2;1;0
21009; 36.7 ; 183.7 ; 33.9 ;5;82;31;0;5;0;5;3;2;2;1;2
21010; 30.2 ; 60.4 ; -   ;2;68;174;0;2;0;2;1;1;0;2;0
21011; 24.4 ; 219.6 ; 13.2 ;9;20;11;0;9;4;5;5;4;6;3;0
21012; 65.5 ; 786.4 ; 25.9 ;12;18;47;0;12;7;5;5;7;0;0;12
21013; 18.4 ; 166.0 ; 5.1 ;9;14;4;0;9;6;3;7;2;9;0;0
21014; 54.7 ; 164.2 ; 12.2 ;3;126;62;0;3;1;2;2;1;0;2;1
21015; 30.2 ; 90.6 ; 20.8 ;3;59;167;0;3;2;1;3;0;1;2;0
21016; 70.3 ; 281.1 ; 31.5 ;4;77;84;0;4;2;2;4;0;0;0;4
21017; 15.0 ; 30.0 ; -   ;2;62;54;0;2;2;0;2;0;2;0;0
21018; 20.8 ; 124.8 ; 9.7 ;6;46;115;0;6;4;2;5;1;4;2;0
21019; 27.8 ; 389.6 ; 20.3 ;14;5;2;0;14;10;4;5;9;9;5;0
21020; 61.1 ; 122.2 ; 4.2 ;2;263;53;1;1;0;2;1;1;0;0;2
21021; 44.9 ; 808.9 ; 32.4 ;18;17;0;0;18;6;12;13;5;6;6;6
21022; 49.5 ; 148.5 ; 18.5 ;3;164;15;0;3;0;3;3;0;0;2;1
21023; 37.5 ; 150.2 ; 12.3 ;4;101;15;0;4;0;4;4;0;1;3;0
21024; 30.5 ; 426.5 ; 9.7 ;14;8;6;13;1;6;8;7;7;5;9;0
21025; 47.8 ; 191.1 ; 0.6 ;4;9;73;0;4;1;3;2;2;0;4;0
21026; 46.9 ; 1,125.9 ; 30.0 ;24;15;61;0;24;8;16;12;12;8;8;8
21027; 91.2 ; 182.5 ; 28.4 ;2;10;309;0;2;1;1;1;1;0;0;2
21028; 28.9 ; 2,712.6 ; 17.9 ;94;4;1;0;94;40;54;62;32;63;31;0
21029; 15.0 ; 30.0 ; -   ;2;13;341;0;2;0;2;2;0;2;0;0
21030; 34.3 ; 137.3 ; 8.8 ;4;21;163;4;0;0;4;3;1;1;3;0
21031; 27.6 ; 138.1 ; 15.1 ;5;66;6;0;5;2;3;1;4;3;2;0
21032; 33.7 ; 202.5 ; 19.4 ;6;22;206;0;6;4;2;4;2;2;4;0
21033; 46.8 ; 187.0 ; -   ;4;99;111;0;4;1;3;1;3;0;4;0
21034; 25.7 ; 411.0 ; 14.4 ;16;20;23;0;16;6;10;12;4;11;5;0
21035; 30.8 ; 61.7 ; 8.6 ;2;14;340;0;2;1;1;0;2;1;1;0
21036; 29.1 ; 58.3 ; 1.6 ;2;115;167;0;2;0;2;1;1;1;1;0
21037; 19.7 ; 157.7 ; 11.6 ;8;9;60;0;8;3;5;5;3;5;3;0
21038; 18.6 ; 130.2 ; 4.2 ;7;67;6;0;7;0;7;2;5;7;0;0
21039; 22.5 ; 45.0 ; 0.3 ;2;27;44;0;2;2;0;2;0;2;0;0
21040; 50.8 ; 254.2 ; 7.4 ;5;38;20;0;5;0;5;4;1;0;3;2
21041; 110.6 ; 553.1 ; 50.6 ;5;52;90;0;5;0;5;5;0;0;0;5
21042; 96.0 ; 1,151.6 ; 44.1 ;12;14;66;12;0;10;2;2;10;0;0;12
21043; 30.5 ; 916.0 ; 17.0 ;30;7;15;0;30;9;21;8;22;10;20;0
21044; 76.7 ; 153.4 ; 1.3 ;2;107;53;0;2;0;2;1;1;0;0;2
21045; 50.5 ; 1,110.6 ; 16.0 ;22;15;2;0;22;13;9;5;17;0;15;7
21046; 15.0 ; 30.0 ; -   ;2;94;184;0;2;0;2;1;1;2;0;0
21047; 37.0 ; 184.9 ; 14.7 ;5;28;116;0;5;2;3;2;3;2;3;0
21048; 59.6 ; 298.1 ; 49.4 ;5;70;25;0;5;5;0;2;3;2;0;3
21049; 27.5 ; 494.5 ; 14.2 ;18;13;1;0;18;9;9;8;10;12;6;0
21050; 48.2 ; 96.4 ; 2.2 ;2;97;183;0;2;1;1;2;0;0;2;0
21051; 22.3 ; 312.7 ; 12.6 ;14;24;94;0;14;1;13;9;5;9;5;0
21052; 26.0 ; 78.0 ; 12.0 ;3;2;246;0;3;2;1;1;2;2;1;0
21053; 49.1 ; 147.2 ; 7.1 ;3;166;52;0;3;2;1;1;2;0;2;1
21054; 31.9 ; 383.1 ; 14.8 ;12;14;134;0;12;2;10;9;3;4;8;0
21055; 50.9 ; 1,018.8 ; 14.4 ;20;14;5;0;20;8;12;13;7;0;13;7
21056; 18.7 ; 112.2 ; 5.8 ;6;30;107;0;6;4;2;3;3;6;0;0
21057; 23.2 ; 162.2 ; 12.8 ;7;59;6;0;7;2;5;3;4;5;2;0
21058; 27.6 ; 55.3 ; 3.8 ;2;149;82;2;0;1;1;1;1;1;1;0
21059; 34.4 ; 137.5 ; 19.8 ;4;28;197;0;4;4;0;1;3;1;3;0
21060; 48.2 ; 96.3 ; 13.0 ;2;4;44;0;2;1;1;1;1;0;1;1
21061; 22.3 ; 111.4 ; 7.9 ;5;9;230;0;5;1;4;4;1;3;2;0
21062; 28.1 ; 252.5 ; 9.9 ;9;21;10;0;9;1;8;5;4;6;3;0
21063; 20.2 ; 80.9 ; 2.6 ;4;47;10;0;4;2;2;2;2;4;0;0
21064; 28.6 ; 885.9 ; 11.8 ;31;11;47;0;31;14;17;8;23;21;10;0
21065; 33.1 ; 925.6 ; 9.9 ;28;7;5;0;28;5;23;6;22;9;19;0
21066; 35.7 ; 142.9 ; 25.3 ;4;5;133;0;4;4;0;1;3;1;2;1
21067; 36.5 ; 291.9 ; 14.0 ;8;24;138;0;8;4;4;2;6;3;5;0
21068; 45.2 ; 135.5 ; -   ;3;16;126;0;3;1;2;0;3;0;3;0
21069; 31.2 ; 62.3 ; 8.0 ;2;34;344;0;2;1;1;0;2;1;1;0
21070; 22.6 ; 45.2 ; 11.4 ;2;139;185;0;2;1;1;0;2;1;1;0
21071; 58.0 ; 232.2 ; 9.5 ;4;49;267;0;4;0;4;2;2;0;0;4
21072; 46.8 ; 140.3 ; -   ;3;72;231;0;3;0;3;3;0;0;3;0
21073; 49.7 ; 248.5 ; 3.3 ;5;44;58;0;5;2;3;2;3;0;5;0
21074; 48.9 ; 146.6 ; 8.5 ;3;58;8;3;0;1;2;2;1;0;2;1
21075; 63.5 ; 190.4 ; 13.1 ;3;16;254;0;3;1;2;2;1;0;0;3
21076; 22.6 ; 90.2 ; 5.3 ;4;33;146;0;4;4;0;1;3;4;0;0
21077; 66.2 ; 132.5 ; 29.2 ;2;5;126;0;2;0;2;2;0;0;0;2
21078; 29.9 ; 59.9 ; 0.1 ;2;69;344;0;2;2;0;0;2;2;0;0
21079; 24.8 ; 74.3 ; 14.2 ;3;26;24;0;3;2;1;1;2;2;1;0
21080; 62.9 ; 125.8 ; 22.0 ;2;182;0;0;2;0;2;2;0;0;0;2
21081; 34.2 ; 68.4 ; 23.4 ;2;11;122;2;0;1;1;2;0;1;0;1
21082; 51.7 ; 103.3 ; 1.0 ;2;302;125;0;2;0;2;2;0;0;2;0
21083; 36.9 ; 73.8 ; 17.7 ;2;18;121;0;2;0;2;2;0;1;1;0
21084; 78.2 ; 312.7 ; 36.9 ;4;73;78;0;4;2;2;2;2;0;0;4
21085; 21.3 ; 64.0 ; 4.1 ;3;98;10;0;3;0;3;3;0;3;0;0
21086; 56.1 ; 112.2 ; 2.3 ;2;82;126;0;2;0;2;2;0;0;0;2
21087; 53.0 ; 106.0 ; 31.0 ;2;36;169;2;0;0;2;0;2;1;0;1
21088; 15.0 ; 164.8 ; -   ;11;11;9;0;11;7;4;7;4;11;0;0
21089; 35.3 ; 918.5 ; 14.5 ;26;11;19;0;26;16;10;4;22;9;17;0
21090; 26.0 ; 77.9 ; 1.7 ;3;68;119;0;3;1;2;2;1;3;0;0
21091; 16.2 ; 113.7 ; 3.8 ;7;9;209;0;7;3;4;5;2;7;0;0
21092; 20.2 ; 80.6 ; 3.3 ;4;1;271;0;4;3;1;2;2;4;0;0
21093; 19.7 ; 39.3 ; -   ;2;30;246;0;2;1;1;1;1;2;0;0
21094; 70.1 ; 140.1 ; 39.0 ;2;38;225;0;2;0;2;2;0;0;0;2
21095; 23.1 ; 92.3 ; 11.2 ;4;76;157;0;4;0;4;4;0;3;1;0
21096; 46.8 ; 327.3 ; 17.3 ;7;28;21;0;7;3;4;4;3;2;3;2
21097; 39.9 ; 119.8 ; 9.2 ;3;15;273;0;3;1;2;2;1;0;3;0
21098; 85.5 ; 170.9 ; 20.4 ;2;44;120;0;2;0;2;2;0;0;0;2
21099; 30.4 ; 304.3 ; 16.5 ;10;32;0;0;10;3;7;9;1;3;7;0
21100; 49.5 ; 197.8 ; 4.7 ;4;40;41;1;3;0;4;4;0;0;4;0
21101; 41.7 ; 83.4 ; 7.6 ;2;9;305;0;2;1;1;2;0;0;2;0
21102; 69.5 ; 834.4 ; 5.8 ;12;17;95;0;12;3;9;2;10;0;0;12
21103; 52.5 ; 105.0 ; -   ;2;22;140;0;2;1;1;0;2;0;2;0
21104; 35.2 ; 70.4 ; 7.5 ;2;53;115;0;2;1;1;1;1;1;1;0
21105; 18.4 ; 36.8 ; 5.1 ;2;5;309;0;2;1;1;2;0;2;0;0
21106; 47.8 ; 334.8 ; 29.1 ;7;33;83;0;7;5;2;5;2;2;3;2
21107; 48.3 ; 96.6 ; 21.5 ;2;42;189;0;2;0;2;2;0;1;0;1
21108; 38.9 ; 194.6 ; 23.4 ;5;18;68;0;5;1;4;4;1;2;1;2
21109; 36.7 ; 550.0 ; 16.5 ;15;18;29;0;15;12;3;9;6;5;10;0
21110; 29.0 ; 174.1 ; 10.8 ;6;43;7;0;6;2;4;5;1;4;2;0
21111; 18.1 ; 108.6 ; 2.2 ;6;36;20;0;6;2;4;5;1;6;0;0
21112; 26.1 ; 1,514.5 ; 14.2 ;58;5;2;0;58;30;28;37;21;39;19;0
21113; 20.7 ; 82.9 ; 0.8 ;4;62;113;1;3;3;1;3;1;4;0;0
21114; 45.2 ; 226.1 ; 25.3 ;5;12;234;0;5;4;1;4;1;2;1;2
21115; 28.6 ; 171.5 ; 13.8 ;6;50;13;0;6;5;1;0;6;4;2;0
21116; 17.2 ; 34.4 ; 1.2 ;2;27;50;0;2;1;1;0;2;2;0;0
21117; 20.0 ; 40.1 ; 7.6 ;2;5;158;0;2;0;2;0;2;2;0;0
21118; 22.6 ; 45.2 ; 11.4 ;2;5;278;0;2;0;2;2;0;1;1;0
21119; 63.2 ; 252.9 ; 14.1 ;4;44;47;1;3;0;4;4;0;0;0;4
21120; 20.0 ; 40.1 ; 7.6 ;2;7;386;0;2;1;1;2;0;2;0;0
21121; 174.7 ; 349.5 ; 92.2 ;2;49;215;0;2;1;1;1;1;0;0;2
21122; 20.9 ; 41.9 ; 4.6 ;2;8;272;0;2;1;1;0;2;2;0;0
21123; 50.8 ; 203.2 ; 12.3 ;4;49;101;0;4;3;1;1;3;0;3;1
21124; 97.8 ; 195.7 ; 31.3 ;2;20;160;2;0;2;0;1;1;0;0;2
21125; 26.1 ; 209.2 ; -   ;8;29;2;0;8;1;7;4;4;8;0;0
21126; 142.6 ; 285.2 ; 65.1 ;2;41;170;0;2;1;1;0;2;0;0;2
21127; 15.0 ; 30.0 ; -   ;2;1;1;0;2;1;1;1;1;2;0;0
21128; 22.0 ; 242.4 ; 6.5 ;11;21;74;0;11;2;9;6;5;11;0;0
21129; 40.8 ; 938.0 ; 16.9 ;23;10;16;0;23;7;16;13;10;8;7;8
21130; 30.6 ; 61.1 ; 0.9 ;2;29;120;0;2;1;1;0;2;1;1;0
21131; 80.1 ; 160.3 ; 41.4 ;2;26;377;0;2;0;2;2;0;0;0;2
21132; 24.8 ; 74.5 ; 5.6 ;3;44;215;0;3;1;2;0;3;2;1;0
21133; 52.0 ; 260.1 ; 2.4 ;5;30;164;0;5;1;4;2;3;0;5;0
21134; 28.8 ; 115.3 ; 14.8 ;4;49;131;0;4;1;3;2;2;3;1;0
21135; 15.0 ; 30.0 ; -   ;2;316;0;0;2;1;1;1;1;2;0;0
21136; 33.6 ; 772.2 ; 8.9 ;23;15;41;0;23;3;20;14;9;8;15;0
21137; 42.7 ; 213.7 ; 27.2 ;5;52;35;5;0;5;0;5;0;2;1;2
21138; 46.1 ; 691.7 ; 19.2 ;15;16;10;0;15;5;10;6;9;5;5;5
21139; 31.8 ; 63.7 ; 25.2 ;2;107;31;0;2;0;2;1;1;1;0;1
21140; 16.9 ; 67.4 ; 2.4 ;4;27;194;0;4;1;3;1;3;4;0;0
21141; 28.9 ; 86.7 ; 7.0 ;3;43;41;0;3;1;2;1;2;2;1;0
21142; 19.4 ; 58.3 ; 5.5 ;3;4;6;0;3;1;2;0;3;3;0;0
21143; 53.9 ; 161.7 ; 13.1 ;3;65;104;1;2;1;2;3;0;0;2;1
21144; 75.2 ; 676.8 ; 21.0 ;9;32;26;0;9;0;9;9;0;0;0;9
21145; 27.4 ; 383.8 ; 10.5 ;14;23;47;0;14;7;7;11;3;9;5;0
21146; 118.1 ; 236.1 ; 51.0 ;2;44;31;0;2;0;2;2;0;0;0;2
21147; 47.1 ; 94.2 ; 0.5 ;2;165;58;2;0;0;2;1;1;0;2;0
21148; 65.7 ; 262.9 ; 25.0 ;4;78;52;0;4;1;3;2;2;0;0;4
21149; 30.2 ; 60.4 ; -   ;2;60;119;2;0;1;1;1;1;0;2;0
21150; 55.5 ; 222.0 ; 39.3 ;4;86;36;2;2;1;3;2;2;1;0;3
21151; 75.6 ; 378.0 ; 31.8 ;5;21;53;0;5;0;5;5;0;0;0;5
21152; 20.6 ; 206.0 ; 6.9 ;10;23;81;0;10;5;5;6;4;10;0;0
21153; 69.6 ; 139.2 ; 11.2 ;2;6;256;0;2;1;1;2;0;0;0;2
21154; 67.9 ; 135.9 ; -   ;2;51;209;0;2;1;1;2;0;0;0;2
21155; 15.0 ; 30.0 ; -   ;2;37;117;0;2;1;1;2;0;2;0;0
21156; 15.0 ; 30.0 ; -   ;2;3;120;0;2;1;1;0;2;2;0;0
21157; 46.5 ; 511.0 ; 37.8 ;11;30;14;0;11;6;5;5;6;4;3;4
21158; 58.3 ; 174.8 ; 10.9 ;3;101;110;0;3;0;3;3;0;0;0;3
21159; 57.7 ; 346.2 ; 28.3 ;6;10;14;0;6;3;3;3;3;2;0;4
21160; 100.5 ; 1,105.4 ; 56.7 ;11;22;99;0;11;2;9;11;0;0;0;11
21161; 16.1 ; 32.1 ; 1.6 ;2;14;203;0;2;2;0;2;0;2;0;0
21162; 20.1 ; 180.8 ; 3.1 ;9;10;195;0;9;7;2;8;1;9;0;0
21163; 64.2 ; 256.8 ; 32.9 ;4;97;53;0;4;1;3;3;1;0;0;4
21164; 48.6 ; 97.2 ; -   ;2;8;264;0;2;2;0;1;1;0;2;0
21165; 30.1 ; 60.1 ; 0.2 ;2;11;200;2;0;0;2;1;1;1;1;0
21166; 53.2 ; 212.9 ; 0.6 ;4;104;11;0;4;0;4;4;0;0;4;0
21167; 42.1 ; 126.4 ; 13.5 ;3;83;40;0;3;1;2;2;1;1;1;1
21168; 40.0 ; 600.3 ; 13.3 ;15;18;11;0;15;3;12;11;4;5;10;0
21169; 72.2 ; 361.0 ; 26.1 ;5;65;26;0;5;2;3;2;3;0;0;5
21170; 62.9 ; 125.8 ; 5.4 ;2;54;6;0;2;1;1;1;1;0;0;2
21171; 24.2 ; 121.0 ; 13.6 ;5;37;38;0;5;2;3;3;2;3;2;0
21172; 44.8 ; 89.6 ; 2.9 ;2;55;131;2;0;0;2;2;0;0;2;0
21173; 29.2 ; 58.3 ; 13.7 ;2;6;231;0;2;0;2;1;1;1;1;0
21174; 26.6 ; 133.2 ; 6.1 ;5;41;79;0;5;2;3;3;2;3;2;0
21175; 57.6 ; 288.2 ; 41.3 ;5;50;15;0;5;0;5;5;0;2;0;3
21176; 23.0 ; 275.4 ; 10.0 ;12;14;1;0;12;5;7;10;2;8;4;0
21177; 31.3 ; 62.6 ; 6.6 ;2;1;283;0;2;0;2;0;2;1;1;0
21178; 83.0 ; 166.0 ; 54.3 ;2;114;15;2;0;0;2;2;0;1;0;1
21179; 69.3 ; 138.7 ; 5.0 ;2;81;136;0;2;0;2;1;1;0;0;2
21180; 52.0 ; 156.1 ; 3.5 ;3;5;11;0;3;1;2;1;2;0;2;1
21181; 27.0 ; 702.6 ; 16.6 ;26;12;68;0;26;8;18;13;13;17;9;0
21182; 57.5 ; 115.0 ; 6.4 ;2;12;89;0;2;0;2;1;1;0;0;2
21183; 46.8 ; 187.0 ; -   ;4;14;260;0;4;3;1;2;2;0;4;0
21184; 39.6 ; 79.2 ; 4.5 ;2;44;147;0;2;0;2;1;1;0;2;0
21185; 32.8 ; 65.6 ; 18.0 ;2;139;116;0;2;1;1;0;2;1;1;0
21186; 25.6 ; 51.2 ; 0.8 ;2;37;163;0;2;0;2;0;2;2;0;0
21187; 20.8 ; 479.2 ; 3.2 ;23;13;24;0;23;12;11;5;18;23;0;0
21188; 45.2 ; 135.5 ; 2.8 ;3;5;10;3;0;0;3;3;0;0;3;0
21189; 48.9 ; 244.4 ; 19.4 ;5;16;228;0;5;2;3;1;4;2;1;2
21190; 17.7 ; 35.4 ; 4.1 ;2;64;292;0;2;2;0;1;1;2;0;0
21191; 17.4 ; 121.8 ; 4.0 ;7;7;4;7;0;1;6;6;1;7;0;0
21192; 65.1 ; 260.2 ; 21.9 ;4;76;42;0;4;0;4;4;0;0;0;4
21193; 48.2 ; 240.9 ; 20.0 ;5;7;60;0;5;4;1;1;4;2;1;2
21194; 36.4 ; 509.4 ; 14.1 ;14;21;12;0;14;5;9;8;6;5;9;0
21195; 15.0 ; 45.0 ; -   ;3;5;49;0;3;2;1;0;3;3;0;0
21196; 52.2 ; 156.7 ; 40.5 ;3;16;11;3;0;0;3;0;3;1;1;1
21197; 54.8 ; 219.3 ; 11.3 ;4;49;248;0;4;2;2;4;0;0;3;1
21198; 47.2 ; 897.3 ; 15.1 ;19;11;73;0;19;4;15;13;6;0;13;6
21199; 47.0 ; 141.0 ; 0.4 ;3;119;26;0;3;0;3;3;0;0;3;0
21200; 37.1 ; 593.5 ; 29.5 ;16;19;59;0;16;9;7;4;12;5;6;5
21201; 25.0 ; 74.9 ; 5.6 ;3;25;300;0;3;2;1;3;0;2;1;0
21202; 25.7 ; 77.0 ; 5.6 ;3;1;219;0;3;1;2;0;3;2;1;0
21203; 55.8 ; 947.9 ; 26.2 ;17;16;6;0;17;5;12;7;10;6;0;11
21204; 29.3 ; 58.6 ; 17.3 ;2;206;191;0;2;1;1;1;1;1;1;0
21205; 57.0 ; 171.1 ; 40.4 ;3;114;86;0;3;1;2;3;0;1;0;2
21206; 34.6 ; 241.9 ; 8.6 ;7;19;99;0;7;0;7;7;0;2;5;0
21207; 25.1 ; 50.1 ; -   ;2;95;26;0;2;0;2;1;1;2;0;0
21208; 33.3 ; 66.6 ; 27.4 ;2;11;83;0;2;1;1;2;0;1;0;1
21209; 22.5 ; 44.9 ; 11.2 ;2;11;251;0;2;2;0;2;0;1;1;0
21210; 16.5 ; 33.0 ; 2.3 ;2;334;72;0;2;2;0;2;0;2;0;0
21211; 43.7 ; 131.0 ; 12.6 ;3;14;29;0;3;2;1;1;2;0;2;1
21212; 21.5 ; 43.1 ; 9.8 ;2;30;98;0;2;2;0;0;2;1;1;0
21213; 71.0 ; 852.5 ; 15.9 ;12;15;5;0;12;1;11;8;4;0;0;12
21214; 19.4 ; 38.9 ; -   ;2;14;161;0;2;1;1;0;2;2;0;0
21215; 47.6 ; 1,618.4 ; 15.7 ;34;8;161;0;34;20;14;10;24;0;23;11
21216; 48.2 ; 144.6 ; 13.9 ;3;134;21;0;3;2;1;2;1;0;2;1
21217; 78.6 ; 1,258.1 ; 31.3 ;16;15;10;0;16;4;12;9;7;0;0;16
21218; 25.4 ; 177.8 ; 14.7 ;7;23;178;0;7;6;1;3;4;5;2;0
21219; 16.5 ; 33.0 ; 2.3 ;2;39;148;0;2;1;1;1;1;2;0;0
21220; 30.8 ; 61.7 ; 8.6 ;2;8;389;0;2;1;1;0;2;1;1;0
21221; 37.5 ; 337.9 ; 16.7 ;9;32;12;0;9;1;8;5;4;3;6;0
21222; 46.7 ; 467.2 ; 0.1 ;10;21;219;0;10;3;7;9;1;0;10;0
21223; 52.4 ; 104.8 ; 5.6 ;2;170;204;0;2;0;2;0;2;0;1;1
21224; 68.2 ; 1,023.7 ; 21.8 ;15;19;5;0;15;0;15;11;4;0;0;15
21225; 38.4 ; 76.7 ; 35.0 ;2;104;17;0;2;0;2;2;0;1;0;1
21226; 73.7 ; 884.7 ; 42.0 ;12;24;6;0;12;7;5;10;2;0;0;12
21227; 46.9 ; 187.4 ; 18.9 ;4;32;163;0;4;1;3;2;2;1;2;1
21228; 68.9 ; 206.7 ; 40.6 ;3;83;131;0;3;0;3;3;0;1;0;2
21229; 30.1 ; 60.1 ; 0.2 ;2;5;250;0;2;2;0;0;2;1;1;0
21230; 43.6 ; 523.1 ; 21.8 ;12;21;162;0;12;5;7;7;5;4;4;4
21231; 45.5 ; 182.1 ; 7.4 ;4;32;20;0;4;1;3;3;1;0;4;0
21232; 42.1 ; 168.6 ; 19.9 ;4;4;73;0;4;1;3;2;2;1;2;1
21233; 30.8 ; 61.7 ; 8.6 ;2;1;226;0;2;1;1;0;2;1;1;0
21234; 68.1 ; 340.5 ; 25.5 ;5;42;42;0;5;1;4;5;0;0;0;5
21235; 20.0 ; 40.1 ; -   ;2;42;267;0;2;1;1;2;0;2;0;0
21236; 76.0 ; 227.9 ; 32.1 ;3;34;205;0;3;0;3;0;3;0;0;3
21237; 52.0 ; 259.8 ; 24.9 ;5;46;41;0;5;0;5;2;3;2;1;2
21238; 25.1 ; 50.1 ; -   ;2;6;5;0;2;0;2;2;0;2;0;0
21239; 64.0 ; 127.9 ; 1.1 ;2;157;0;0;2;0;2;1;1;0;0;2
21240; 38.8 ; 77.7 ; 26.1 ;2;29;174;0;2;0;2;1;1;1;0;1
21241; 92.6 ; 185.3 ; 6.4 ;2;142;93;0;2;2;0;1;1;0;0;2
21242; 123.0 ; 983.6 ; 22.5 ;8;30;26;0;8;1;7;7;1;0;0;8
21243; 34.4 ; 68.9 ; -   ;2;7;380;0;2;2;0;2;0;0;2;0
21244; 36.6 ; 659.4 ; 15.2 ;18;16;0;0;18;5;13;6;12;6;12;0
21245; 35.8 ; 71.7 ; 8.5 ;2;422;0;0;2;0;2;1;1;1;1;0
21246; 49.8 ; 248.8 ; 35.0 ;5;9;186;5;0;4;1;2;3;2;1;2
21247; 74.4 ; 297.5 ; 45.1 ;4;23;199;0;4;1;3;2;2;1;0;3
21248; 25.1 ; 50.1 ; -   ;2;1;276;0;2;1;1;2;0;2;0;0
21249; 49.8 ; 99.6 ; 2.4 ;2;230;11;1;1;1;1;1;1;0;2;0
21250; 18.0 ; 36.1 ; 4.6 ;2;3;173;0;2;1;1;0;2;2;0;0
21251; 44.5 ; 489.4 ; 13.9 ;11;31;113;0;11;3;8;4;7;0;7;4
21252; 23.3 ; 70.0 ; 8.1 ;3;142;10;0;3;0;3;2;1;2;1;0
21253; 24.4 ; 170.9 ; 5.9 ;7;46;2;0;7;3;4;1;6;5;2;0
21254; 47.0 ; 141.0 ; 0.4 ;3;164;74;1;2;0;3;2;1;0;3;0
21255; 17.9 ; 89.3 ; 4.7 ;5;49;64;0;5;0;5;3;2;5;0;0
21256; 37.3 ; 74.6 ; 14.1 ;2;6;215;0;2;0;2;1;1;1;1;0
21257; 39.3 ; 550.0 ; 6.3 ;14;20;5;1;13;2;12;2;12;0;14;0
21258; 33.4 ; 66.8 ; 4.8 ;2;13;62;0;2;0;2;2;0;1;1;0
21259; 40.1 ; 2,004.7 ; 31.2 ;50;5;17;0;50;25;25;13;37;17;16;17
21260; 36.0 ; 72.0 ; 8.7 ;2;346;74;0;2;0;2;2;0;1;1;0
21261; 45.4 ; 1,181.5 ; 11.8 ;26;12;4;0;26;8;18;14;12;0;17;9
21262; 36.6 ; 109.8 ; -   ;3;68;83;0;3;1;2;1;2;0;3;0
21263; 27.9 ; 83.7 ; 5.9 ;3;5;270;0;3;1;2;3;0;2;1;0
21264; 45.6 ; 182.2 ; 20.5 ;4;26;206;2;2;3;1;1;3;1;2;1
21265; 16.5 ; 33.0 ; 2.3 ;2;77;97;0;2;1;1;2;0;2;0;0
21266; 55.6 ; 222.2 ; 27.2 ;4;83;19;0;4;2;2;2;2;1;0;3
21267; 59.7 ; 179.2 ; 12.1 ;3;5;261;0;3;3;0;1;2;0;0;3
21268; 15.0 ; 30.0 ; -   ;2;31;254;0;2;2;0;0;2;2;0;0
21269; 35.6 ; 178.2 ; 9.7 ;5;28;8;0;5;2;3;1;4;2;3;0
21270; 22.5 ; 44.9 ; 11.2 ;2;5;262;0;2;1;1;2;0;1;1;0
21271; 36.9 ; 73.8 ; 17.7 ;2;10;0;0;2;1;1;0;2;1;1;0
21272; 29.0 ; 1,072.8 ; 16.4 ;37;12;10;0;37;16;21;7;30;25;12;0
21273; 37.3 ; 74.6 ; 18.3 ;2;410;16;1;1;0;2;0;2;1;0;1
21274; 71.3 ; 285.1 ; 37.9 ;4;48;99;0;4;1;3;4;0;0;0;4
21275; 36.6 ; 73.2 ; -   ;2;68;170;0;2;2;0;1;1;0;2;0
21276; 41.7 ; 83.4 ; 7.6 ;2;275;115;0;2;1;1;1;1;0;2;0
21277; 47.5 ; 94.9 ; 1.1 ;2;156;11;0;2;0;2;2;0;0;2;0
21278; 44.5 ; 89.0 ; 20.5 ;2;1;43;2;0;1;1;2;0;1;0;1
21279; 39.7 ; 1,072.9 ; 13.7 ;27;14;5;0;27;3;24;14;13;9;18;0
21280; 53.5 ; 106.9 ; 18.8 ;2;132;191;0;2;2;0;0;2;0;1;1
21281; 21.7 ; 108.7 ; 8.1 ;5;31;139;0;5;0;5;1;4;5;0;0
21282; 70.1 ; 140.3 ; 35.0 ;2;3;107;0;2;1;1;1;1;0;0;2
21283; 31.1 ; 529.2 ; 28.0 ;17;14;1;0;17;6;11;6;11;6;5;6
21284; 29.7 ; 59.4 ; 22.0 ;2;37;262;0;2;0;2;1;1;1;1;0
21285; 22.8 ; 45.5 ; 3.4 ;2;260;98;0;2;1;1;1;1;2;0;0
21286; 28.1 ; 140.4 ; 10.5 ;5;73;22;0;5;2;3;2;3;3;2;0
21287; 25.1 ; 100.6 ; 11.4 ;4;40;101;0;4;2;2;2;2;3;1;0
21288; 46.8 ; 93.5 ; -   ;2;195;110;0;2;0;2;2;0;0;2;0
21289; 41.9 ; 125.8 ; 10.6 ;3;134;123;0;3;2;1;1;2;0;3;0
21290; 53.8 ; 107.7 ; 3.4 ;2;37;300;0;2;0;2;0;2;0;1;1
21291; 47.2 ; 283.0 ; 0.4 ;6;46;41;0;6;5;1;2;4;0;6;0
21292; 53.8 ; 161.5 ; 44.4 ;3;31;110;0;3;0;3;2;1;1;1;1
21293; 48.6 ; 145.9 ; 2.2 ;3;76;36;0;3;1;2;3;0;0;3;0
21294; 38.7 ; 116.2 ; 12.6 ;3;162;8;0;3;1;2;1;2;1;2;0
21295; 53.8 ; 215.1 ; 4.9 ;4;111;23;0;4;2;2;4;0;0;3;1
21296; 17.3 ; 34.7 ; 3.5 ;2;3;266;0;2;1;1;2;0;2;0;0
21297; 50.4 ; 100.7 ; 5.4 ;2;262;5;0;2;1;1;2;0;0;1;1
21298; 21.1 ; 42.2 ; -   ;2;12;5;1;1;0;2;1;1;2;0;0
21299; 20.6 ; 41.1 ; 8.4 ;2;16;245;0;2;2;0;0;2;2;0;0
21300; 54.9 ; 823.8 ; 24.3 ;15;19;4;0;15;2;13;12;3;0;10;5
21301; 20.9 ; 438.9 ; 10.1 ;21;11;11;0;21;7;14;5;16;14;7;0
21302; 49.6 ; 99.2 ; 3.2 ;2;3;96;2;0;1;1;2;0;0;2;0
21303; 74.1 ; 296.2 ; 51.1 ;4;45;162;0;4;0;4;3;1;1;0;3
21304; 67.4 ; 134.8 ; 42.1 ;2;10;203;2;0;2;0;0;2;1;0;1
21305; 16.6 ; 33.2 ; 2.4 ;2;15;5;0;2;1;1;2;0;2;0;0
21306; 35.9 ; 71.8 ; 16.2 ;2;47;188;0;2;1;1;0;2;1;1;0
21307; 18.9 ; 605.2 ; 9.2 ;32;8;48;0;32;17;15;13;19;32;0;0
21308; 49.6 ; 99.1 ; 15.6 ;2;6;225;0;2;0;2;2;0;0;1;1
21309; 35.1 ; 175.4 ; 9.8 ;5;45;5;0;5;4;1;1;4;2;3;0
21310; 21.4 ; 149.6 ; 4.7 ;7;30;17;7;0;2;5;0;7;7;0;0
21311; 22.7 ; 227.2 ; 7.2 ;10;22;28;0;10;7;3;4;6;10;0;0
21312; 15.0 ; 30.0 ; -   ;2;2;82;2;0;1;1;2;0;2;0;0
21313; 51.2 ; 153.5 ; 24.1 ;3;82;93;0;3;1;2;3;0;1;1;1
21314; 27.2 ; 81.6 ; 9.2 ;3;82;5;3;0;1;2;1;2;2;1;0
21315; 37.4 ; 523.4 ; 16.0 ;14;9;41;0;14;4;10;11;3;5;9;0
21316; 16.0 ; 79.9 ; 2.3 ;5;63;61;0;5;5;0;5;0;5;0;0
21317; 38.1 ; 190.7 ; 23.8 ;5;26;262;0;5;1;4;3;2;2;1;2
21318; 25.7 ; 256.6 ; 13.7 ;10;18;69;0;10;2;8;4;6;7;3;0
21319; 41.0 ; 450.7 ; 29.8 ;11;33;91;0;11;4;7;3;8;4;3;4
21320; 24.2 ; 120.8 ; 11.7 ;5;44;141;0;5;0;5;2;3;3;2;0
21321; 22.6 ; 45.2 ; 11.4 ;2;23;69;2;0;0;2;0;2;1;1;0
21322; 25.2 ; 327.5 ; 7.8 ;13;21;11;0;13;6;7;3;10;9;4;0
21323; 18.1 ; 126.9 ; 8.0 ;7;6;5;0;7;2;5;3;4;7;0;0
21324; 35.0 ; 70.0 ; 0.9 ;2;93;101;0;2;0;2;1;1;0;2;0
21325; 45.4 ; 680.9 ; 9.3 ;15;29;5;0;15;5;10;4;11;0;15;0
21326; 15.0 ; 30.0 ; -   ;2;15;230;0;2;1;1;0;2;2;0;0
21327; 27.9 ; 55.9 ; 4.9 ;2;4;118;0;2;1;1;1;1;1;1;0
21328; 21.6 ; 43.3 ; 4.6 ;2;27;239;0;2;1;1;1;1;2;0;0
21329; 31.8 ; 63.7 ; 25.2 ;2;4;123;0;2;1;1;1;1;1;0;1
21330; 57.8 ; 346.9 ; 10.7 ;6;38;120;0;6;0;6;5;1;0;0;6
21331; 28.7 ; 286.7 ; 8.9 ;10;5;12;0;10;7;3;8;2;7;3;0
21332; 18.8 ; 75.1 ; 8.0 ;4;5;237;0;4;2;2;4;0;4;0;0
21333; 19.3 ; 57.9 ; 0.7 ;3;23;277;0;3;2;1;3;0;3;0;0
21334; 32.8 ; 131.2 ; 28.1 ;4;37;116;0;4;2;2;2;2;1;2;1
21335; 38.2 ; 191.0 ; 18.6 ;5;38;226;0;5;0;5;3;2;2;1;2
21336; 23.3 ; 535.3 ; 3.6 ;23;17;14;0;23;14;9;17;6;23;0;0
21337; 30.6 ; 122.5 ; 0.5 ;4;32;10;4;0;0;4;4;0;0;4;0
21338; 47.6 ; 666.8 ; 16.8 ;14;15;57;0;14;4;10;10;4;0;9;5
21339; 25.1 ; 50.1 ; -   ;2;40;245;0;2;1;1;1;1;2;0;0
21340; 45.0 ; 90.0 ; 38.5 ;2;43;233;0;2;2;0;1;1;1;0;1
21341; 15.0 ; 30.0 ; -   ;2;107;212;0;2;2;0;1;1;2;0;0
21342; 55.6 ; 388.9 ; 22.5 ;7;9;236;0;7;0;7;4;3;0;0;7
21343; 31.4 ; 156.9 ; 16.1 ;5;32;203;0;5;2;3;0;5;2;3;0
21344; 16.2 ; 81.2 ; 2.1 ;5;69;15;0;5;1;4;1;4;5;0;0
21345; 54.7 ; 109.5 ; 12.0 ;2;82;110;0;2;0;2;2;0;0;1;1
21346; 46.8 ; 749.5 ; 14.3 ;16;17;26;0;16;9;7;11;5;0;11;5
21347; 64.1 ; 320.7 ; 31.4 ;5;41;5;0;5;0;5;3;2;0;0;5
21348; 30.2 ; 272.0 ; 21.5 ;9;14;40;0;9;4;5;2;7;3;6;0
21349; 41.5 ; 83.1 ; 10.6 ;2;20;218;0;2;2;0;2;0;0;2;0
21350; 18.2 ; 255.3 ; 3.6 ;14;10;17;14;0;6;8;7;7;14;0;0
21351; 62.5 ; 125.0 ; 14.9 ;2;75;199;0;2;0;2;2;0;0;0;2
21352; 21.4 ; 171.4 ; 9.3 ;8;28;33;0;8;5;3;5;3;5;3;0
21353; 49.7 ; 199.0 ; 23.8 ;4;41;204;0;4;1;3;3;1;1;2;1
21354; 16.4 ; 32.8 ; 2.1 ;2;53;154;0;2;2;0;1;1;2;0;0
21355; 35.8 ; 179.1 ; 4.8 ;5;39;105;0;5;0;5;2;3;0;5;0
21356; 47.0 ; 423.2 ; 18.5 ;9;8;20;0;9;3;6;8;1;3;3;3
21357; 30.6 ; 61.2 ; 14.7 ;2;31;116;0;2;0;2;2;0;1;1;0
21358; 64.4 ; 257.7 ; 20.4 ;4;52;89;0;4;1;3;2;2;0;0;4
21359; 64.4 ; 257.8 ; 32.7 ;4;116;86;0;4;3;1;1;3;0;0;4
21360; 47.5 ; 94.9 ; -   ;2;4;89;0;2;1;1;1;1;0;2;0
21361; 37.3 ; 74.6 ; 18.3 ;2;119;190;0;2;0;2;0;2;1;0;1
21362; 18.6 ; 55.7 ; 6.6 ;3;58;103;3;0;1;2;3;0;3;0;0
21363; 38.3 ; 229.9 ; 4.8 ;6;59;22;3;3;1;5;1;5;0;6;0
21364; 48.6 ; 145.9 ; 1.7 ;3;10;216;0;3;2;1;3;0;0;3;0
21365; 36.3 ; 253.9 ; 22.3 ;7;60;26;0;7;3;4;4;3;2;3;2
21366; 51.5 ; 154.5 ; 30.8 ;3;36;202;0;3;1;2;2;1;1;1;1
21367; 24.8 ; 74.3 ; 9.5 ;3;5;254;0;3;2;1;3;0;2;1;0
21368; 42.6 ; 85.3 ; 9.1 ;2;14;106;2;0;1;1;0;2;0;2;0
21369; 69.7 ; 139.5 ; 35.6 ;2;148;63;1;1;1;1;1;1;0;0;2
21370; 28.4 ; 85.2 ; 3.1 ;3;107;15;0;3;1;2;2;1;2;1;0
21371; 26.6 ; 106.6 ; 11.2 ;4;26;2;0;4;2;2;4;0;3;1;0
21372; 33.2 ; 332.2 ; 16.2 ;10;28;72;0;10;4;6;4;6;3;7;0
21373; 50.1 ; 150.3 ; 12.5 ;3;59;141;0;3;0;3;0;3;0;2;1
21374; 41.3 ; 123.9 ; 6.5 ;3;18;22;0;3;0;3;3;0;0;3;0
21375; 35.6 ; 284.6 ; 12.9 ;8;29;78;0;8;1;7;2;6;3;5;0
21376; 42.9 ; 85.7 ; -   ;2;32;284;0;2;0;2;0;2;0;2;0
21377; 40.8 ; 81.6 ; 10.0 ;2;86;2;2;0;1;1;0;2;0;2;0
21378; 65.5 ; 262.0 ; 42.2 ;4;57;70;3;1;2;2;2;2;1;0;3
21379; 15.0 ; 59.9 ; -   ;4;14;242;0;4;1;3;2;2;4;0;0
21380; 35.1 ; 245.7 ; 18.6 ;7;18;61;0;7;3;4;2;5;2;5;0
21381; 45.1 ; 135.2 ; 13.7 ;3;41;207;0;3;3;0;3;0;0;2;1
21382; 60.3 ; 723.6 ; 12.6 ;12;30;2;0;12;8;4;3;9;0;0;12
21383; 28.7 ; 57.3 ; 11.9 ;2;19;241;0;2;0;2;2;0;1;1;0
21384; 46.3 ; 231.7 ; 29.5 ;5;57;162;0;5;2;3;3;2;2;1;2
21385; 38.8 ; 77.7 ; 12.9 ;2;2;75;2;0;2;0;0;2;1;1;0
21386; 26.6 ; 133.2 ; 9.2 ;5;41;75;0;5;1;4;2;3;3;2;0
21387; 41.5 ; 207.4 ; 5.4 ;5;32;178;0;5;0;5;4;1;0;5;0
21388; 42.8 ; 984.1 ; 25.5 ;23;11;2;0;23;15;8;11;12;8;7;8
21389; 67.1 ; 268.4 ; 24.6 ;4;105;110;0;4;1;3;2;2;0;0;4
21390; 46.8 ; 93.5 ; -   ;2;87;147;0;2;0;2;2;0;0;2;0
21391; 46.8 ; 93.5 ; -   ;2;16;248;0;2;0;2;1;1;0;2;0
21392; 33.8 ; 203.0 ; 12.5 ;6;51;122;0;6;1;5;5;1;2;4;0
21393; 33.2 ; 165.8 ; 10.3 ;5;40;4;0;5;1;4;2;3;2;3;0
21394; 57.7 ; 288.3 ; 26.6 ;5;33;79;0;5;0;5;5;0;0;0;5
21395; 35.9 ; 71.8 ; 16.2 ;2;239;165;0;2;2;0;0;2;1;1;0
21396; 34.7 ; 173.5 ; 14.2 ;5;32;63;0;5;0;5;2;3;2;3;0
21397; 36.6 ; 73.2 ; -   ;2;80;69;0;2;0;2;2;0;0;2;0
21398; 26.8 ; 80.3 ; 3.1 ;3;87;105;0;3;1;2;1;2;3;0;0
21399; 27.7 ; 249.7 ; 9.4 ;9;5;63;0;9;1;8;9;0;6;3;0
21400; 24.8 ; 273.1 ; 12.5 ;11;29;6;0;11;3;8;5;6;7;4;0
21401; 51.1 ; 255.7 ; 14.0 ;5;57;5;0;5;1;4;3;2;0;3;2
21402; 19.7 ; 98.3 ; -   ;5;7;275;0;5;4;1;3;2;5;0;0
21403; 20.0 ; 320.3 ; 7.3 ;16;23;7;0;16;5;11;5;11;16;0;0
21404; 79.5 ; 238.5 ; 57.7 ;3;76;57;2;1;1;2;1;2;1;0;2
21405; 20.0 ; 80.1 ; 6.2 ;4;36;182;0;4;2;2;0;4;4;0;0
21406; 26.7 ; 80.2 ; 7.8 ;3;198;24;0;3;3;0;2;1;2;1;0
21407; 56.2 ; 224.7 ; 7.1 ;4;40;220;0;4;1;3;3;1;0;0;4
21408; 41.4 ; 165.5 ; 14.1 ;4;6;155;0;4;4;0;2;2;1;2;1
21409; 61.3 ; 245.1 ; 5.7 ;4;51;12;0;4;3;1;1;3;0;0;4
21410; 93.9 ; 375.6 ; 35.0 ;4;27;309;0;4;0;4;4;0;0;0;4
21411; 67.4 ; 134.7 ; 20.1 ;2;107;10;2;0;0;2;0;2;0;0;2
21412; 37.8 ; 1,551.2 ; 14.6 ;41;5;38;0;41;8;33;14;27;14;27;0
21413; 35.2 ; 175.8 ; 6.3 ;5;17;194;0;5;3;2;3;2;2;3;0
21414; 39.5 ; 157.8 ; 13.9 ;4;40;54;1;3;2;2;4;0;1;3;0
21415; 19.8 ; 39.7 ; 1.9 ;2;5;104;2;0;2;0;2;0;2;0;0
21416; 43.4 ; 130.2 ; 12.4 ;3;40;97;3;0;2;1;1;2;0;2;1
21417; 51.9 ; 259.3 ; 22.8 ;5;82;47;0;5;0;5;3;2;2;1;2
21418; 32.3 ; 226.0 ; 5.8 ;7;18;16;0;7;3;4;4;3;2;5;0
21419; 38.8 ; 77.7 ; 12.9 ;2;192;58;2;0;1;1;0;2;1;1;0
21420; 41.4 ; 82.7 ; 16.7 ;2;34;250;0;2;1;1;1;1;1;0;1
21421; 39.1 ; 117.3 ; 13.3 ;3;47;41;0;3;0;3;2;1;1;2;0
21422; 56.6 ; 283.2 ; 24.8 ;5;57;46;0;5;0;5;1;4;0;0;5
21423; 39.4 ; 197.1 ; 15.6 ;5;25;125;0;5;3;2;2;3;2;1;2
21424; 32.5 ; 162.6 ; 11.4 ;5;16;126;0;5;2;3;3;2;2;3;0
21425; 44.6 ; 89.1 ; 11.9 ;2;101;178;0;2;0;2;2;0;0;1;1
21426; 26.5 ; 423.5 ; 10.4 ;16;16;139;0;16;7;9;1;15;11;5;0
21427; 46.8 ; 93.5 ; -   ;2;66;108;2;0;1;1;0;2;0;2;0
21428; 59.2 ; 118.4 ; 2.6 ;2;5;268;0;2;0;2;0;2;0;0;2
21429; 36.3 ; 72.5 ; 16.8 ;2;173;80;0;2;1;1;0;2;1;1;0
21430; 53.9 ; 970.6 ; 23.3 ;18;14;5;0;18;3;15;4;14;0;12;6
21431; 63.5 ; 253.9 ; 15.7 ;4;100;41;0;4;2;2;2;2;0;0;4
21432; 26.0 ; 104.0 ; 12.5 ;4;36;171;0;4;4;0;3;1;3;1;0
21433; 17.7 ; 35.4 ; 4.1 ;2;3;280;0;2;2;0;0;2;2;0;0
21434; 24.1 ; 217.1 ; 27.3 ;9;7;254;0;9;4;5;2;7;6;3;0
21435; 55.0 ; 384.8 ; 20.6 ;7;27;110;0;7;1;6;3;4;0;5;2
21436; 29.6 ; 59.3 ; 6.8 ;2;102;51;0;2;1;1;0;2;1;1;0
21437; 105.3 ; 210.7 ; 6.6 ;2;168;79;0;2;0;2;2;0;0;0;2
21438; 41.5 ; 415.1 ; 32.1 ;10;22;147;0;10;4;6;9;1;3;4;3
21439; 94.1 ; 376.2 ; 8.6 ;4;73;89;0;4;0;4;4;0;0;0;4
21440; 58.9 ; 117.8 ; 6.6 ;2;6;89;0;2;0;2;2;0;0;0;2
21441; 38.7 ; 271.1 ; 13.5 ;7;18;129;0;7;4;3;2;5;2;5;0
21442; 34.6 ; 242.4 ; 14.9 ;7;12;9;0;7;2;5;4;3;2;5;0
21443; 29.9 ; 507.6 ; 19.6 ;17;9;14;0;17;7;10;12;5;11;6;0
21444; 33.4 ; 66.8 ; 4.8 ;2;66;29;0;2;1;1;2;0;1;1;0
21445; 46.0 ; 230.2 ; 22.6 ;5;34;56;0;5;3;2;3;2;2;1;2
21446; 95.0 ; 1,140.4 ; 23.5 ;12;19;10;0;12;0;12;9;3;0;0;12
21447; 41.7 ; 83.4 ; 7.6 ;2;49;122;0;2;0;2;2;0;0;2;0
21448; 37.7 ; 75.5 ; 29.6 ;2;29;94;0;2;1;1;2;0;1;0;1
21449; 26.6 ; 79.8 ; 7.9 ;3;6;22;0;3;1;2;3;0;2;1;0
21450; 46.7 ; 420.5 ; 34.0 ;9;36;15;0;9;3;6;7;2;3;3;3
21451; 15.0 ; 30.0 ; -   ;2;3;43;0;2;1;1;0;2;2;0;0
21452; 37.2 ; 74.4 ; 28.2 ;2;88;84;0;2;0;2;2;0;1;0;1
21453; 58.0 ; 174.0 ; 15.6 ;3;41;157;0;3;0;3;1;2;0;0;3
21454; 40.8 ; 1,223.5 ; 11.3 ;30;14;9;0;30;17;13;7;23;10;20;0
21455; 45.3 ; 316.8 ; 19.8 ;7;38;20;0;7;1;6;0;7;2;3;2
21456; 44.2 ; 88.4 ; 4.9 ;2;214;83;0;2;2;0;1;1;0;2;0
21457; 45.7 ; 137.1 ; 2.6 ;3;97;68;0;3;0;3;3;0;0;3;0
21458; 29.3 ; 117.2 ; 2.1 ;4;4;217;0;4;1;3;1;3;3;1;0
21459; 38.2 ; 114.5 ; 11.5 ;3;65;79;0;3;1;2;1;2;1;2;0
21460; 37.6 ; 187.8 ; 12.6 ;5;23;257;0;5;2;3;3;2;2;3;0
21461; 51.6 ; 258.2 ; 5.7 ;5;31;31;0;5;0;5;3;2;0;3;2
21462; 59.5 ; 118.9 ; 6.2 ;2;178;251;0;2;1;1;2;0;0;0;2
21463; 27.9 ; 139.3 ; 5.4 ;5;24;34;0;5;2;3;1;4;3;2;0
21464; 82.3 ; 246.8 ; 103.1 ;3;65;99;1;2;1;2;3;0;1;0;2
21465; 53.2 ; 106.3 ; 35.6 ;2;8;263;0;2;1;1;2;0;1;0;1
21466; 33.8 ; 202.5 ; 8.5 ;6;33;6;2;4;1;5;2;4;2;4;0
21467; 21.6 ; 86.2 ; 10.9 ;4;7;253;0;4;1;3;1;3;3;1;0
21468; 26.9 ; 268.5 ; 7.8 ;10;25;23;0;10;2;8;6;4;7;3;0
21469; 43.4 ; 86.8 ; 13.6 ;2;8;278;0;2;0;2;2;0;1;0;1
21470; 64.7 ; 582.1 ; 11.2 ;9;48;20;0;9;0;9;9;0;0;0;9
21471; 31.2 ; 62.5 ; 24.3 ;2;4;71;2;0;1;1;0;2;1;0;1
21472; 27.7 ; 110.8 ; 15.1 ;4;27;167;0;4;0;4;2;2;3;1;0
21473; 55.6 ; 166.7 ; 45.8 ;3;9;299;0;3;0;3;3;0;1;0;2
21474; 26.1 ; 104.3 ; 15.0 ;4;27;256;0;4;1;3;3;1;3;1;0
21475; 46.2 ; 92.5 ; 8.0 ;2;94;32;0;2;0;2;1;1;0;2;0
21476; 67.0 ; 134.0 ; 14.2 ;2;1;250;0;2;1;1;0;2;0;0;2
21477; 34.7 ; 138.9 ; 2.4 ;4;54;67;0;4;3;1;2;2;0;4;0
21478; 37.1 ; 333.5 ; 14.9 ;9;26;48;0;9;0;9;6;3;3;6;0
21479; 22.5 ; 44.9 ; 11.2 ;2;27;224;0;2;1;1;0;2;1;1;0
21480; 32.8 ; 164.2 ; 10.2 ;5;17;184;0;5;1;4;3;2;2;3;0
21481; 25.1 ; 100.3 ; -   ;4;3;40;0;4;1;3;2;2;4;0;0
21482; 15.7 ; 204.2 ; 2.9 ;13;15;8;0;13;1;12;10;3;13;0;0
21483; 19.5 ; 97.5 ; 3.2 ;5;14;221;0;5;1;4;2;3;5;0;0
21484; 30.1 ; 180.8 ; 14.7 ;6;57;73;0;6;3;3;2;4;2;4;0
21485; 32.3 ; 96.9 ; 14.3 ;3;32;116;1;2;1;2;1;2;1;2;0
21486; 38.6 ; 540.9 ; 13.2 ;14;21;8;0;14;9;5;8;6;5;9;0
21487; 56.8 ; 283.8 ; 22.6 ;5;62;88;0;5;2;3;3;2;0;0;5
21488; 30.8 ; 154.1 ; 6.2 ;5;22;283;0;5;2;3;2;3;2;3;0
21489; 24.9 ; 323.5 ; 7.9 ;13;10;120;0;13;7;6;2;11;9;4;0
21490; 15.0 ; 104.9 ; -   ;7;7;390;0;7;2;5;3;4;7;0;0
21491; 24.7 ; 74.0 ; 9.2 ;3;14;231;0;3;2;1;1;2;2;1;0
21492; 29.9 ; 59.7 ; 7.2 ;2;181;17;0;2;0;2;0;2;1;1;0
21493; 23.3 ; 46.6 ; 10.3 ;2;59;8;2;0;1;1;2;0;1;1;0
21494; 36.5 ; 766.5 ; 19.3 ;21;18;3;0;21;15;6;9;12;7;7;7
21495; 47.9 ; 143.6 ; 7.2 ;3;32;62;3;0;0;3;3;0;0;2;1
21496; 34.0 ; 67.9 ; 13.3 ;2;20;115;0;2;0;2;0;2;1;1;0
21497; 38.3 ; 76.7 ; 2.6 ;2;43;244;0;2;2;0;0;2;0;2;0
21498; 37.0 ; 111.0 ; 11.2 ;3;15;204;0;3;0;3;1;2;1;2;0
21499; 56.6 ; 113.2 ; 11.9 ;2;6;178;0;2;0;2;2;0;0;0;2
21500; 41.5 ; 165.9 ; 6.0 ;4;7;220;0;4;2;2;2;2;0;4;0
21501; 29.9 ; 328.9 ; 8.7 ;11;29;6;0;11;0;11;3;8;7;4;0
21502; 25.1 ; 50.1 ; -   ;2;100;15;0;2;0;2;2;0;2;0;0
21503; 28.0 ; 168.0 ; 3.6 ;6;36;37;0;6;1;5;0;6;4;2;0
21504; 28.0 ; 55.9 ; 19.4 ;2;83;162;1;1;0;2;0;2;1;1;0
21505; 30.9 ; 216.4 ; 22.6 ;7;19;314;0;7;0;7;7;0;2;5;0
21506; 15.0 ; 59.9 ; -   ;4;31;158;0;4;3;1;1;3;4;0;0
21507; 15.0 ; 149.9 ; -   ;10;7;2;0;10;7;3;9;1;10;0;0
21508; 40.4 ; 202.2 ; 17.3 ;5;35;21;0;5;1;4;1;4;2;1;2
21509; 18.3 ; 806.7 ; 6.6 ;44;9;4;0;44;19;25;26;18;44;0;0
21510; 29.7 ; 148.5 ; 6.9 ;5;35;250;0;5;2;3;1;4;3;2;0
21511; 33.5 ; 167.5 ; 7.8 ;5;13;262;0;5;2;3;2;3;2;3;0
21512; 37.7 ; 188.5 ; 43.7 ;5;25;75;5;0;2;3;5;0;2;1;2
21513; 50.1 ; 551.0 ; 11.9 ;11;28;26;0;11;3;8;4;7;0;7;4
21514; 45.2 ; 180.9 ; 1.9 ;4;76;11;0;4;2;2;1;3;0;4;0
21515; 35.1 ; 175.4 ; 12.7 ;5;21;0;2;3;2;3;1;4;2;3;0
21516; 22.8 ; 68.3 ; 7.7 ;3;83;29;0;3;1;2;2;1;2;1;0
21517; 34.7 ; 138.7 ; 16.2 ;4;74;110;0;4;2;2;4;0;1;3;0
21518; 21.9 ; 109.7 ; 9.7 ;5;32;58;0;5;1;4;2;3;3;2;0
21519; 36.6 ; 73.2 ; -   ;2;5;278;0;2;0;2;1;1;0;2;0
21520; 33.6 ; 67.3 ; 12.8 ;2;191;91;0;2;2;0;1;1;1;1;0
21521; 58.3 ; 116.6 ; 22.1 ;2;195;47;2;0;0;2;1;1;0;0;2
21522; 51.8 ; 103.6 ; 7.6 ;2;44;68;0;2;0;2;2;0;0;1;1
21523; 46.3 ; 231.7 ; 10.5 ;5;49;112;0;5;2;3;3;2;0;3;2
21524; 15.0 ; 30.0 ; -   ;2;6;299;0;2;0;2;1;1;2;0;0
21525; 53.2 ; 106.4 ; 5.4 ;2;76;101;2;0;1;1;2;0;0;1;1
21526; 32.4 ; 421.7 ; 17.1 ;13;37;14;0;13;10;3;13;0;4;9;0
21527; 33.7 ; 101.1 ; 12.2 ;3;60;57;1;2;1;2;1;2;1;2;0
21528; 37.5 ; 112.4 ; 20.6 ;3;158;44;0;3;1;2;3;0;1;1;1
21529; 28.8 ; 86.5 ; 2.5 ;3;53;221;0;3;1;2;3;0;2;1;0
21530; 38.2 ; 267.1 ; 16.4 ;7;44;21;0;7;0;7;5;2;2;5;0
21531; 50.5 ; 101.1 ; 4.6 ;2;36;32;0;2;0;2;2;0;0;1;1
21532; 37.1 ; 222.7 ; 14.4 ;6;69;35;0;6;2;4;6;0;2;4;0
21533; 27.7 ; 637.3 ; 13.1 ;23;14;22;0;23;8;15;12;11;15;8;0
21534; 23.6 ; 118.2 ; 8.5 ;5;31;80;0;5;3;2;0;5;3;2;0
21535; 47.5 ; 94.9 ; -   ;2;5;95;2;0;0;2;2;0;0;2;0
21536; 39.3 ; 707.8 ; 9.7 ;18;17;2;0;18;9;9;7;11;6;12;0
21537; 86.2 ; 172.4 ; 56.1 ;2;2;193;2;0;1;1;0;2;0;0;2
21538; 47.5 ; 94.9 ; 1.1 ;2;176;5;0;2;0;2;1;1;0;2;0
21539; 31.3 ; 93.9 ; 17.9 ;3;9;22;0;3;1;2;0;3;1;2;0
21540; 68.3 ; 683.1 ; 32.2 ;10;8;44;0;10;3;7;8;2;0;0;10
21541; 23.0 ; 160.8 ; 17.5 ;7;23;70;0;7;1;6;4;3;5;2;0
21542; 83.6 ; 167.3 ; 11.2 ;2;39;47;0;2;0;2;1;1;0;0;2
21543; 32.5 ; 97.5 ; 17.7 ;3;239;3;0;3;3;0;3;0;1;2;0
21544; 31.1 ; 93.2 ; 29.5 ;3;128;41;0;3;1;2;2;1;1;1;1
21545; 34.3 ; 343.5 ; 20.2 ;10;27;38;0;10;7;3;1;9;3;7;0
21546; 77.1 ; 231.2 ; 70.9 ;3;38;98;0;3;3;0;1;2;1;0;2
21547; 18.0 ; 36.1 ; 4.6 ;2;27;116;0;2;1;1;0;2;2;0;0
21548; 15.9 ; 31.8 ; 1.4 ;2;1;269;0;2;1;1;0;2;2;0;0
21549; 65.6 ; 262.6 ; 27.5 ;4;63;11;0;4;0;4;3;1;0;0;4
21550; 65.1 ; 585.8 ; 13.8 ;9;23;10;0;9;0;9;9;0;0;0;9
21551; 30.1 ; 150.7 ; 11.0 ;5;48;68;0;5;0;5;3;2;2;3;0
21552; 33.1 ; 99.4 ; 18.6 ;3;32;232;0;3;0;3;0;3;1;2;0
21553; 17.2 ; 188.7 ; 5.5 ;11;4;0;0;11;5;6;5;6;11;0;0
21554; 49.8 ; 199.0 ; 17.7 ;4;56;84;0;4;2;2;1;3;0;3;1
21555; 31.6 ; 63.1 ; 21.6 ;2;77;183;0;2;0;2;0;2;1;1;0
21556; 70.7 ; 353.7 ; 22.3 ;5;26;14;0;5;4;1;4;1;0;0;5
21557; 36.5 ; 255.7 ; 8.2 ;7;47;34;0;7;2;5;4;3;2;5;0
21558; 51.8 ; 310.7 ; 3.5 ;6;41;62;0;6;0;6;5;1;0;4;2
21559; 47.5 ; 94.9 ; -   ;2;14;87;0;2;1;1;1;1;0;2;0
21560; 34.4 ; 68.9 ; 5.4 ;2;46;35;2;0;1;1;0;2;1;1;0
21561; 48.4 ; 242.0 ; 29.6 ;5;12;53;0;5;1;4;3;2;2;1;2
21562; 17.1 ; 120.0 ; 3.8 ;7;18;181;0;7;5;2;7;0;7;0;0
21563; 79.6 ; 159.1 ; 11.6 ;2;197;26;0;2;1;1;1;1;0;0;2
21564; 23.9 ; 430.5 ; 7.8 ;18;18;5;0;18;6;12;7;11;12;6;0
21565; 38.4 ; 192.2 ; 21.8 ;5;50;83;0;5;2;3;3;2;2;1;2
21566; 17.0 ; 238.4 ; 4.2 ;14;5;1;0;14;9;5;3;11;14;0;0
21567; 68.0 ; 272.1 ; 14.9 ;4;77;10;0;4;0;4;3;1;0;0;4
21568; 17.6 ; 403.9 ; 6.3 ;23;7;4;0;23;9;14;8;15;23;0;0
21569; 24.1 ; 144.4 ; 16.4 ;6;14;128;0;6;4;2;2;4;4;2;0
21570; 70.4 ; 492.7 ; 18.4 ;7;19;49;0;7;3;4;7;0;0;0;7
21571; 78.4 ; 156.9 ; 46.4 ;2;11;90;0;2;0;2;1;1;0;0;2
21572; 59.5 ; 416.6 ; 22.1 ;7;37;36;0;7;0;7;7;0;0;0;7
21573; 27.6 ; 55.3 ; 3.8 ;2;48;234;0;2;1;1;2;0;1;1;0
21574; 52.2 ; 208.7 ; 20.8 ;4;14;278;0;4;1;3;3;1;0;3;1
21575; 42.0 ; 294.0 ; 13.0 ;7;37;53;1;6;0;7;6;1;2;5;0
21576; 25.1 ; 50.1 ; -   ;2;86;191;0;2;1;1;1;1;2;0;0
21577; 35.7 ; 71.3 ; 23.8 ;2;34;240;0;2;1;1;0;2;1;0;1
21578; 46.8 ; 140.3 ; -   ;3;13;242;0;3;0;3;3;0;0;3;0
21579; 30.1 ; 60.2 ; 5.9 ;2;29;243;0;2;1;1;2;0;1;1;0
21580; 44.0 ; 176.2 ; 10.5 ;4;28;4;0;4;3;1;2;2;0;4;0
21581; 46.8 ; 93.5 ; -   ;2;93;284;0;2;1;1;2;0;0;2;0
21582; 44.0 ; 263.8 ; 10.2 ;6;31;41;0;6;1;5;6;0;0;6;0
21583; 18.4 ; 1,585.5 ; 5.2 ;86;2;0;0;86;2;84;53;33;86;0;0
21584; 59.6 ; 119.2 ; 2.9 ;2;195;73;0;2;0;2;1;1;0;0;2
21585; 56.4 ; 169.1 ; 0.4 ;3;68;53;0;3;1;2;1;2;0;0;3
21586; 36.0 ; 360.1 ; 10.4 ;10;28;5;0;10;5;5;2;8;3;7;0
21587; 17.2 ; 34.4 ; 3.3 ;2;74;180;0;2;1;1;1;1;2;0;0
21588; 47.8 ; 238.8 ; 3.9 ;5;59;10;0;5;1;4;4;1;0;5;0
21589; 98.3 ; 196.6 ; 1.6 ;2;19;324;0;2;2;0;1;1;0;0;2
21590; 36.6 ; 73.2 ; -   ;2;26;342;0;2;1;1;0;2;0;2;0
21591; 48.7 ; 341.1 ; 14.2 ;7;38;58;0;7;2;5;4;3;0;5;2
21592; 51.9 ; 207.7 ; 6.3 ;4;11;270;0;4;3;1;3;1;0;3;1
21593; 56.9 ; 284.7 ; 11.1 ;5;55;64;0;5;2;3;1;4;0;0;5
21594; 47.8 ; 334.9 ; 46.0 ;7;30;212;0;7;5;2;5;2;2;3;2
21595; 59.0 ; 176.9 ; 21.8 ;3;112;36;0;3;1;2;1;2;0;0;3
21596; 53.2 ; 478.4 ; 18.5 ;9;28;55;0;9;3;6;5;4;0;6;3
21597; 26.5 ; 212.2 ; 17.0 ;8;16;42;0;8;1;7;8;0;5;3;0
21598; 33.7 ; 606.3 ; 21.0 ;18;22;38;0;18;3;15;14;4;6;12;0
21599; 25.1 ; 50.1 ; -   ;2;48;23;0;2;1;1;2;0;2;0;0
21600; 61.2 ; 306.1 ; 13.6 ;5;15;22;1;4;0;5;2;3;0;0;5
21601; 51.0 ; 102.1 ; 2.2 ;2;27;242;0;2;1;1;0;2;0;2;0
21602; 31.4 ; 62.7 ; 9.4 ;2;278;2;0;2;2;0;0;2;1;1;0
21603; 88.5 ; 1,682.3 ; 26.4 ;19;18;10;0;19;9;10;12;7;0;0;19
21604; 34.3 ; 239.8 ; 28.6 ;7;23;40;0;7;2;5;5;2;2;3;2
21605; 45.0 ; 135.0 ; 30.6 ;3;5;59;0;3;1;2;1;2;1;1;1
21606; 37.3 ; 186.7 ; 6.4 ;5;48;234;0;5;2;3;3;2;0;5;0
21607; 44.1 ; 220.3 ; 16.9 ;5;51;60;0;5;1;4;2;3;2;1;2
21608; 41.6 ; 623.9 ; 9.4 ;15;20;14;0;15;9;6;8;7;0;15;0
21609; 15.0 ; 59.9 ; -   ;4;47;56;0;4;2;2;2;2;4;0;0
21610; 50.0 ; 149.9 ; 2.3 ;3;81;81;0;3;1;2;2;1;0;3;0
21611; 50.8 ; 152.4 ; 6.1 ;3;24;21;0;3;1;2;1;2;0;2;1
21612; 27.9 ; 139.4 ; 9.3 ;5;31;89;0;5;3;2;2;3;3;2;0
21613; 40.3 ; 564.4 ; 17.4 ;14;21;5;0;14;4;10;12;2;5;4;5
21614; 16.8 ; 33.6 ; 2.7 ;2;26;377;0;2;0;2;0;2;2;0;0
21615; 53.6 ; 267.8 ; 5.4 ;5;78;6;0;5;0;5;1;4;0;3;2
21616; 69.7 ; 348.4 ; 16.0 ;5;41;36;0;5;0;5;5;0;0;0;5
21617; 36.7 ; 73.3 ; 5.1 ;2;39;183;0;2;0;2;2;0;0;2;0
21618; 45.6 ; 91.3 ; 0.3 ;2;52;159;0;2;2;0;2;0;0;2;0
21619; 49.5 ; 395.8 ; 32.5 ;8;29;79;0;8;2;6;4;4;3;2;3
21620; 46.6 ; 93.1 ; 1.4 ;2;5;43;1;1;0;2;1;1;0;2;0
21621; 38.9 ; 699.7 ; 16.5 ;18;18;41;0;18;0;18;16;2;6;6;6
21622; 25.6 ; 76.7 ; 19.4 ;3;5;283;0;3;2;1;2;1;2;1;0
21623; 45.9 ; 137.6 ; 4.1 ;3;90;17;0;3;1;2;2;1;0;3;0
21624; 20.2 ; 121.5 ; 9.7 ;6;32;53;0;6;4;2;3;3;6;0;0
21625; 34.0 ; 67.9 ; 13.3 ;2;126;158;0;2;0;2;1;1;1;1;0
21626; 82.8 ; 414.2 ; 37.4 ;5;22;141;0;5;0;5;3;2;0;0;5
21627; 58.4 ; 175.1 ; 10.3 ;3;47;0;0;3;0;3;3;0;0;0;3
21628; 32.3 ; 96.9 ; 13.3 ;3;6;267;0;3;0;3;3;0;1;2;0
21629; 53.3 ; 213.1 ; 12.0 ;4;94;41;3;1;3;1;2;2;0;3;1
21630; 34.2 ; 136.7 ; 11.9 ;4;44;62;0;4;1;3;4;0;1;3;0
21631; 46.6 ; 233.0 ; 35.6 ;5;27;10;0;5;1;4;4;1;2;1;2
21632; 28.8 ; 259.5 ; 17.2 ;9;29;1;0;9;5;4;7;2;6;3;0
21633; 24.1 ; 240.8 ; 16.1 ;10;25;53;0;10;2;8;4;6;7;3;0
21634; 23.8 ; 190.6 ; 6.4 ;8;35;26;0;8;4;4;5;3;5;3;0
21635; 44.6 ; 624.5 ; 11.1 ;14;18;8;0;14;6;8;12;2;0;9;5
21636; 34.1 ; 68.2 ; 13.5 ;2;25;125;0;2;0;2;1;1;1;1;0
21637; 52.4 ; 104.8 ; 0.2 ;2;29;262;0;2;1;1;0;2;0;2;0
21638; 17.5 ; 280.0 ; 5.2 ;16;13;8;9;7;13;3;15;1;16;0;0
21639; 58.0 ; 290.2 ; 22.8 ;5;15;98;0;5;2;3;3;2;0;0;5
21640; 34.4 ; 309.5 ; 6.0 ;9;32;26;0;9;2;7;2;7;3;6;0
21641; 46.8 ; 93.5 ; -   ;2;27;160;0;2;1;1;0;2;0;2;0
21642; 30.2 ; 60.4 ; -   ;2;64;258;0;2;1;1;2;0;0;2;0
21643; 47.7 ; 95.4 ; 7.2 ;2;18;142;0;2;0;2;2;0;0;2;0
21644; 40.6 ; 203.0 ; 11.1 ;5;93;5;0;5;1;4;2;3;2;3;0
21645; 47.8 ; 191.3 ; 0.4 ;4;24;8;0;4;1;3;2;2;0;4;0
21646; 53.6 ; 268.0 ; 7.5 ;5;59;31;0;5;1;4;3;2;0;3;2
21647; 43.3 ; 130.0 ; 12.1 ;3;78;97;0;3;3;0;1;2;0;2;1
21648; 36.4 ; 145.6 ; 13.9 ;4;70;86;0;4;4;0;4;0;1;3;0
21649; 72.2 ; 505.3 ; 38.5 ;7;20;11;0;7;0;7;6;1;0;0;7
21650; 47.9 ; 670.4 ; 11.3 ;14;29;26;0;14;5;9;4;10;0;9;5
21651; 25.1 ; 50.1 ; -   ;2;41;16;0;2;1;1;2;0;2;0;0
21652; 40.8 ; 204.2 ; 10.3 ;5;13;5;5;0;0;5;3;2;0;5;0
21653; 25.2 ; 125.9 ; 16.7 ;5;74;62;0;5;0;5;2;3;3;2;0
21654; 36.6 ; 73.2 ; -   ;2;99;46;0;2;2;0;0;2;0;2;0
21655; 32.3 ; 194.0 ; 17.8 ;6;28;99;0;6;1;5;3;3;2;4;0
21656; 15.9 ; 143.1 ; 2.2 ;9;30;52;0;9;0;9;2;7;9;0;0
21657; 21.5 ; 107.6 ; 12.5 ;5;34;156;0;5;5;0;5;0;3;2;0
21658; 16.9 ; 84.5 ; 4.3 ;5;24;0;0;5;1;4;0;5;5;0;0
21659; 24.0 ; 215.7 ; 10.7 ;9;32;1;0;9;1;8;5;4;6;3;0
21660; 38.2 ; 267.2 ; 20.5 ;7;25;230;0;7;2;5;6;1;2;3;2
21661; 27.6 ; 55.3 ; 3.8 ;2;165;160;0;2;2;0;1;1;1;1;0
21662; 47.5 ; 379.9 ; 25.1 ;8;53;26;0;8;0;8;3;5;3;2;3
21663; 46.8 ; 93.5 ; -   ;2;245;168;0;2;0;2;2;0;0;2;0
21664; 41.2 ; 123.7 ; 10.1 ;3;40;268;0;3;2;1;2;1;0;3;0
21665; 56.0 ; 167.9 ; -   ;3;32;36;0;3;0;3;3;0;0;0;3
21666; 26.9 ; 80.7 ; 18.9 ;3;56;5;0;3;0;3;1;2;2;1;0
21667; 30.6 ; 122.5 ; 11.9 ;4;20;199;0;4;2;2;1;3;1;3;0
21668; 22.2 ; 66.6 ; 13.2 ;3;137;38;0;3;2;1;1;2;2;1;0
21669; 66.0 ; 329.9 ; 13.8 ;5;96;5;0;5;0;5;5;0;0;0;5
21670; 49.8 ; 696.7 ; 6.4 ;14;20;2;0;14;11;3;3;11;0;9;5
21671; 27.0 ; 108.1 ; 8.9 ;4;59;126;0;4;1;3;2;2;3;1;0
21672; 46.8 ; 93.5 ; -   ;2;14;195;0;2;1;1;0;2;0;2;0
21673; 33.5 ; 167.4 ; 19.6 ;5;30;63;0;5;3;2;1;4;2;3;0
21674; 50.5 ; 101.1 ; 11.5 ;2;83;75;0;2;2;0;1;1;0;1;1
21675; 17.9 ; 35.7 ; 1.1 ;2;7;128;2;0;2;0;2;0;2;0;0
21676; 21.0 ; 105.2 ; 5.9 ;5;61;47;0;5;2;3;3;2;5;0;0
21677; 20.5 ; 143.2 ; 12.6 ;7;34;73;0;7;0;7;5;2;5;2;0
21678; 17.1 ; 34.3 ; 3.2 ;2;6;222;0;2;2;0;2;0;2;0;0
21679; 46.8 ; 233.8 ; -   ;5;8;241;0;5;1;4;2;3;0;5;0
21680; 68.1 ; 204.3 ; 55.0 ;3;50;293;0;3;3;0;3;0;1;0;2
21681; 34.5 ; 68.9 ; 14.1 ;2;11;1;0;2;0;2;2;0;1;1;0
21682; 30.0 ; 59.9 ; -   ;2;19;259;0;2;2;0;2;0;2;0;0
21683; 45.1 ; 315.5 ; 18.5 ;7;29;89;0;7;2;5;6;1;2;3;2
21684; 32.0 ; 223.7 ; 16.0 ;7;33;68;0;7;1;6;7;0;2;5;0
21685; 43.8 ; 87.6 ; 24.8 ;2;28;103;0;2;1;1;0;2;1;0;1
21686; 33.1 ; 66.3 ; 11.2 ;2;43;86;0;2;2;0;1;1;1;1;0
21687; 34.5 ; 172.3 ; 11.4 ;5;61;11;0;5;0;5;2;3;2;3;0
21688; 70.1 ; 140.3 ; 35.0 ;2;37;115;1;1;0;2;1;1;0;0;2
21689; 16.8 ; 33.6 ; 2.7 ;2;244;68;0;2;0;2;2;0;2;0;0
21690; 36.1 ; 180.7 ; 15.4 ;5;46;8;0;5;2;3;5;0;2;3;0
21691; 47.7 ; 95.4 ; 1.4 ;2;11;153;0;2;0;2;1;1;0;2;0
21692; 17.2 ; 137.8 ; 5.1 ;8;23;104;0;8;2;6;5;3;8;0;0
21693; 62.5 ; 187.4 ; 45.2 ;3;36;215;0;3;1;2;2;1;1;0;2
21694; 56.7 ; 113.4 ; 38.7 ;2;145;62;1;1;0;2;2;0;1;0;1
21695; 21.2 ; 380.8 ; 9.1 ;18;16;22;0;18;8;10;7;11;12;6;0
21696; 38.1 ; 76.1 ; 11.7 ;2;58;118;0;2;2;0;1;1;1;1;0
21697; 28.9 ; 86.8 ; 17.2 ;3;7;236;0;3;0;3;3;0;2;1;0
21698; 42.1 ; 337.0 ; 16.7 ;8;21;129;0;8;7;1;4;4;3;2;3
21699; 51.0 ; 102.0 ; -   ;2;32;146;2;0;0;2;0;2;0;2;0
21700; 38.7 ; 773.3 ; 15.6 ;20;14;5;0;20;10;10;6;14;7;13;0
21701; 30.8 ; 61.7 ; 8.6 ;2;93;5;0;2;0;2;1;1;1;1;0
21702; 50.9 ; 254.6 ; 21.3 ;5;68;4;5;0;2;3;3;2;2;1;2
21703; 49.1 ; 98.1 ; 2.9 ;2;134;110;1;1;1;1;2;0;0;2;0
21704; 30.9 ; 92.6 ; 15.0 ;3;132;21;0;3;0;3;1;2;1;2;0
21705; 20.5 ; 40.9 ; 6.9 ;2;30;122;0;2;1;1;1;1;2;0;0
21706; 36.6 ; 2,197.1 ; 26.5 ;60;5;1;0;60;25;35;31;29;20;20;20
21707; 41.5 ; 166.0 ; 12.1 ;4;36;89;3;1;2;2;2;2;1;3;0
21708; 30.2 ; 60.4 ; -   ;2;5;159;2;0;1;1;2;0;0;2;0
21709; 30.2 ; 60.4 ; -   ;2;40;227;0;2;1;1;0;2;0;2;0
21710; 18.0 ; 36.1 ; 4.6 ;2;82;167;0;2;0;2;0;2;2;0;0
21711; 18.0 ; 72.2 ; 3.7 ;4;39;75;1;3;3;1;3;1;4;0;0
21712; 27.4 ; 164.6 ; 11.2 ;6;34;5;5;1;1;5;2;4;4;2;0
21713; 22.5 ; 44.9 ; 11.2 ;2;1;252;0;2;1;1;0;2;1;1;0
21714; 48.6 ; 145.9 ; 1.7 ;3;33;153;0;3;1;2;3;0;0;3;0
21715; 46.8 ; 93.5 ; -   ;2;8;237;0;2;1;1;2;0;0;2;0
21716; 24.9 ; 49.8 ; 0.3 ;2;37;231;0;2;0;2;0;2;2;0;0
21717; 24.3 ; 121.7 ; 14.9 ;5;54;104;0;5;0;5;3;2;3;2;0
21718; 57.7 ; 173.2 ; 0.4 ;3;59;63;0;3;0;3;2;1;0;0;3
21719; 38.5 ; 231.0 ; 14.1 ;6;64;36;0;6;1;5;6;0;2;4;0
21720; 15.0 ; 45.0 ; -   ;3;6;6;0;3;0;3;0;3;3;0;0
21721; 27.0 ; 161.8 ; 15.6 ;6;63;11;0;6;2;4;1;5;4;2;0
21722; 40.5 ; 364.5 ; 10.8 ;9;20;5;9;0;2;7;8;1;3;6;0
21723; 32.0 ; 191.9 ; 15.0 ;6;42;41;0;6;4;2;3;3;2;4;0
21724; 30.0 ; 59.9 ; 22.4 ;2;9;383;0;2;1;1;1;1;1;1;0
21725; 26.0 ; 1,224.1 ; 15.9 ;47;6;2;0;47;16;31;28;19;31;16;0
21726; 84.1 ; 252.3 ; 67.1 ;3;38;31;0;3;0;3;2;1;1;0;2
21727; 48.2 ; 144.5 ; 2.6 ;3;29;230;0;3;2;1;3;0;0;3;0
21728; 31.1 ; 62.2 ; 9.1 ;2;24;362;0;2;0;2;2;0;1;1;0
21729; 19.6 ; 58.8 ; 4.8 ;3;11;248;0;3;2;1;0;3;3;0;0
21730; 15.0 ; 74.9 ; -   ;5;23;2;0;5;3;2;5;0;5;0;0
21731; 51.7 ; 2,015.5 ; 21.7 ;39;9;15;0;39;6;33;29;10;13;13;13
21732; 20.0 ; 100.2 ; 7.6 ;5;78;35;0;5;3;2;4;1;5;0;0
21733; 66.1 ; 330.7 ; 30.2 ;5;43;65;5;0;4;1;1;4;0;0;5
21734; 39.5 ; 276.6 ; 41.0 ;7;7;101;0;7;2;5;3;4;2;3;2
21735; 43.9 ; 263.4 ; 40.2 ;6;39;92;0;6;4;2;5;1;2;2;2
21736; 56.7 ; 623.5 ; 32.4 ;11;20;112;0;11;7;4;10;1;4;0;7
21737; 71.4 ; 214.2 ; 38.5 ;3;7;131;0;3;0;3;3;0;0;0;3
21738; 36.2 ; 72.3 ; 12.1 ;2;151;26;0;2;0;2;1;1;1;1;0
21739; 31.6 ; 94.9 ; 15.3 ;3;59;100;0;3;1;2;3;0;1;2;0
21740; 35.5 ; 177.3 ; 16.9 ;5;35;21;0;5;2;3;4;1;2;3;0
21741; 45.7 ; 91.5 ; 4.3 ;2;14;351;0;2;0;2;0;2;0;2;0
21742; 46.1 ; 138.3 ; 29.2 ;3;5;251;0;3;2;1;1;2;1;1;1
21743; 32.1 ; 96.2 ; 8.6 ;3;68;128;0;3;1;2;1;2;1;2;0
21744; 56.0 ; 223.8 ; 5.1 ;4;88;46;0;4;3;1;4;0;0;0;4
21745; 61.7 ; 246.6 ; -   ;4;42;94;0;4;0;4;4;0;0;0;4
21746; 33.8 ; 236.6 ; 17.7 ;7;10;221;0;7;2;5;3;4;2;5;0
21747; 18.7 ; 206.1 ; 7.2 ;11;7;244;0;11;5;6;5;6;11;0;0
21748; 21.8 ; 43.7 ; 4.9 ;2;24;209;0;2;0;2;1;1;2;0;0
21749; 17.7 ; 35.4 ; 4.1 ;2;7;209;0;2;0;2;2;0;2;0;0
21750; 47.2 ; 188.9 ; 1.0 ;4;32;199;0;4;1;3;4;0;0;4;0
21751; 38.6 ; 77.3 ; 6.3 ;2;31;236;0;2;0;2;2;0;0;2;0
21752; 39.5 ; 79.0 ; 12.5 ;2;134;78;1;1;0;2;1;1;1;1;0
21753; 38.1 ; 190.3 ; 17.1 ;5;5;263;0;5;2;3;3;2;2;1;2
21754; 51.7 ; 103.4 ; 32.2 ;2;5;107;0;2;1;1;1;1;1;0;1
21755; 52.6 ; 157.8 ; 8.3 ;3;34;116;0;3;0;3;3;0;0;2;1
21756; 21.4 ; 64.1 ; 6.2 ;3;34;73;0;3;0;3;1;2;3;0;0
21757; 18.4 ; 73.5 ; 7.2 ;4;8;53;0;4;1;3;2;2;4;0;0
21758; 30.2 ; 181.3 ; 8.9 ;6;23;215;0;6;2;4;1;5;2;4;0
21759; 58.8 ; 176.3 ; 23.8 ;3;43;110;3;0;0;3;3;0;0;0;3
21760; 43.7 ; 174.7 ; 9.8 ;4;59;120;0;4;0;4;4;0;0;4;0
21761; 23.2 ; 208.5 ; 8.6 ;9;6;170;0;9;2;7;7;2;6;3;0
21762; 37.7 ; 753.8 ; 13.6 ;20;16;5;0;20;4;16;11;9;7;13;0
21763; 15.0 ; 74.9 ; -   ;5;28;52;0;5;0;5;3;2;5;0;0
21764; 47.0 ; 141.0 ; 0.4 ;3;110;36;1;2;0;3;3;0;0;3;0
21765; 47.1 ; 94.2 ; 0.5 ;2;267;73;0;2;1;1;0;2;0;2;0
21766; 59.1 ; 709.6 ; 16.7 ;12;26;26;0;12;1;11;5;7;0;0;12
21767; 48.9 ; 244.4 ; 21.0 ;5;78;20;0;5;1;4;1;4;2;1;2
21768; 38.6 ; 115.8 ; 39.1 ;3;63;58;1;2;0;3;1;2;1;1;1
21769; 63.2 ; 189.5 ; 2.6 ;3;59;188;0;3;0;3;1;2;0;0;3
21770; 25.8 ; 51.6 ; 16.2 ;2;31;263;0;2;0;2;1;1;1;1;0
21771; 30.9 ; 61.7 ; 23.8 ;2;2;237;0;2;1;1;1;1;1;1;0
21772; 36.3 ; 290.3 ; 14.0 ;8;4;176;0;8;2;6;8;0;3;5;0
21773; 19.8 ; 119.0 ; 6.2 ;6;36;14;0;6;5;1;3;3;6;0;0
21774; 29.8 ; 149.1 ; 13.0 ;5;22;16;0;5;1;4;3;2;3;2;0
21775; 47.7 ; 143.1 ; 0.4 ;3;16;20;0;3;0;3;3;0;0;3;0
21776; 25.6 ; 76.7 ; 19.4 ;3;41;93;3;0;2;1;3;0;2;1;0
21777; 37.4 ; 1,309.6 ; 17.2 ;35;7;11;0;35;23;12;27;8;12;23;0
21778; 46.8 ; 93.5 ; -   ;2;28;206;0;2;2;0;0;2;0;2;0
21779; 36.8 ; 625.7 ; 14.8 ;17;26;4;0;17;7;10;13;4;6;11;0
21780; 18.6 ; 241.8 ; 6.5 ;13;24;5;0;13;3;10;11;2;13;0;0
21781; 30.1 ; 150.6 ; 3.7 ;5;50;57;0;5;2;3;2;3;2;3;0
21782; 48.0 ; 240.2 ; 2.2 ;5;52;31;0;5;0;5;4;1;0;5;0
21783; 44.2 ; 176.8 ; 6.1 ;4;38;35;0;4;2;2;2;2;0;4;0
21784; 49.6 ; 99.3 ; 4.3 ;2;29;155;0;2;1;1;1;1;0;2;0
21785; 32.8 ; 426.0 ; 15.1 ;13;14;14;0;13;8;5;9;4;4;9;0
21786; 21.9 ; 219.3 ; 8.3 ;10;24;68;1;9;3;7;5;5;7;3;0
21787; 38.5 ; 77.0 ; 6.3 ;2;12;265;0;2;2;0;2;0;0;2;0
21788; 82.7 ; 165.3 ; 53.8 ;2;8;325;0;2;1;1;1;1;1;0;1
21789; 22.7 ; 136.2 ; 3.9 ;6;50;58;0;6;0;6;6;0;6;0;0
21790; 16.1 ; 32.1 ; 1.6 ;2;7;383;0;2;0;2;2;0;2;0;0
21791; 49.8 ; 149.3 ; 13.3 ;3;5;260;0;3;3;0;1;2;0;2;1
21792; 48.8 ; 390.8 ; 1.3 ;8;20;15;0;8;0;8;8;0;0;8;0
21793; 45.6 ; 182.4 ; 21.8 ;4;59;110;0;4;3;1;4;0;1;2;1
21794; 28.2 ; 140.8 ; 14.9 ;5;59;23;0;5;2;3;3;2;3;2;0
21795; 45.8 ; 91.7 ; 1.4 ;2;3;275;0;2;1;1;1;1;0;2;0
21796; 15.0 ; 30.0 ; -   ;2;11;258;0;2;0;2;2;0;2;0;0
21797; 50.1 ; 702.0 ; 27.8 ;14;33;2;0;14;2;12;4;10;5;4;5
21798; 55.4 ; 221.4 ; 33.4 ;4;31;4;4;0;2;2;4;0;1;0;3
21799; 37.3 ; 747.0 ; 13.4 ;20;12;63;0;20;3;17;2;18;7;13;0
21800; 21.0 ; 63.0 ; 8.4 ;3;34;46;3;0;3;0;3;0;3;0;0
21801; 22.0 ; 109.9 ; 8.3 ;5;9;113;0;5;1;4;2;3;3;2;0
21802; 28.0 ; 55.9 ; 19.4 ;2;23;173;0;2;1;1;0;2;1;1;0
21803; 20.4 ; 183.2 ; 6.4 ;9;37;8;0;9;5;4;5;4;9;0;0
21804; 50.6 ; 607.1 ; 12.2 ;12;28;5;0;12;5;7;10;2;0;8;4
21805; 46.2 ; 92.4 ; 3.8 ;2;86;162;0;2;1;1;2;0;0;2;0
21806; 41.2 ; 989.8 ; 20.3 ;24;17;5;0;24;8;16;13;11;8;8;8
21807; 44.9 ; 134.6 ; 3.1 ;3;69;5;0;3;1;2;3;0;0;3;0
21808; 20.6 ; 41.3 ; 1.8 ;2;103;100;2;0;1;1;2;0;2;0;0
21809; 42.7 ; 384.5 ; 17.1 ;9;30;52;0;9;0;9;4;5;3;3;3
21810; 64.7 ; 388.3 ; 31.0 ;6;25;215;0;6;1;5;5;1;0;0;6
21811; 31.0 ; 62.0 ; 14.8 ;2;14;116;0;2;1;1;0;2;1;1;0
21812; 28.9 ; 86.7 ; 9.9 ;3;2;262;0;3;1;2;3;0;2;1;0
21813; 43.4 ; 86.9 ; -   ;2;4;344;0;2;1;1;1;1;0;2;0
21814; 36.5 ; 765.6 ; 16.9 ;21;17;15;0;21;2;19;9;12;7;14;0
21815; 22.7 ; 136.2 ; 6.4 ;6;31;199;0;6;3;3;2;4;6;0;0
21816; 33.0 ; 263.6 ; 10.4 ;8;41;5;0;8;2;6;8;0;3;5;0
21817; 50.2 ; 100.4 ; 34.5 ;2;3;262;0;2;1;1;2;0;1;0;1
21818; 45.2 ; 225.8 ; 4.2 ;5;10;186;5;0;2;3;4;1;0;5;0
21819; 31.2 ; 125.0 ; 2.3 ;4;23;97;0;4;1;3;1;3;1;3;0
21820; 72.4 ; 217.2 ; 62.8 ;3;102;114;1;2;2;1;1;2;1;0;2
21821; 30.1 ; 240.5 ; 10.9 ;8;11;18;0;8;5;3;5;3;3;5;0
21822; 26.2 ; 157.3 ; 20.8 ;6;41;157;0;6;0;6;6;0;4;2;0
21823; 46.8 ; 93.5 ; -   ;2;104;173;0;2;1;1;2;0;0;2;0
21824; 33.0 ; 494.7 ; 6.5 ;15;23;1;0;15;4;11;1;14;5;10;0
21825; 26.8 ; 80.4 ; 1.9 ;3;9;143;0;3;0;3;1;2;3;0;0
21826; 94.4 ; 188.9 ; 1.4 ;2;25;162;0;2;0;2;2;0;0;0;2
21827; 45.4 ; 136.2 ; 8.5 ;3;35;209;0;3;0;3;2;1;0;3;0
21828; 36.5 ; 73.0 ; 17.2 ;2;316;11;0;2;1;1;1;1;1;1;0
21829; 27.7 ; 83.1 ; 14.9 ;3;99;112;0;3;2;1;1;2;2;1;0
21830; 43.9 ; 219.7 ; 21.8 ;5;30;142;0;5;2;3;2;3;2;1;2
21831; 36.6 ; 109.8 ; -   ;3;45;23;0;3;1;2;1;2;0;3;0
21832; 17.4 ; 87.1 ; 1.3 ;5;9;10;0;5;0;5;5;0;5;0;0
21833; 27.2 ; 136.2 ; 13.2 ;5;57;15;0;5;2;3;2;3;3;2;0
21834; 45.2 ; 226.1 ; 9.9 ;5;13;221;0;5;0;5;3;2;0;3;2
21835; 74.8 ; 373.9 ; 31.6 ;5;106;12;0;5;4;1;1;4;0;0;5
21836; 25.3 ; 202.6 ; 13.7 ;8;42;5;0;8;3;5;3;5;5;3;0
21837; 15.0 ; 30.0 ; -   ;2;29;137;0;2;0;2;1;1;2;0;0
21838; 51.8 ; 103.5 ; 6.4 ;2;124;26;2;0;0;2;2;0;0;1;1
21839; 109.6 ; 548.1 ; 66.6 ;5;50;161;0;5;3;2;3;2;0;0;5
21840; 47.0 ; 141.0 ; 0.4 ;3;135;58;0;3;1;2;0;3;0;3;0
21841; 61.3 ; 183.9 ; 50.4 ;3;54;99;0;3;0;3;2;1;1;0;2
21842; 65.9 ; 197.7 ; 38.4 ;3;72;152;0;3;0;3;3;0;1;0;2
21843; 52.8 ; 105.5 ; 1.6 ;2;189;58;0;2;0;2;1;1;0;2;0
21844; 56.8 ; 113.6 ; 16.0 ;2;79;75;0;2;1;1;0;2;0;0;2
21845; 41.6 ; 790.2 ; 14.1 ;19;15;0;0;19;0;19;17;2;6;7;6
21846; 30.8 ; 153.8 ; 10.2 ;5;99;42;0;5;2;3;1;4;2;3;0
21847; 36.8 ; 184.2 ; 14.9 ;5;22;189;0;5;3;2;1;4;2;3;0
21848; 46.6 ; 93.2 ; 31.3 ;2;18;176;0;2;2;0;1;1;1;0;1
21849; 47.2 ; 235.9 ; 0.4 ;5;23;52;0;5;1;4;5;0;0;5;0
21850; 38.5 ; 76.9 ; 12.4 ;2;218;40;0;2;1;1;1;1;1;1;0
21851; 25.5 ; 127.4 ; 7.6 ;5;27;38;0;5;1;4;1;4;3;2;0
21852; 39.7 ; 79.5 ; 4.7 ;2;5;260;0;2;2;0;1;1;0;2;0
21853; 23.9 ; 71.8 ; 13.3 ;3;2;53;0;3;1;2;1;2;2;1;0
21854; 17.2 ; 172.2 ; 4.3 ;10;19;68;0;10;4;6;6;4;10;0;0
21855; 49.6 ; 99.3 ; 4.3 ;2;75;121;1;1;0;2;2;0;0;2;0
21856; 23.1 ; 300.1 ; 6.5 ;13;29;2;0;13;7;6;2;11;13;0;0
21857; 64.5 ; 193.6 ; 15.0 ;3;95;10;2;1;0;3;2;1;0;0;3
21858; 63.6 ; 318.2 ; 17.1 ;5;37;5;0;5;0;5;5;0;0;0;5
21859; 46.6 ; 419.3 ; 14.7 ;9;36;75;0;9;5;4;2;7;0;6;3
21860; 34.3 ; 308.5 ; 9.9 ;9;23;59;0;9;3;6;7;2;3;6;0
21861; 36.3 ; 72.5 ; 16.8 ;2;6;38;0;2;0;2;1;1;1;1;0
21862; 41.9 ; 293.0 ; 10.1 ;7;30;57;3;4;2;5;4;3;0;7;0
21863; 58.0 ; 116.0 ; 0.3 ;2;88;42;0;2;0;2;2;0;0;0;2
21864; 16.8 ; 622.1 ; 6.1 ;37;11;8;0;37;11;26;11;26;37;0;0
21865; 42.0 ; 84.1 ; 8.1 ;2;104;89;0;2;1;1;0;2;0;2;0
21866; 48.6 ; 194.2 ; 3.3 ;4;49;39;0;4;3;1;1;3;0;4;0
21867; 24.8 ; 173.6 ; 9.9 ;7;24;78;0;7;1;6;5;2;5;2;0
21868; 40.4 ; 80.8 ; 9.5 ;2;4;186;0;2;1;1;1;1;0;2;0
21869; 54.0 ; 432.1 ; 16.4 ;8;36;92;0;8;1;7;4;4;0;5;3
21870; 18.6 ; 352.6 ; 8.3 ;19;14;42;0;19;10;9;5;14;19;0;0
21871; 46.8 ; 702.0 ; 22.6 ;15;30;1;0;15;2;13;10;5;5;5;5
21872; 38.5 ; 192.4 ; 13.0 ;5;5;50;0;5;4;1;1;4;2;3;0
21873; 47.1 ; 94.2 ; 0.5 ;2;47;89;2;0;1;1;2;0;0;2;0
21874; 41.0 ; 246.2 ; 14.0 ;6;26;37;0;6;0;6;1;5;2;2;2
21875; 47.7 ; 143.1 ; 0.4 ;3;54;0;0;3;0;3;1;2;0;3;0
21876; 35.9 ; 71.8 ; 16.2 ;2;15;101;0;2;1;1;2;0;1;1;0
21877; 41.8 ; 292.7 ; 9.2 ;7;38;10;0;7;1;6;1;6;0;7;0
21878; 77.7 ; 233.0 ; 51.5 ;3;22;235;0;3;1;2;2;1;1;0;2
21879; 26.2 ; 78.6 ; 20.6 ;3;25;208;0;3;2;1;2;1;2;1;0
21880; 46.9 ; 187.6 ; 25.0 ;4;48;310;0;4;1;3;1;3;1;2;1
21881; 33.4 ; 66.7 ; 23.0 ;2;77;11;0;2;1;1;1;1;1;0;1
21882; 27.5 ; 82.5 ; 14.7 ;3;95;68;0;3;0;3;3;0;2;1;0
21883; 21.1 ; 105.3 ; 8.8 ;5;20;149;0;5;3;2;4;1;5;0;0
21884; 30.9 ; 61.7 ; 23.8 ;2;93;116;0;2;0;2;2;0;1;1;0
21885; 72.8 ; 291.1 ; 14.5 ;4;97;35;0;4;1;3;3;1;0;0;4
21886; 15.9 ; 174.5 ; 1.7 ;11;10;11;0;11;6;5;11;0;11;0;0
21887; 53.4 ; 266.9 ; 31.4 ;5;47;27;0;5;1;4;2;3;2;1;2
21888; 17.7 ; 247.5 ; 2.2 ;14;9;41;0;14;8;6;3;11;14;0;0
21889; 56.4 ; 451.0 ; 13.6 ;8;31;101;0;8;2;6;2;6;0;0;8
21890; 40.2 ; 1,125.7 ; 13.7 ;28;14;4;0;28;13;15;6;22;9;19;0
21891; 49.2 ; 196.7 ; 0.7 ;4;43;24;0;4;1;3;2;2;0;4;0
21892; 42.2 ; 168.8 ; 19.5 ;4;13;28;0;4;3;1;4;0;1;2;1
21893; 23.5 ; 94.0 ; 4.5 ;4;21;119;0;4;4;0;4;0;4;0;0
21894; 38.5 ; 76.9 ; 12.4 ;2;58;141;0;2;0;2;2;0;1;1;0
21895; 53.1 ; 159.4 ; 6.6 ;3;25;185;0;3;2;1;0;3;0;2;1
21896; 39.6 ; 197.8 ; 31.7 ;5;61;17;1;4;1;4;2;3;2;1;2
21897; 28.9 ; 57.9 ; 20.9 ;2;41;124;2;0;1;1;2;0;1;1;0
21898; 58.2 ; 756.4 ; 26.7 ;13;17;26;0;13;2;11;7;6;0;0;13
21899; 44.0 ; 220.2 ; 12.2 ;5;41;248;0;5;2;3;2;3;0;3;2
21900; 15.0 ; 30.0 ; -   ;2;3;160;2;0;1;1;1;1;2;0;0
21901; 26.5 ; 106.1 ; 3.1 ;4;92;18;1;3;2;2;2;2;4;0;0
21902; 28.5 ; 228.2 ; 12.9 ;8;25;169;0;8;2;6;4;4;5;3;0
21903; 21.8 ; 109.2 ; 17.8 ;5;32;54;5;0;5;0;0;5;3;2;0
21904; 42.0 ; 629.3 ; 18.5 ;15;27;32;0;15;10;5;10;5;5;5;5
21905; 51.2 ; 307.4 ; 14.0 ;6;68;36;0;6;1;5;4;2;0;4;2
21906; 41.8 ; 209.0 ; 5.9 ;5;74;20;0;5;0;5;5;0;0;5;0
21907; 46.7 ; 140.1 ; 3.5 ;3;25;162;3;0;0;3;3;0;0;3;0
21908; 46.1 ; 184.6 ; 23.6 ;4;77;41;0;4;2;2;4;0;1;2;1
21909; 34.5 ; 68.9 ; 14.1 ;2;131;10;0;2;0;2;2;0;1;1;0
21910; 62.7 ; 877.1 ; 20.0 ;14;22;5;0;14;2;12;7;7;0;0;14
21911; 46.5 ; 185.8 ; 29.6 ;4;40;152;0;4;2;2;4;0;1;2;1
21912; 46.7 ; 746.5 ; 14.4 ;16;12;20;0;16;10;6;6;10;0;11;5
21913; 30.9 ; 154.6 ; 12.1 ;5;51;56;0;5;2;3;2;3;2;3;0
21914; 23.5 ; 47.0 ; 0.9 ;2;182;21;1;1;0;2;2;0;2;0;0
21915; 29.1 ; 174.4 ; 11.3 ;6;22;40;0;6;3;3;2;4;4;2;0
21916; 62.4 ; 124.8 ; 1.3 ;2;6;128;0;2;2;0;0;2;0;0;2
21917; 27.8 ; 83.4 ; 14.4 ;3;50;23;0;3;2;1;1;2;2;1;0
21918; 63.4 ; 126.8 ; 2.5 ;2;37;236;0;2;0;2;1;1;0;0;2
21919; 68.5 ; 410.8 ; 24.1 ;6;5;2;0;6;5;1;6;0;0;0;6
21920; 31.8 ; 63.7 ; 25.2 ;2;1;173;0;2;1;1;0;2;1;0;1
21921; 40.9 ; 408.5 ; 17.3 ;10;23;78;0;10;5;5;9;1;3;4;3
21922; 26.3 ; 131.5 ; 8.2 ;5;25;123;0;5;4;1;3;2;3;2;0
21923; 51.8 ; 362.5 ; 18.5 ;7;17;31;0;7;0;7;5;2;0;5;2
21924; 27.4 ; 109.6 ; 8.5 ;4;49;73;0;4;0;4;4;0;3;1;0
21925; 41.7 ; 166.9 ; 12.1 ;4;14;206;0;4;2;2;3;1;1;3;0
21926; 26.5 ; 106.1 ; 15.4 ;4;32;20;0;4;2;2;3;1;3;1;0
21927; 65.0 ; 195.1 ; 4.4 ;3;2;75;0;3;3;0;1;2;0;0;3
21928; 47.1 ; 235.7 ; 29.7 ;5;70;24;0;5;2;3;5;0;2;1;2
21929; 44.5 ; 311.2 ; 9.9 ;7;44;111;0;7;5;2;4;3;0;7;0
21930; 51.5 ; 360.7 ; 21.4 ;7;43;23;0;7;3;4;5;2;0;5;2
21931; 39.2 ; 78.3 ; 35.5 ;2;20;62;0;2;0;2;2;0;1;0;1
21932; 18.9 ; 189.1 ; 6.0 ;10;28;32;0;10;4;6;3;7;10;0;0
21933; 42.6 ; 85.3 ; 9.1 ;2;23;258;0;2;0;2;1;1;0;2;0
21934; 39.6 ; 198.0 ; 20.5 ;5;36;160;0;5;2;3;2;3;2;1;2
21935; 20.6 ; 61.9 ; 3.7 ;3;2;116;3;0;2;1;3;0;3;0;0
21936; 35.8 ; 143.3 ; 27.8 ;4;13;380;0;4;4;0;1;3;1;2;1
21937; 45.9 ; 183.5 ; 9.1 ;4;17;215;0;4;2;2;1;3;0;4;0
21938; 88.6 ; 1,239.7 ; 27.8 ;14;32;20;0;14;3;11;9;5;0;0;14
21939; 20.0 ; 40.1 ; 7.6 ;2;19;99;0;2;0;2;2;0;2;0;0
21940; 15.7 ; 78.5 ; 1.7 ;5;14;52;0;5;1;4;3;2;5;0;0
21941; 81.4 ; 244.3 ; 7.0 ;3;23;233;0;3;1;2;1;2;0;0;3
21942; 55.0 ; 274.8 ; 10.8 ;5;19;143;0;5;1;4;2;3;0;3;2
21943; 49.6 ; 297.8 ; 3.1 ;6;50;10;0;6;0;6;4;2;0;6;0
21944; 89.3 ; 178.5 ; 11.1 ;2;195;99;1;1;0;2;2;0;0;0;2
21945; 30.9 ; 61.7 ; 23.8 ;2;4;254;0;2;1;1;2;0;1;1;0
21946; 118.0 ; 236.1 ; 96.5 ;2;33;53;1;1;1;1;0;2;1;0;1
21947; 50.0 ; 100.0 ; 4.9 ;2;6;99;0;2;0;2;2;0;0;2;0
21948; 33.4 ; 66.8 ; 4.8 ;2;82;224;0;2;1;1;2;0;1;1;0
21949; 20.0 ; 1,218.5 ; 5.0 ;61;7;10;0;61;38;23;22;39;61;0;0
21950; 50.0 ; 500.4 ; 19.0 ;10;18;137;0;10;1;9;5;5;0;7;3
21951; 34.6 ; 69.2 ; 22.4 ;2;63;57;0;2;0;2;1;1;1;0;1
21952; 47.3 ; 141.8 ; 11.9 ;3;109;140;0;3;2;1;3;0;0;2;1
21953; 43.1 ; 603.9 ; 20.0 ;14;24;2;0;14;2;12;3;11;5;4;5
21954; 38.1 ; 152.3 ; 10.6 ;4;33;110;0;4;0;4;3;1;1;3;0
21955; 42.9 ; 214.5 ; 15.7 ;5;30;15;0;5;2;3;4;1;2;1;2
21956; 97.7 ; 195.4 ; 76.3 ;2;16;185;0;2;1;1;0;2;1;0;1
21957; 34.3 ; 171.4 ; 5.5 ;5;41;36;0;5;0;5;4;1;2;3;0
21958; 41.5 ; 166.1 ; 14.5 ;4;35;11;0;4;0;4;3;1;1;2;1
21959; 48.5 ; 242.6 ; 15.2 ;5;19;0;0;5;0;5;5;0;0;3;2
21960; 26.4 ; 422.7 ; 10.3 ;16;5;103;0;16;12;4;4;12;11;5;0
21961; 61.7 ; 185.1 ; 25.0 ;3;2;254;0;3;2;1;0;3;0;0;3
21962; 97.3 ; 486.5 ; 114.3 ;5;78;90;0;5;0;5;3;2;2;0;3
21963; 47.5 ; 142.4 ; -   ;3;11;38;0;3;1;2;1;2;0;3;0
21964; 23.4 ; 116.9 ; 4.4 ;5;41;200;0;5;2;3;5;0;5;0;0
21965; 44.7 ; 134.0 ; 7.4 ;3;43;91;0;3;1;2;1;2;0;3;0
21966; 46.8 ; 93.5 ; -   ;2;2;119;0;2;1;1;1;1;0;2;0
21967; 39.0 ; 195.0 ; 14.8 ;5;25;1;5;0;0;5;4;1;2;3;0
21968; 83.8 ; 335.0 ; 70.3 ;4;105;15;2;2;0;4;2;2;1;0;3
21969; 42.3 ; 84.6 ; 7.7 ;2;44;32;0;2;0;2;0;2;0;2;0
21970; 65.8 ; 197.3 ; 16.2 ;3;44;230;0;3;0;3;2;1;0;0;3
21971; 54.5 ; 272.3 ; 21.7 ;5;29;239;0;5;1;4;4;1;0;3;2
21972; 17.7 ; 35.4 ; 4.1 ;2;14;246;0;2;0;2;1;1;2;0;0
21973; 23.1 ; 92.4 ; 17.2 ;4;78;31;0;4;1;3;1;3;3;1;0
21974; 39.1 ; 273.6 ; 13.3 ;7;54;27;0;7;0;7;7;0;2;5;0
21975; 33.7 ; 1,718.8 ; 15.6 ;51;5;0;0;51;24;27;30;21;17;34;0
21976; 40.8 ; 81.7 ; 9.9 ;2;113;53;0;2;0;2;0;2;0;2;0
21977; 24.0 ; 95.9 ; 11.3 ;4;4;56;0;4;2;2;2;2;3;1;0
21978; 77.1 ; 462.5 ; 27.2 ;6;62;41;0;6;2;4;6;0;0;0;6
21979; 42.6 ; 2,941.3 ; 15.8 ;69;6;1;0;69;29;40;36;33;23;23;23
21980; 40.5 ; 890.7 ; 16.5 ;22;19;6;0;22;5;17;8;14;7;8;7
21981; 31.6 ; 569.6 ; 24.6 ;18;23;5;0;18;2;16;14;4;6;6;6
21982; 44.0 ; 220.0 ; 23.6 ;5;64;104;0;5;2;3;3;2;2;1;2
21983; 25.1 ; 50.1 ; -   ;2;5;73;0;2;0;2;0;2;2;0;0
21984; 38.3 ; 76.5 ; -   ;2;291;62;0;2;0;2;2;0;0;2;0
21985; 37.4 ; 74.9 ; 19.0 ;2;39;209;0;2;0;2;0;2;1;0;1
21986; 20.4 ; 285.6 ; 5.2 ;14;19;5;0;14;8;6;4;10;14;0;0
21987; 40.9 ; 81.8 ; 16.0 ;2;17;241;0;2;1;1;2;0;1;0;1
21988; 40.3 ; 201.4 ; 14.1 ;5;59;74;0;5;4;1;2;3;2;3;0
21989; 55.5 ; 388.2 ; 10.1 ;7;65;11;0;7;2;5;3;4;0;0;7
21990; 44.4 ; 88.8 ; 12.2 ;2;328;125;0;2;0;2;0;2;0;1;1
21991; 24.2 ; 121.1 ; 13.4 ;5;45;1;4;1;1;4;3;2;3;2;0
21992; 31.6 ; 63.2 ; 24.9 ;2;18;13;2;0;2;0;2;0;1;0;1
21993; 50.1 ; 250.5 ; 5.7 ;5;12;172;0;5;4;1;1;4;0;3;2
21994; 47.7 ; 95.5 ; 1.5 ;2;5;270;0;2;2;0;0;2;0;2;0
21995; 16.6 ; 33.2 ; 2.4 ;2;55;5;0;2;0;2;1;1;2;0;0
21996; 33.4 ; 100.1 ; 5.9 ;3;125;89;1;2;2;1;2;1;1;2;0
21997; 37.2 ; 148.6 ; 15.3 ;4;25;240;0;4;2;2;2;2;1;3;0
21998; 18.4 ; 92.2 ; 2.0 ;5;3;263;0;5;3;2;5;0;5;0;0
21999; 52.5 ; 367.5 ; 17.6 ;7;40;11;0;7;0;7;7;0;0;5;2
22000; 17.3 ; 69.3 ; 3.1 ;4;17;1;2;2;2;2;2;2;4;0;0
22001; 27.0 ; 135.2 ; 12.0 ;5;34;58;0;5;2;3;0;5;3;2;0
22002; 23.5 ; 70.5 ; 2.4 ;3;20;131;0;3;1;2;0;3;3;0;0
22003; 48.3 ; 145.0 ; 21.5 ;3;11;343;0;3;2;1;2;1;1;1;1
22004; 63.9 ; 383.6 ; 25.1 ;6;25;92;6;0;5;1;0;6;0;0;6
22005; 53.8 ; 107.6 ; 35.3 ;2;176;22;0;2;1;1;1;1;1;0;1
22006; 27.0 ; 54.0 ; 11.6 ;2;4;95;0;2;0;2;2;0;1;1;0
22007; 34.7 ; 381.5 ; 16.4 ;11;20;36;0;11;4;7;7;4;4;7;0
22008; 39.6 ; 554.9 ; 17.8 ;14;11;5;0;14;2;12;1;13;5;4;5
22009; 22.9 ; 1,100.0 ; 4.6 ;48;5;9;0;48;23;25;18;30;48;0;0
22010; 71.2 ; 142.5 ; 3.8 ;2;25;152;0;2;0;2;0;2;0;0;2
22011; 27.0 ; 107.9 ; 10.4 ;4;29;64;0;4;0;4;3;1;3;1;0
22012; 38.9 ; 233.3 ; 11.0 ;6;11;257;0;6;2;4;2;4;2;4;0
22013; 53.9 ; 161.6 ; 21.4 ;3;69;142;0;3;0;3;1;2;0;2;1
22014; 43.8 ; 175.1 ; 13.0 ;4;19;82;0;4;4;0;3;1;0;3;1
22015; 41.1 ; 246.4 ; 10.5 ;6;11;127;0;6;0;6;2;4;0;6;0
22016; 56.0 ; 224.0 ; 8.2 ;4;69;225;0;4;0;4;3;1;0;0;4
22017; 34.0 ; 102.0 ; 12.0 ;3;26;323;0;3;1;2;3;0;1;2;0
22018; 30.3 ; 121.3 ; 3.1 ;4;21;219;0;4;2;2;1;3;1;3;0
22019; 33.2 ; 132.6 ; 2.7 ;4;7;139;0;4;3;1;3;1;0;4;0
22020; 39.3 ; 196.3 ; 34.3 ;5;49;140;0;5;3;2;2;3;2;1;2
22021; 20.7 ; 289.8 ; 10.5 ;14;14;123;0;14;9;5;4;10;9;5;0
22022; 37.5 ; 524.9 ; 13.3 ;14;22;20;0;14;6;8;12;2;5;9;0
22023; 33.7 ; 134.8 ; 11.9 ;4;5;109;0;4;2;2;3;1;1;3;0
22024; 58.0 ; 173.9 ; 30.5 ;3;185;29;0;3;3;0;0;3;1;0;2
22025; 15.0 ; 30.0 ; -   ;2;71;71;2;0;1;1;1;1;2;0;0
22026; 27.9 ; 195.2 ; 14.1 ;7;26;116;0;7;4;3;7;0;5;2;0
22027; 30.5 ; 182.9 ; 2.7 ;6;28;35;0;6;4;2;1;5;2;4;0
22028; 92.9 ; 929.0 ; 52.1 ;10;32;8;9;1;9;1;2;8;0;0;10
22029; 44.3 ; 487.7 ; 25.0 ;11;25;56;0;11;8;3;11;0;4;3;4
22030; 30.7 ; 122.9 ; 0.4 ;4;8;5;4;0;0;4;4;0;0;4;0
22031; 82.9 ; 248.7 ; 23.4 ;3;108;89;2;1;1;2;3;0;0;0;3
22032; 32.8 ; 294.9 ; 18.5 ;9;50;3;0;9;8;1;9;0;3;6;0
22033; 44.4 ; 88.9 ; 11.8 ;2;194;143;0;2;0;2;1;1;0;1;1
22034; 26.2 ; 235.5 ; 9.9 ;9;19;64;0;9;1;8;7;2;6;3;0
22035; 15.0 ; 74.9 ; -   ;5;36;53;0;5;0;5;1;4;5;0;0
22036; 50.6 ; 101.2 ; 2.9 ;2;15;164;0;2;1;1;2;0;0;2;0
22037; 62.9 ; 314.4 ; 17.5 ;5;83;6;0;5;1;4;1;4;0;0;5
22038; 27.8 ; 83.3 ; 2.7 ;3;21;166;1;2;2;1;1;2;2;1;0
22039; 44.3 ; 177.3 ; 14.8 ;4;93;1;0;4;1;3;2;2;1;2;1
22040; 48.4 ; 678.1 ; 19.1 ;14;23;26;0;14;1;13;11;3;5;4;5
22041; 47.2 ; 236.1 ; 1.2 ;5;33;123;0;5;1;4;1;4;0;5;0
22042; 16.4 ; 147.9 ; 1.6 ;9;21;47;0;9;3;6;2;7;9;0;0
22043; 45.3 ; 90.6 ; 13.1 ;2;1;206;0;2;2;0;2;0;0;1;1
22044; 48.9 ; 97.8 ; 3.2 ;2;13;252;0;2;0;2;1;1;0;2;0
22045; 15.0 ; 74.9 ; -   ;5;9;106;5;0;2;3;1;4;5;0;0
22046; 66.1 ; 132.1 ; 26.0 ;2;11;93;0;2;2;0;2;0;0;0;2
22047; 29.8 ; 89.5 ; 5.0 ;3;6;209;3;0;2;1;2;1;2;1;0
22048; 117.9 ; 235.8 ; 36.5 ;2;221;99;1;1;0;2;2;0;0;0;2
22049; 29.7 ; 118.9 ; 16.7 ;4;61;162;0;4;1;3;3;1;3;1;0
22050; 36.3 ; 72.5 ; 16.8 ;2;56;21;1;1;0;2;2;0;1;1;0
22051; 40.9 ; 163.6 ; 24.8 ;4;2;248;0;4;1;3;2;2;1;2;1
22052; 37.1 ; 111.4 ; 17.7 ;3;13;274;0;3;1;2;2;1;1;2;0
22053; 30.5 ; 304.6 ; 7.2 ;10;33;74;0;10;4;6;3;7;3;7;0
22054; 34.0 ; 102.0 ; 18.3 ;3;48;96;0;3;2;1;1;2;1;2;0
22055; 36.0 ; 179.9 ; 15.5 ;5;50;38;0;5;3;2;2;3;2;3;0
22056; 42.0 ; 84.1 ; 8.1 ;2;7;90;0;2;1;1;1;1;0;2;0
22057; 42.1 ; 1,053.4 ; 9.4 ;25;16;5;0;25;7;18;16;9;0;25;0
22058; 55.9 ; 391.0 ; 0.5 ;7;41;10;0;7;0;7;7;0;0;0;7
22059; 41.8 ; 250.6 ; 17.8 ;6;17;110;0;6;0;6;3;3;2;2;2
22060; 48.9 ; 195.5 ; 2.6 ;4;1;264;0;4;3;1;1;3;0;4;0
22061; 53.6 ; 214.3 ; 11.6 ;4;17;26;0;4;0;4;4;0;0;3;1
22062; 44.9 ; 179.5 ; 2.7 ;4;20;26;0;4;1;3;2;2;0;4;0
22063; 56.1 ; 504.7 ; 19.4 ;9;27;5;9;0;3;6;4;5;0;0;9
22064; 67.7 ; 135.4 ; 9.1 ;2;194;78;1;1;0;2;2;0;0;0;2
22065; 41.1 ; 123.4 ; 19.9 ;3;17;284;0;3;2;1;1;2;1;1;1
22066; 79.3 ; 237.9 ; 57.7 ;3;101;9;2;1;2;1;0;3;1;0;2
22067; 16.8 ; 33.6 ; 2.7 ;2;77;256;0;2;1;1;2;0;2;0;0
22068; 45.7 ; 91.4 ; 13.6 ;2;31;236;0;2;1;1;1;1;0;1;1
22069; 59.3 ; 118.6 ; 18.8 ;2;39;120;0;2;0;2;1;1;0;0;2
22070; 47.1 ; 188.5 ; 23.5 ;4;16;218;0;4;3;1;2;2;1;2;1
22071; 25.2 ; 75.5 ; 9.8 ;3;16;115;0;3;1;2;2;1;2;1;0
22072; 18.3 ; 91.7 ; 5.5 ;5;60;19;0;5;4;1;3;2;5;0;0
22073; 32.1 ; 96.2 ; 22.7 ;3;54;89;0;3;0;3;1;2;1;2;0
22074; 27.5 ; 55.0 ; 7.2 ;2;1;84;0;2;0;2;1;1;1;1;0
22075; 18.0 ; 36.1 ; 4.6 ;2;50;163;0;2;0;2;2;0;2;0;0
22076; 31.9 ; 95.6 ; 22.4 ;3;20;236;0;3;1;2;2;1;1;2;0
22077; 48.4 ; 145.1 ; 16.7 ;3;2;140;0;3;3;0;1;2;0;2;1
22078; 37.0 ; 74.0 ; 14.6 ;2;48;185;0;2;0;2;2;0;1;1;0
22079; 35.9 ; 251.3 ; 11.3 ;7;27;6;0;7;2;5;4;3;2;5;0
22080; 47.2 ; 94.4 ; 0.6 ;2;7;272;0;2;1;1;0;2;0;2;0
22081; 23.4 ; 70.2 ; 8.2 ;3;75;116;0;3;0;3;3;0;2;1;0
22082; 24.4 ; 48.8 ; 8.7 ;2;194;64;0;2;0;2;0;2;1;1;0
22083; 43.9 ; 614.9 ; 7.8 ;14;19;11;0;14;0;14;12;2;0;14;0
22084; 107.7 ; 215.3 ; 11.8 ;2;145;94;0;2;0;2;1;1;0;0;2
22085; 55.4 ; 221.5 ; 32.9 ;4;61;99;0;4;1;3;2;2;1;0;3
22086; 33.0 ; 231.3 ; 12.5 ;7;41;41;0;7;2;5;3;4;2;5;0
22087; 25.9 ; 414.9 ; 11.5 ;16;21;71;0;16;9;7;16;0;11;5;0
22088; 21.7 ; 43.4 ; 3.4 ;2;30;296;0;2;1;1;2;0;2;0;0
22089; 101.2 ; 202.5 ; 73.0 ;2;158;136;0;2;0;2;2;0;1;0;1
22090; 30.2 ; 60.4 ; -   ;2;232;26;0;2;0;2;2;0;0;2;0
22091; 31.5 ; 94.5 ; 15.9 ;3;72;185;0;3;0;3;3;0;1;2;0
22092; 57.8 ; 289.0 ; 22.9 ;5;32;125;0;5;1;4;5;0;0;0;5
22093; 27.2 ; 108.9 ; 17.0 ;4;12;54;0;4;2;2;4;0;3;1;0
22094; 44.7 ; 178.8 ; 12.6 ;4;82;15;2;2;0;4;1;3;0;3;1
22095; 31.4 ; 723.0 ; 14.9 ;23;19;1;0;23;10;13;6;17;8;15;0
22096; 36.1 ; 72.1 ; 0.1 ;2;74;136;0;2;1;1;2;0;0;2;0
22097; 48.6 ; 729.2 ; 15.9 ;15;22;1;0;15;11;4;2;13;0;10;5
22098; 38.5 ; 115.5 ; 24.2 ;3;25;32;0;3;1;2;1;2;1;1;1
22099; 42.8 ; 171.1 ; 12.8 ;4;49;126;0;4;2;2;1;3;1;2;1
22100; 47.6 ; 285.9 ; 11.9 ;6;47;86;0;6;2;4;4;2;0;4;2
22101; 22.5 ; 157.5 ; 13.3 ;7;47;2;0;7;2;5;5;2;5;2;0
22102; 49.5 ; 98.9 ; 0.2 ;2;54;79;0;2;1;1;1;1;0;2;0
22103; 70.1 ; 140.3 ; 35.0 ;2;113;173;0;2;0;2;2;0;0;0;2
22104; 20.7 ; 82.6 ; 4.5 ;4;10;250;0;4;4;0;1;3;4;0;0
22105; 16.0 ; 48.0 ; 1.9 ;3;14;74;0;3;0;3;1;2;3;0;0
22106; 57.5 ; 747.8 ; 33.9 ;13;17;26;0;13;2;11;9;4;4;0;9
22107; 53.7 ; 214.7 ; 22.3 ;4;82;41;0;4;0;4;4;0;0;3;1
22108; 67.7 ; 338.4 ; 34.6 ;5;63;68;0;5;1;4;3;2;0;0;5
22109; 21.9 ; 197.3 ; 8.8 ;9;21;139;0;9;6;3;2;7;6;3;0
22110; 45.1 ; 180.3 ; 22.1 ;4;101;26;0;4;0;4;4;0;1;2;1
22111; 22.9 ; 68.7 ; 4.0 ;3;78;122;0;3;1;2;2;1;3;0;0
22112; 21.4 ; 42.9 ; 5.4 ;2;107;110;0;2;0;2;0;2;2;0;0
22113; 26.3 ; 105.2 ; 10.9 ;4;95;2;0;4;2;2;2;2;3;1;0
22114; 49.8 ; 896.4 ; 26.5 ;18;7;86;1;17;13;5;2;16;6;6;6
22115; 30.4 ; 151.9 ; 13.4 ;5;14;69;0;5;3;2;2;3;2;3;0
22116; 38.5 ; 231.1 ; 6.8 ;6;21;5;0;6;1;5;6;0;0;6;0
22117; 16.1 ; 64.4 ; 2.4 ;4;7;276;0;4;2;2;1;3;4;0;0
22118; 54.2 ; 542.4 ; 29.0 ;10;37;9;0;10;1;9;8;2;3;4;3
22119; 60.4 ; 241.6 ; 52.2 ;4;34;127;0;4;2;2;2;2;1;0;3
22120; 45.5 ; 91.1 ; 2.9 ;2;35;69;0;2;0;2;0;2;0;2;0
22121; 61.6 ; 123.3 ; 28.1 ;2;77;229;0;2;1;1;1;1;0;0;2
22122; 28.1 ; 56.1 ; 19.6 ;2;1;194;0;2;0;2;1;1;1;1;0
22123; 57.7 ; 115.4 ; 48.9 ;2;116;290;0;2;2;0;1;1;1;0;1
22124; 35.0 ; 140.0 ; 4.7 ;4;68;122;0;4;1;3;1;3;0;4;0
22125; 39.9 ; 79.9 ; 15.0 ;2;4;396;0;2;1;1;0;2;1;1;0
22126; 73.5 ; 220.6 ; 18.0 ;3;146;64;1;2;2;1;2;1;0;0;3
22127; 25.8 ; 1,264.5 ; 9.1 ;49;9;1;0;49;21;28;16;33;33;16;0
22128; 51.4 ; 513.6 ; 17.4 ;10;20;112;0;10;4;6;3;7;0;7;3
22129; 32.1 ; 160.7 ; 18.3 ;5;44;41;5;0;0;5;3;2;2;3;0
22130; 64.8 ; 388.7 ; 27.4 ;6;18;120;0;6;1;5;0;6;0;0;6
22131; 16.1 ; 176.8 ; 3.1 ;11;21;41;0;11;6;5;4;7;11;0;0
22132; 17.7 ; 70.8 ; 3.4 ;4;21;0;4;0;1;3;1;3;4;0;0
22133; 33.0 ; 495.6 ; 18.5 ;15;14;116;0;15;0;15;14;1;5;10;0
22134; 75.7 ; 151.5 ; 43.4 ;2;31;210;0;2;0;2;2;0;0;0;2
22135; 26.0 ; 597.3 ; 7.6 ;23;9;5;0;23;9;14;16;7;15;8;0
22136; 42.0 ; 84.0 ; 2.9 ;2;18;110;0;2;0;2;0;2;0;2;0
22137; 46.6 ; 233.0 ; 16.4 ;5;88;31;1;4;2;3;5;0;0;3;2
22138; 42.2 ; 211.0 ; 5.8 ;5;38;59;0;5;4;1;2;3;0;5;0
22139; 39.3 ; 117.8 ; 11.3 ;3;9;147;0;3;1;2;1;2;1;2;0
22140; 52.0 ; 675.7 ; 20.9 ;13;15;110;0;13;7;6;9;4;0;9;4
22141; 18.6 ; 260.0 ; 6.5 ;14;10;236;0;14;5;9;14;0;14;0;0
22142; 17.8 ; 178.3 ; 6.0 ;10;29;8;0;10;4;6;3;7;10;0;0
22143; 40.3 ; 201.6 ; 16.3 ;5;43;38;1;4;3;2;1;4;2;1;2
22144; 81.8 ; 163.6 ; 84.9 ;2;77;92;1;1;1;1;0;2;1;0;1
22145; 37.2 ; 74.5 ; 1.0 ;2;383;11;0;2;0;2;0;2;0;2;0
22146; 43.9 ; 263.6 ; 12.5 ;6;35;103;0;6;2;4;6;0;0;4;2
22147; 57.1 ; 114.3 ; 6.9 ;2;179;131;0;2;1;1;1;1;0;0;2
22148; 31.7 ; 158.5 ; 15.3 ;5;20;198;0;5;3;2;4;1;2;3;0
22149; 28.0 ; 55.9 ; 19.4 ;2;395;47;0;2;1;1;1;1;1;1;0
22150; 31.5 ; 94.4 ; 15.5 ;3;11;202;0;3;1;2;2;1;1;2;0
22151; 49.5 ; 494.6 ; 7.9 ;10;20;16;1;9;0;10;2;8;0;7;3
22152; 47.5 ; 94.9 ; -   ;2;11;32;0;2;0;2;0;2;0;2;0
22153; 54.6 ; 546.0 ; 29.9 ;10;21;157;0;10;2;8;6;4;3;4;3
22154; 38.4 ; 422.6 ; 5.7 ;11;30;5;0;11;4;7;8;3;0;11;0
22155; 48.1 ; 433.0 ; 10.7 ;9;32;22;0;9;5;4;7;2;0;6;3
22156; 50.9 ; 509.4 ; 13.8 ;10;33;11;0;10;0;10;7;3;0;7;3
22157; 93.5 ; 187.0 ; -   ;2;19;125;0;2;0;2;1;1;0;0;2
22158; 32.7 ; 65.3 ; 21.1 ;2;113;183;0;2;1;1;1;1;1;1;0
22159; 29.0 ; 144.8 ; 11.5 ;5;17;35;5;0;5;0;4;1;3;2;0
22160; 38.5 ; 76.9 ; 12.4 ;2;69;204;0;2;0;2;1;1;1;1;0
22161; 36.6 ; 182.8 ; 40.6 ;5;41;1;0;5;0;5;5;0;2;1;2
22162; 48.6 ; 97.2 ; -   ;2;55;220;0;2;1;1;1;1;0;2;0
22163; 36.2 ; 289.9 ; 6.8 ;8;41;79;0;8;0;8;8;0;3;5;0
22164; 28.1 ; 84.4 ; 3.2 ;3;58;20;0;3;0;3;0;3;2;1;0
22165; 21.9 ; 175.3 ; 6.2 ;8;13;5;0;8;0;8;6;2;8;0;0
22166; 25.1 ; 50.1 ; -   ;2;13;11;0;2;0;2;0;2;2;0;0
22167; 20.0 ; 40.1 ; 7.6 ;2;54;217;0;2;1;1;0;2;2;0;0
22168; 26.4 ; 52.9 ; 17.2 ;2;5;85;0;2;0;2;2;0;1;1;0
22169; 34.1 ; 136.5 ; 6.3 ;4;11;200;0;4;0;4;2;2;1;3;0
22170; 45.1 ; 90.1 ; 29.9 ;2;151;141;1;1;0;2;2;0;1;0;1
22171; 70.5 ; 846.4 ; 21.6 ;12;16;0;0;12;2;10;10;2;0;0;12
22172; 50.5 ; 201.9 ; 8.4 ;4;17;151;0;4;1;3;4;0;0;3;1
22173; 38.3 ; 153.1 ; 14.0 ;4;52;267;0;4;1;3;1;3;1;3;0
22174; 47.7 ; 95.5 ; 1.5 ;2;8;209;0;2;1;1;2;0;0;2;0
22175; 67.0 ; 133.9 ; 7.6 ;2;179;125;0;2;1;1;2;0;0;0;2
22176; 15.0 ; 30.0 ; -   ;2;31;173;1;1;0;2;1;1;2;0;0
22177; 51.8 ; 725.3 ; 21.1 ;14;24;80;0;14;1;13;4;10;0;9;5
22178; 38.5 ; 77.1 ; 6.5 ;2;17;92;2;0;2;0;0;2;0;2;0
22179; 26.3 ; 131.6 ; 13.2 ;5;11;10;0;5;0;5;3;2;3;2;0
22180; 45.9 ; 91.8 ; 26.6 ;2;26;35;1;1;2;0;1;1;1;0;1
22181; 29.2 ; 787.2 ; 19.9 ;27;16;5;0;27;4;23;11;16;18;9;0
22182; 75.4 ; 301.8 ; 38.0 ;4;41;245;0;4;1;3;2;2;0;0;4
22183; 65.2 ; 195.6 ; 25.7 ;3;122;115;0;3;0;3;3;0;0;0;3
22184; 23.8 ; 95.0 ; 8.1 ;4;20;67;0;4;1;3;2;2;3;1;0
22185; 64.2 ; 1,605.2 ; 20.0 ;25;10;148;0;25;8;17;24;1;0;0;25
22186; 33.3 ; 366.1 ; 10.3 ;11;15;14;0;11;2;9;2;9;4;7;0
22187; 38.5 ; 115.4 ; 12.3 ;3;37;170;0;3;1;2;1;2;1;2;0
22188; 38.6 ; 77.1 ; 3.0 ;2;5;47;0;2;0;2;0;2;0;2;0
22189; 20.0 ; 380.7 ; 2.8 ;19;15;57;0;19;12;7;3;16;19;0;0
22190; 15.0 ; 74.9 ; -   ;5;36;124;0;5;2;3;0;5;5;0;0
22191; 25.6 ; 76.7 ; 11.4 ;3;18;241;0;3;2;1;1;2;2;1;0
22192; 53.5 ; 107.0 ; 10.1 ;2;218;197;1;1;2;0;2;0;0;1;1
22193; 39.7 ; 238.5 ; 14.7 ;6;17;14;0;6;4;2;1;5;2;4;0
22194; 69.3 ; 138.5 ; 38.4 ;2;11;41;0;2;1;1;1;1;0;0;2
22195; 44.0 ; 175.8 ; 18.9 ;4;60;84;0;4;0;4;2;2;1;2;1
22196; 24.7 ; 346.3 ; 17.5 ;14;30;32;0;14;2;12;7;7;9;5;0
22197; 46.8 ; 93.5 ; -   ;2;170;131;1;1;0;2;1;1;0;2;0
22198; 42.5 ; 212.4 ; 13.8 ;5;77;134;0;5;3;2;3;2;2;1;2
22199; 56.9 ; 910.1 ; 13.6 ;16;30;2;0;16;6;10;5;11;0;0;16
22200; 19.0 ; 133.3 ; 12.2 ;7;25;2;7;0;5;2;5;2;5;2;0
22201; 38.8 ; 77.7 ; 12.9 ;2;38;94;0;2;0;2;0;2;1;1;0
22202; 78.7 ; 393.7 ; 42.2 ;5;61;62;0;5;0;5;4;1;0;0;5
22203; 53.5 ; 107.0 ; 5.9 ;2;112;44;2;0;1;1;1;1;0;1;1
22204; 25.9 ; 103.7 ; 5.8 ;4;105;5;0;4;0;4;2;2;3;1;0
22205; 32.4 ; 356.4 ; 14.2 ;11;12;134;0;11;6;5;10;1;4;7;0
22206; 36.6 ; 109.8 ; -   ;3;68;41;2;1;1;2;2;1;0;3;0
22207; 36.0 ; 216.0 ; 7.6 ;6;48;11;0;6;0;6;5;1;2;4;0
22208; 15.0 ; 45.0 ; -   ;3;5;38;0;3;1;2;0;3;3;0;0
22209; 19.3 ; 57.9 ; 7.9 ;3;2;183;0;3;1;2;1;2;3;0;0
22210; 42.5 ; 127.5 ; 7.8 ;3;41;182;0;3;3;0;1;2;0;3;0
22211; 90.9 ; 363.6 ; 28.9 ;4;42;74;0;4;1;3;4;0;0;0;4
22212; 65.1 ; 130.1 ; 18.8 ;2;5;283;0;2;0;2;2;0;0;0;2
22213; 69.0 ; 1,311.2 ; 18.7 ;19;16;15;0;19;0;19;7;12;0;0;19
22214; 16.1 ; 193.1 ; 3.1 ;12;23;17;0;12;5;7;4;8;12;0;0
22215; 30.9 ; 61.7 ; 23.8 ;2;137;59;0;2;1;1;0;2;1;1;0
22216; 41.9 ; 125.8 ; 10.8 ;3;44;22;0;3;1;2;0;3;0;3;0
22217; 39.2 ; 78.4 ; 12.4 ;2;59;23;0;2;2;0;2;0;1;1;0
22218; 30.1 ; 90.4 ; 15.6 ;3;8;143;3;0;2;1;1;2;1;2;0
22219; 78.8 ; 157.5 ; 22.7 ;2;13;210;0;2;0;2;2;0;0;0;2
22220; 37.7 ; 226.3 ; 9.9 ;6;6;110;0;6;3;3;2;4;2;4;0
22221; 30.0 ; 59.9 ; -   ;2;11;192;2;0;2;0;0;2;2;0;0
22222; 27.9 ; 55.9 ; 2.8 ;2;1;320;0;2;0;2;1;1;1;1;0
22223; 44.1 ; 132.4 ; 28.0 ;3;74;275;0;3;1;2;2;1;1;1;1
22224; 53.1 ; 159.3 ; 25.2 ;3;20;40;0;3;1;2;3;0;1;1;1
22225; 73.3 ; 220.0 ; 25.4 ;3;45;187;0;3;1;2;1;2;0;0;3
22226; 58.4 ; 175.2 ; 16.2 ;3;25;247;0;3;0;3;2;1;0;0;3
22227; 56.7 ; 113.3 ; 5.1 ;2;5;47;0;2;0;2;2;0;0;0;2
22228; 88.8 ; 532.7 ; 25.8 ;6;72;36;0;6;0;6;5;1;0;0;6
22229; 33.3 ; 66.6 ; 7.8 ;2;196;86;0;2;2;0;2;0;1;1;0
22230; 52.1 ; 104.2 ; 7.7 ;2;4;7;0;2;1;1;0;2;0;1;1
22231; 105.2 ; 631.0 ; 72.4 ;6;43;160;0;6;2;4;2;4;0;0;6
22232; 36.9 ; 110.7 ; 20.3 ;3;151;16;0;3;0;3;2;1;1;1;1
22233; 56.4 ; 112.9 ; 39.3 ;2;16;311;0;2;0;2;0;2;1;0;1
22234; 100.0 ; 199.9 ; 63.6 ;2;46;40;0;2;1;1;2;0;0;0;2
22235; 73.7 ; 516.0 ; 10.0 ;7;38;5;0;7;0;7;7;0;0;0;7
22236; 29.9 ; 119.6 ; 13.4 ;4;22;284;0;4;3;1;4;0;3;1;0
22237; 30.2 ; 120.7 ; -   ;4;42;26;1;3;0;4;1;3;0;4;0
22238; 65.6 ; 196.9 ; 25.5 ;3;76;32;0;3;0;3;3;0;0;0;3
22239; 34.1 ; 68.3 ; 21.7 ;2;13;268;0;2;0;2;2;0;1;0;1
22240; 51.5 ; 360.5 ; 11.6 ;7;18;131;0;7;0;7;7;0;0;5;2
22241; 48.2 ; 96.3 ; 2.1 ;2;20;183;0;2;0;2;0;2;0;2;0
22242; 42.2 ; 548.7 ; 29.4 ;13;35;2;0;13;5;8;10;3;4;5;4
22243; 33.0 ; 66.1 ; 20.5 ;2;33;144;0;2;1;1;2;0;1;1;0
22244; 20.7 ; 62.2 ; -   ;3;7;9;3;0;1;2;3;0;3;0;0
22245; 17.8 ; 160.3 ; 6.3 ;9;35;4;0;9;6;3;1;8;9;0;0
22246; 37.1 ; 185.5 ; 11.1 ;5;41;1;0;5;3;2;2;3;2;3;0
22247; 41.8 ; 167.3 ; 36.4 ;4;53;5;0;4;2;2;3;1;1;2;1
22248; 110.7 ; 442.9 ; 59.1 ;4;17;174;0;4;1;3;2;2;0;0;4
22249; 16.2 ; 372.4 ; 4.3 ;23;11;14;0;23;22;1;23;0;23;0;0
22250; 15.0 ; 30.0 ; -   ;2;5;35;0;2;2;0;0;2;2;0;0
22251; 22.3 ; 491.4 ; 7.9 ;22;18;5;0;22;7;15;17;5;15;7;0
22252; 28.3 ; 283.1 ; 8.0 ;10;45;4;0;10;6;4;5;5;7;3;0
22253; 15.0 ; 30.0 ; -   ;2;232;59;0;2;0;2;1;1;2;0;0
22254; 115.7 ; 231.4 ; 66.8 ;2;14;94;2;0;0;2;1;1;0;0;2
22255; 24.7 ; 841.0 ; 8.5 ;34;13;3;0;34;20;14;21;13;23;11;0
22256; 35.9 ; 179.6 ; 20.6 ;5;45;128;0;5;4;1;2;3;2;1;2
22257; 45.9 ; 275.6 ; 14.6 ;6;63;51;0;6;1;5;5;1;0;4;2
22258; 37.2 ; 186.2 ; 15.3 ;5;42;1;0;5;0;5;2;3;2;3;0
22259; 40.6 ; 202.8 ; 10.0 ;5;7;31;0;5;1;4;1;4;0;5;0
22260; 67.8 ; 406.7 ; 17.4 ;6;31;62;0;6;0;6;4;2;0;0;6
22261; 63.0 ; 126.0 ; 21.5 ;2;22;152;0;2;1;1;2;0;0;0;2
22262; 48.2 ; 192.6 ; 1.7 ;4;26;206;0;4;2;2;3;1;0;4;0
22263; 29.0 ; 116.2 ; 16.3 ;4;29;172;0;4;3;1;1;3;3;1;0
22264; 56.1 ; 280.6 ; 6.6 ;5;66;5;0;5;0;5;5;0;0;0;5
22265; 22.6 ; 90.2 ; 5.3 ;4;27;194;0;4;0;4;1;3;4;0;0
22266; 44.9 ; 1,033.8 ; 10.9 ;23;17;30;0;23;11;12;20;3;0;15;8
22267; 30.2 ; 60.4 ; -   ;2;50;224;0;2;2;0;0;2;0;2;0
22268; 51.7 ; 103.4 ; 22.6 ;2;163;89;0;2;0;2;0;2;1;0;1
22269; 51.8 ; 517.8 ; 18.8 ;10;30;0;0;10;2;8;7;3;0;7;3
22270; 16.4 ; 49.3 ; 1.3 ;3;49;66;1;2;1;2;3;0;3;0;0
22271; 50.3 ; 201.1 ; 4.3 ;4;38;10;0;4;0;4;2;2;0;4;0
22272; 44.8 ; 89.6 ; 5.8 ;2;6;257;0;2;0;2;2;0;0;2;0
22273; 46.4 ; 185.4 ; 36.2 ;4;33;30;0;4;4;0;1;3;1;2;1
22274; 40.7 ; 692.6 ; 11.6 ;17;22;8;0;17;5;12;10;7;6;11;0
22275; 39.6 ; 515.3 ; 24.9 ;13;28;0;0;13;5;8;5;8;4;5;4
22276; 22.1 ; 132.3 ; 13.1 ;6;43;62;0;6;2;4;3;3;4;2;0
22277; 38.1 ; 266.9 ; 18.4 ;7;27;125;0;7;3;4;3;4;2;3;2
22278; 39.9 ; 79.8 ; 13.1 ;2;5;263;0;2;0;2;1;1;1;1;0
22279; 47.7 ; 810.2 ; 21.6 ;17;24;18;0;17;6;11;7;10;6;5;6
22280; 21.3 ; 85.2 ; 8.0 ;4;119;17;0;4;3;1;3;1;4;0;0
22281; 47.0 ; 94.1 ; 15.6 ;2;78;155;0;2;1;1;1;1;0;1;1
22282; 18.2 ; 36.4 ; -   ;2;9;5;0;2;1;1;1;1;2;0;0
22283; 23.1 ; 69.4 ; 3.2 ;3;18;243;0;3;2;1;1;2;3;0;0
22284; 88.6 ; 265.9 ; 11.5 ;3;40;65;0;3;2;1;1;2;0;0;3
22285; 29.4 ; 58.8 ; -   ;2;1;5;2;0;0;2;1;1;2;0;0
22286; 87.6 ; 262.9 ; 29.2 ;3;85;41;1;2;0;3;2;1;0;0;3
22287; 31.0 ; 92.9 ; 20.8 ;3;58;99;0;3;1;2;1;2;1;2;0
22288; 21.1 ; 190.3 ; 9.6 ;9;19;4;0;9;1;8;7;2;6;3;0
22289; 44.4 ; 177.6 ; 13.9 ;4;71;94;0;4;1;3;0;4;0;3;1
22290; 47.8 ; 95.6 ; 1.6 ;2;132;22;0;2;1;1;1;1;0;2;0
22291; 49.7 ; 149.0 ; 7.8 ;3;66;47;0;3;0;3;3;0;0;2;1
22292; 50.8 ; 710.9 ; 16.9 ;14;14;5;0;14;5;9;6;8;0;9;5
22293; 49.8 ; 1,592.6 ; 14.7 ;32;7;31;0;32;3;29;7;25;0;21;11
22294; 77.2 ; 849.6 ; 24.6 ;11;14;162;0;11;1;10;8;3;0;0;11
22295; 119.9 ; 239.7 ; 82.8 ;2;18;52;0;2;0;2;2;0;0;0;2
22296; 47.2 ; 235.9 ; 0.7 ;5;36;16;0;5;1;4;5;0;0;5;0
22297; 18.3 ; 73.1 ; 5.0 ;4;16;38;0;4;2;2;1;3;4;0;0
22298; 52.5 ; 105.0 ; -   ;2;14;146;0;2;0;2;0;2;0;2;0
22299; 21.1 ; 210.7 ; 10.3 ;10;16;144;0;10;5;5;5;5;7;3;0
22300; 53.8 ; 161.4 ; 15.9 ;3;59;173;0;3;0;3;3;0;0;2;1
22301; 46.6 ; 93.2 ; 0.2 ;2;59;351;0;2;1;1;1;1;0;2;0
22302; 25.1 ; 50.1 ; -   ;2;5;110;0;2;0;2;1;1;2;0;0
22303; 38.9 ; 194.6 ; 17.8 ;5;17;18;5;0;4;1;0;5;2;1;2
22304; 40.4 ; 121.3 ; 12.8 ;3;9;120;0;3;1;2;1;2;1;2;0
22305; 67.6 ; 202.8 ; 5.8 ;3;88;89;0;3;0;3;3;0;0;0;3
22306; 27.2 ; 81.5 ; 11.3 ;3;29;149;0;3;3;0;3;0;2;1;0
22307; 72.8 ; 218.3 ; 18.4 ;3;15;293;0;3;3;0;2;1;0;0;3
22308; 52.5 ; 105.0 ; 7.5 ;2;206;94;1;1;1;1;0;2;0;1;1
22309; 17.6 ; 105.8 ; 5.9 ;6;8;188;0;6;1;5;3;3;6;0;0
22310; 44.4 ; 88.8 ; 44.0 ;2;16;154;0;2;1;1;0;2;1;0;1
22311; 15.0 ; 45.0 ; -   ;3;12;132;0;3;1;2;2;1;3;0;0
22312; 95.6 ; 191.3 ; 3.2 ;2;42;179;0;2;1;1;0;2;0;0;2
22313; 18.3 ; 55.0 ; 6.2 ;3;54;188;0;3;0;3;1;2;3;0;0
22314; 21.6 ; 627.3 ; 11.8 ;29;6;146;0;29;16;13;13;16;19;10;0
22315; 38.8 ; 155.3 ; 19.5 ;4;8;194;2;2;0;4;4;0;1;2;1
22316; 38.7 ; 232.2 ; 23.0 ;6;51;5;0;6;0;6;5;1;2;2;2
22317; 22.9 ; 45.8 ; -   ;2;256;82;0;2;1;1;2;0;2;0;0
22318; 21.6 ; 258.8 ; 11.2 ;12;36;26;0;12;2;10;4;8;8;4;0
22319; 18.0 ; 36.1 ; 4.6 ;2;4;1;0;2;0;2;2;0;2;0;0
22320; 39.0 ; 77.9 ; 13.5 ;2;86;114;0;2;2;0;0;2;1;1;0
22321; 25.6 ; 51.3 ; 16.0 ;2;243;63;0;2;1;1;0;2;1;1;0
22322; 39.4 ; 473.2 ; 22.6 ;12;26;11;0;12;5;7;2;10;4;4;4
22323; 25.4 ; 127.2 ; 10.0 ;5;60;103;0;5;1;4;4;1;3;2;0
22324; 30.0 ; 59.9 ; -   ;2;31;22;0;2;0;2;1;1;2;0;0
22325; 41.3 ; 82.6 ; 24.3 ;2;30;85;0;2;0;2;1;1;1;0;1
22326; 36.3 ; 290.2 ; 24.8 ;8;5;227;0;8;0;8;4;4;3;2;3
22327; 98.0 ; 490.1 ; 65.6 ;5;59;18;0;5;2;3;5;0;0;0;5
22328; 20.0 ; 99.9 ; 8.9 ;5;10;56;4;1;2;3;1;4;5;0;0
22329; 51.2 ; 307.3 ; 27.5 ;6;27;40;0;6;2;4;0;6;2;2;2
22330; 46.0 ; 322.1 ; 29.1 ;7;49;23;0;7;2;5;4;3;2;3;2
22331; 48.9 ; 342.1 ; 3.8 ;7;34;11;0;7;1;6;5;2;0;7;0
22332; 49.4 ; 197.4 ; 38.4 ;4;38;0;0;4;1;3;2;2;1;2;1
22333; 46.4 ; 232.1 ; 18.9 ;5;70;74;0;5;1;4;5;0;2;1;2
22334; 49.0 ; 343.0 ; 3.1 ;7;36;47;0;7;0;7;3;4;0;7;0
22335; 43.1 ; 302.0 ; 18.5 ;7;6;247;0;7;3;4;6;1;2;3;2
22336; 54.4 ; 163.1 ; 24.1 ;3;7;47;0;3;1;2;2;1;0;2;1
22337; 49.1 ; 196.4 ; 5.0 ;4;22;188;0;4;3;1;1;3;0;4;0
22338; 19.3 ; 289.0 ; 9.1 ;15;11;16;0;15;4;11;6;9;15;0;0
22339; 58.0 ; 116.0 ; 9.6 ;2;81;0;0;2;0;2;1;1;0;0;2
22340; 99.3 ; 397.1 ; 32.9 ;4;37;3;0;4;1;3;1;3;0;0;4
22341; 31.1 ; 124.2 ; 15.0 ;4;79;134;0;4;3;1;1;3;1;3;0
22342; 46.8 ; 93.5 ; -   ;2;13;262;0;2;0;2;2;0;0;2;0
22343; 18.5 ; 74.1 ; 3.3 ;4;23;79;0;4;2;2;1;3;4;0;0
22344; 54.7 ; 273.3 ; 20.2 ;5;27;69;0;5;0;5;3;2;0;3;2
22345; 23.0 ; 45.9 ; 11.9 ;2;11;11;2;0;0;2;1;1;1;1;0
22346; 27.9 ; 111.8 ; 6.1 ;4;86;6;0;4;0;4;2;2;3;1;0
22347; 52.5 ; 105.0 ; -   ;2;43;178;0;2;1;1;0;2;0;2;0
22348; 23.3 ; 70.0 ; 8.1 ;3;139;2;0;3;2;1;3;0;2;1;0
22349; 25.1 ; 75.4 ; 9.3 ;3;61;71;3;0;3;0;1;2;2;1;0
22350; 34.4 ; 206.4 ; 15.7 ;6;24;77;0;6;4;2;5;1;2;4;0
22351; 31.4 ; 1,225.9 ; 11.5 ;39;8;4;0;39;21;18;23;16;13;26;0
22352; 32.6 ; 195.9 ; 16.2 ;6;32;17;0;6;4;2;4;2;2;4;0
22353; 27.6 ; 55.3 ; 3.8 ;2;23;218;0;2;1;1;0;2;1;1;0
22354; 25.3 ; 50.5 ; 0.8 ;2;10;27;2;0;0;2;2;0;2;0;0
22355; 31.6 ; 63.1 ; 15.1 ;2;14;232;0;2;1;1;2;0;1;1;0
22356; 29.5 ; 295.5 ; 15.3 ;10;32;11;0;10;4;6;2;8;7;3;0
22357; 41.7 ; 458.8 ; 10.3 ;11;19;3;0;11;3;8;8;3;0;11;0
22358; 69.6 ; 139.2 ; 19.9 ;2;58;116;2;0;0;2;2;0;0;0;2
22359; 16.1 ; 80.5 ; 1.8 ;5;14;88;0;5;5;0;0;5;5;0;0
22360; 15.0 ; 30.0 ; -   ;2;217;11;1;1;1;1;2;0;2;0;0
22361; 42.5 ; 169.9 ; 12.9 ;4;114;45;0;4;2;2;3;1;1;2;1
22362; 38.6 ; 502.4 ; 11.8 ;13;21;18;0;13;0;13;6;7;4;9;0
22363; 34.6 ; 138.6 ; 9.9 ;4;79;65;0;4;3;1;3;1;1;3;0
22364; 26.0 ; 78.0 ; 1.7 ;3;41;206;0;3;0;3;3;0;3;0;0
22365; 33.5 ; 234.3 ; 20.8 ;7;35;57;0;7;2;5;4;3;2;5;0
22366; 23.9 ; 71.6 ; 7.1 ;3;31;74;0;3;0;3;1;2;2;1;0
22367; 48.1 ; 96.2 ; 0.9 ;2;118;101;0;2;0;2;1;1;0;2;0
22368; 38.0 ; 342.1 ; 15.8 ;9;23;38;0;9;2;7;9;0;3;6;0
22369; 56.7 ; 1,475.2 ; 39.6 ;26;15;38;0;26;5;21;16;10;9;0;17
22370; 80.7 ; 242.0 ; 64.2 ;3;22;74;0;3;0;3;2;1;1;0;2
22371; 64.4 ; 257.6 ; 87.1 ;4;36;40;0;4;2;2;3;1;1;0;3
22372; 56.2 ; 112.4 ; 11.2 ;2;19;173;0;2;0;2;2;0;0;0;2
22373; 39.4 ; 78.8 ; 13.8 ;2;68;194;0;2;0;2;1;1;1;1;0
22374; 22.5 ; 44.9 ; 11.2 ;2;174;99;1;1;1;1;1;1;1;1;0
22375; 51.3 ; 205.0 ; 3.2 ;4;48;26;2;2;0;4;4;0;0;4;0
22376; 53.0 ; 1,006.8 ; 26.2 ;19;16;105;0;19;7;12;17;2;6;7;6
22377; 69.6 ; 1,044.7 ; 29.1 ;15;23;5;0;15;1;14;15;0;0;0;15
22378; 24.9 ; 74.6 ; 9.3 ;3;115;14;0;3;3;0;0;3;2;1;0
22379; 40.6 ; 81.2 ; 9.2 ;2;5;178;0;2;0;2;1;1;0;2;0
22380; 47.0 ; 328.8 ; 22.1 ;7;51;57;0;7;1;6;3;4;2;3;2
22381; 40.1 ; 401.5 ; 17.6 ;10;31;26;0;10;8;2;9;1;3;4;3
22382; 21.5 ; 43.1 ; 5.3 ;2;32;127;0;2;0;2;2;0;2;0;0
22383; 24.1 ; 96.3 ; 7.1 ;4;77;84;0;4;0;4;2;2;3;1;0
22384; 32.2 ; 160.9 ; 10.0 ;5;22;143;0;5;2;3;2;3;2;3;0
22385; 61.4 ; 122.8 ; 15.6 ;2;55;125;0;2;1;1;1;1;0;0;2
22386; 134.1 ; 268.3 ; 127.9 ;2;89;121;0;2;1;1;1;1;1;0;1
22387; 36.6 ; 73.2 ; -   ;2;24;159;0;2;2;0;1;1;0;2;0
22388; 19.6 ; 156.8 ; 3.6 ;8;5;8;8;0;5;3;1;7;8;0;0
22389; 16.5 ; 66.1 ; 3.2 ;4;25;22;0;4;2;2;1;3;4;0;0
22390; 49.5 ; 247.7 ; 14.6 ;5;86;2;0;5;3;2;3;2;0;3;2
22391; 46.6 ; 233.2 ; 22.6 ;5;74;125;0;5;2;3;3;2;2;1;2
22392; 39.9 ; 279.5 ; 8.1 ;7;22;146;0;7;2;5;1;6;0;7;0
22393; 54.7 ; 328.1 ; 17.9 ;6;14;20;0;6;1;5;3;3;0;4;2
22394; 29.3 ; 175.7 ; 13.3 ;6;14;179;0;6;0;6;4;2;4;2;0
22395; 28.3 ; 141.6 ; 10.4 ;5;68;61;0;5;3;2;3;2;3;2;0
22396; 43.8 ; 745.3 ; 14.4 ;17;14;126;0;17;9;8;11;6;6;5;6
22397; 29.7 ; 1,159.3 ; 9.2 ;39;11;6;0;39;13;26;9;30;26;13;0
22398; 23.9 ; 119.6 ; 9.2 ;5;36;40;4;1;5;0;3;2;3;2;0
22399; 20.7 ; 83.0 ; 11.2 ;4;75;41;0;4;2;2;2;2;3;1;0
22400; 67.7 ; 135.5 ; 54.7 ;2;56;89;0;2;0;2;1;1;1;0;1
22401; 54.6 ; 109.3 ; 3.2 ;2;58;259;0;2;2;0;2;0;0;1;1
22402; 38.1 ; 76.3 ; 12.9 ;2;110;164;0;2;1;1;0;2;1;1;0
22403; 48.8 ; 97.6 ; 35.5 ;2;101;99;0;2;0;2;1;1;1;0;1
22404; 24.2 ; 193.6 ; 6.0 ;8;22;14;0;8;5;3;6;2;5;3;0
22405; 53.8 ; 107.6 ; 10.5 ;2;283;15;0;2;0;2;2;0;0;1;1
22406; 30.0 ; 150.1 ; 11.8 ;5;20;23;0;5;1;4;5;0;2;3;0
22407; 20.7 ; 62.2 ; 8.0 ;3;17;132;0;3;2;1;0;3;3;0;0
22408; 18.3 ; 55.0 ; 6.2 ;3;25;57;0;3;0;3;2;1;3;0;0
22409; 37.3 ; 111.9 ; 22.4 ;3;57;48;0;3;0;3;1;2;1;1;1
22410; 22.4 ; 313.1 ; 7.3 ;14;22;32;0;14;4;10;11;3;14;0;0
22411; 56.0 ; 615.6 ; 12.6 ;11;22;12;0;11;4;7;1;10;0;0;11
22412; 27.5 ; 82.5 ; 3.2 ;3;92;17;0;3;1;2;1;2;2;1;0
22413; 51.5 ; 669.5 ; 16.5 ;13;29;57;0;13;2;11;11;2;0;9;4
22414; 54.3 ; 162.9 ; 19.7 ;3;5;262;0;3;0;3;1;2;0;2;1
22415; 15.0 ; 30.0 ; -   ;2;3;271;0;2;1;1;0;2;2;0;0
22416; 30.9 ; 185.4 ; 2.7 ;6;16;105;0;6;2;4;4;2;2;4;0
22417; 37.1 ; 74.3 ; 17.3 ;2;171;125;0;2;0;2;2;0;1;1;0
22418; 21.6 ; 43.3 ; 10.0 ;2;92;16;0;2;1;1;2;0;1;1;0
22419; 49.6 ; 148.7 ; 27.6 ;3;31;200;0;3;2;1;2;1;1;1;1
22420; 51.1 ; 153.2 ; 3.9 ;3;104;4;0;3;3;0;3;0;0;3;0
22421; 21.3 ; 42.5 ; 4.0 ;2;65;204;0;2;0;2;2;0;2;0;0
22422; 17.1 ; 34.2 ; 3.2 ;2;102;38;0;2;2;0;2;0;2;0;0
22423; 41.3 ; 413.1 ; 32.1 ;10;37;87;0;10;6;4;4;6;3;4;3
22424; 43.6 ; 130.9 ; 26.3 ;3;2;256;0;3;2;1;3;0;1;1;1
22425; 16.4 ; 246.2 ; 2.3 ;15;13;220;0;15;5;10;8;7;15;0;0
22426; 46.9 ; 234.5 ; 0.3 ;5;61;89;0;5;0;5;3;2;0;5;0
22427; 21.5 ; 64.6 ; 8.3 ;3;13;287;0;3;2;1;1;2;3;0;0
22428; 40.5 ; 324.2 ; 13.0 ;8;33;15;0;8;1;7;7;1;3;5;0
22429; 64.8 ; 324.0 ; 25.8 ;5;22;52;0;5;0;5;5;0;0;0;5
22430; 16.2 ; 227.4 ; 3.6 ;14;27;23;0;14;6;8;11;3;14;0;0
22431; 36.5 ; 583.4 ; 13.1 ;16;18;55;0;16;1;15;10;6;5;11;0
22432; 45.5 ; 182.2 ; 35.9 ;4;53;26;0;4;1;3;4;0;1;2;1
22433; 34.8 ; 278.5 ; 12.3 ;8;40;21;0;8;2;6;5;3;3;5;0
22434; 21.4 ; 664.5 ; 10.5 ;31;12;46;0;31;9;22;12;19;21;10;0
22435; 36.3 ; 72.5 ; 16.8 ;2;13;41;0;2;0;2;2;0;1;1;0
22436; 15.0 ; 30.0 ; -   ;2;1;39;0;2;2;0;0;2;2;0;0
22437; 44.4 ; 221.8 ; 30.3 ;5;35;38;0;5;2;3;3;2;2;1;2
22438; 39.5 ; 236.9 ; 17.4 ;6;40;12;1;5;1;5;5;1;2;2;2
22439; 36.5 ; 219.0 ; 14.1 ;6;14;250;0;6;0;6;2;4;2;4;0
22440; 38.8 ; 155.3 ; 23.4 ;4;26;129;0;4;1;3;4;0;1;2;1
22441; 63.2 ; 126.4 ; 14.9 ;2;1;68;0;2;0;2;2;0;0;0;2
22442; 32.3 ; 64.6 ; 3.2 ;2;4;115;0;2;1;1;1;1;1;1;0
22443; 28.2 ; 140.8 ; 14.3 ;5;20;143;0;5;2;3;2;3;3;2;0
22444; 53.8 ; 269.0 ; 30.1 ;5;59;20;5;0;0;5;5;0;2;1;2
22445; 34.1 ; 102.4 ; 8.7 ;3;18;89;0;3;1;2;0;3;1;2;0
22446; 32.6 ; 228.1 ; 14.1 ;7;32;191;1;6;2;5;1;6;2;5;0
22447; 31.8 ; 63.7 ; 25.2 ;2;9;22;1;1;1;1;1;1;1;0;1
22448; 19.9 ; 99.3 ; 7.4 ;5;45;62;0;5;2;3;2;3;5;0;0
22449; 34.5 ; 103.4 ; 3.9 ;3;36;158;3;0;2;1;0;3;0;3;0
22450; 32.0 ; 160.0 ; 13.2 ;5;64;11;1;4;2;3;3;2;2;3;0
22451; 71.7 ; 215.2 ; 23.1 ;3;25;372;0;3;0;3;1;2;0;0;3
22452; 120.0 ; 240.0 ; 105.5 ;2;59;149;1;1;1;1;2;0;1;0;1
22453; 22.5 ; 44.9 ; 11.2 ;2;10;101;0;2;1;1;1;1;1;1;0
22454; 21.6 ; 64.9 ; 2.4 ;3;2;275;0;3;2;1;1;2;3;0;0
22455; 46.9 ; 93.9 ; 40.3 ;2;2;365;0;2;1;1;2;0;1;0;1
22456; 33.8 ; 101.3 ; 5.2 ;3;1;249;0;3;2;1;2;1;1;2;0
22457; 61.7 ; 123.3 ; -   ;2;7;179;0;2;1;1;0;2;0;0;2
22458; 140.3 ; 280.5 ; 70.0 ;2;25;257;0;2;0;2;2;0;0;0;2
22459; 21.3 ; 149.2 ; 5.1 ;7;54;36;0;7;4;3;4;3;7;0;0
22460; 20.0 ; 40.1 ; 7.6 ;2;61;119;0;2;2;0;1;1;2;0;0
22461; 17.2 ; 137.8 ; 4.7 ;8;32;0;8;0;0;8;1;7;8;0;0
22462; 15.9 ; 79.4 ; 1.4 ;5;14;38;0;5;5;0;5;0;5;0;0
22463; 29.5 ; 206.8 ; 4.6 ;7;20;31;0;7;1;6;3;4;5;2;0
22464; 45.7 ; 91.3 ; 2.7 ;2;13;23;2;0;2;0;0;2;0;2;0
22465; 44.2 ; 220.8 ; 2.1 ;5;17;218;0;5;3;2;1;4;0;5;0
22466; 89.7 ; 986.7 ; 32.6 ;11;28;15;0;11;1;10;10;1;0;0;11
22467; 53.8 ; 107.6 ; 7.8 ;2;9;180;0;2;1;1;2;0;0;1;1
22468; 68.9 ; 275.4 ; 41.3 ;4;15;3;0;4;3;1;2;2;1;0;3
22469; 15.0 ; 59.9 ; -   ;4;32;68;0;4;2;2;2;2;4;0;0
22470; 49.6 ; 99.3 ; 4.3 ;2;207;105;0;2;0;2;0;2;0;2;0
22471; 36.0 ; 107.9 ; 5.2 ;3;56;10;0;3;0;3;2;1;0;3;0
22472; 77.3 ; 154.5 ; 45.7 ;2;20;299;0;2;0;2;0;2;0;0;2
22473; 29.9 ; 239.4 ; 10.0 ;8;32;47;0;8;2;6;4;4;5;3;0
22474; 35.4 ; 389.3 ; 16.5 ;11;33;9;0;11;7;4;6;5;4;7;0
22475; 22.6 ; 113.1 ; 2.7 ;5;32;54;0;5;3;2;3;2;5;0;0
22476; 32.4 ; 129.4 ; 13.2 ;4;101;24;0;4;3;1;2;2;1;3;0
22477; 49.6 ; 595.7 ; 22.9 ;12;22;0;0;12;4;8;9;3;4;4;4
22478; 37.3 ; 149.3 ; 13.9 ;4;106;6;0;4;0;4;2;2;1;3;0
22479; 46.8 ; 93.5 ; -   ;2;57;131;1;1;0;2;2;0;0;2;0
22480; 55.0 ; 109.9 ; 11.2 ;2;14;83;0;2;1;1;0;2;0;1;1
22481; 16.4 ; 114.7 ; 1.7 ;7;12;254;0;7;2;5;4;3;7;0;0
22482; 48.6 ; 242.8 ; 4.3 ;5;27;119;0;5;3;2;3;2;0;5;0
22483; 27.0 ; 135.1 ; 12.3 ;5;3;248;0;5;4;1;2;3;3;2;0
22484; 15.0 ; 30.0 ; -   ;2;58;223;1;1;2;0;0;2;2;0;0
22485; 24.8 ; 99.0 ; 6.6 ;4;94;69;0;4;3;1;2;2;3;1;0
22486; 77.0 ; 385.1 ; 27.0 ;5;44;5;0;5;1;4;2;3;0;0;5
22487; 21.3 ; 192.0 ; 5.2 ;9;36;14;1;8;7;2;2;7;9;0;0
22488; 21.3 ; 63.8 ; 8.4 ;3;50;66;0;3;1;2;2;1;3;0;0
22489; 17.3 ; 189.8 ; 4.9 ;11;5;1;0;11;7;4;5;6;11;0;0
22490; 25.4 ; 127.1 ; 10.1 ;5;57;2;0;5;3;2;2;3;3;2;0
22491; 29.4 ; 176.5 ; 13.4 ;6;70;38;0;6;3;3;3;3;4;2;0
22492; 15.7 ; 78.5 ; 1.7 ;5;37;170;0;5;2;3;1;4;5;0;0
22493; 20.7 ; 290.4 ; 3.3 ;14;10;5;0;14;9;5;2;12;14;0;0
22494; 48.7 ; 97.4 ; -   ;2;53;221;0;2;1;1;0;2;0;2;0
22495; 78.6 ; 157.3 ; 38.8 ;2;264;125;0;2;0;2;2;0;0;0;2
22496; 58.6 ; 762.0 ; 40.8 ;13;28;5;0;13;3;10;11;2;4;0;9
22497; 15.0 ; 45.0 ; -   ;3;17;269;0;3;3;0;3;0;3;0;0
22498; 20.0 ; 40.1 ; 7.6 ;2;86;29;2;0;2;0;0;2;2;0;0
22499; 15.0 ; 30.0 ; -   ;2;7;161;0;2;2;0;1;1;2;0;0
22500; 54.5 ; 109.1 ; 13.7 ;2;217;5;0;2;1;1;2;0;0;1;1
22501; 20.9 ; 104.5 ; 8.6 ;5;46;1;0;5;3;2;1;4;5;0;0
22502; 47.5 ; 189.8 ; 1.5 ;4;100;140;0;4;3;1;2;2;0;4;0
22503; 27.8 ; 111.0 ; 5.7 ;4;79;74;0;4;1;3;2;2;3;1;0
22504; 21.2 ; 63.7 ; 6.4 ;3;1;75;0;3;3;0;3;0;3;0;0
22505; 54.2 ; 108.4 ; 19.9 ;2;257;74;0;2;0;2;1;1;0;1;1
22506; 37.5 ; 224.9 ; 2.5 ;6;36;83;0;6;1;5;2;4;0;6;0
22507; 53.9 ; 107.8 ; 2.1 ;2;87;188;0;2;0;2;1;1;0;1;1
22508; 26.5 ; 132.5 ; 13.5 ;5;69;29;4;1;5;0;1;4;3;2;0
22509; 38.7 ; 271.0 ; 20.9 ;7;25;152;0;7;0;7;5;2;2;3;2
22510; 18.2 ; 218.9 ; 5.7 ;12;18;0;0;12;2;10;10;2;12;0;0
22511; 20.0 ; 40.1 ; 7.6 ;2;9;97;0;2;1;1;1;1;2;0;0
22512; 36.1 ; 614.3 ; 14.1 ;17;14;23;0;17;9;8;13;4;6;11;0
22513; 41.5 ; 83.0 ; 28.4 ;2;5;200;0;2;0;2;1;1;1;0;1
22514; 37.0 ; 111.0 ; 14.6 ;3;38;57;0;3;1;2;2;1;1;2;0
22515; 50.0 ; 199.9 ; 3.5 ;4;86;15;0;4;0;4;2;2;0;4;0
22516; 59.1 ; 531.9 ; 20.9 ;9;36;5;0;9;0;9;9;0;0;0;9
22517; 18.6 ; 186.1 ; 7.8 ;10;22;33;0;10;5;5;5;5;10;0;0
22518; 46.8 ; 608.5 ; 20.0 ;13;31;58;0;13;5;8;7;6;4;5;4
22519; 31.6 ; 94.7 ; 11.9 ;3;58;176;0;3;2;1;3;0;1;2;0
22520; 37.0 ; 74.0 ; 3.5 ;2;94;205;0;2;0;2;1;1;0;2;0
22521; 51.0 ; 306.3 ; 23.0 ;6;24;10;0;6;1;5;3;3;2;2;2
22522; 42.1 ; 210.5 ; 19.7 ;5;38;26;0;5;2;3;2;3;2;1;2
22523; 26.6 ; 133.2 ; 12.3 ;5;2;260;0;5;3;2;0;5;3;2;0
22524; 22.9 ; 481.8 ; 14.8 ;21;5;61;0;21;12;9;15;6;14;7;0
22525; 35.6 ; 71.1 ; 8.0 ;2;5;227;0;2;2;0;0;2;1;1;0
22526; 39.1 ; 586.1 ; 15.8 ;15;18;11;0;15;1;14;10;5;5;10;0
22527; 50.9 ; 305.5 ; 9.8 ;6;32;12;0;6;2;4;1;5;0;4;2
22528; 59.6 ; 119.3 ; 61.5 ;2;94;111;2;0;0;2;1;1;1;0;1
22529; 45.2 ; 90.3 ; 3.5 ;2;143;49;1;1;1;1;0;2;0;2;0
22530; 21.8 ; 87.2 ; 5.3 ;4;60;71;0;4;3;1;1;3;4;0;0
22531; 30.2 ; 60.4 ; -   ;2;69;210;0;2;0;2;2;0;0;2;0
22532; 20.5 ; 184.1 ; 10.7 ;9;32;23;0;9;9;0;8;1;6;3;0
22533; 24.3 ; 72.8 ; 17.0 ;3;5;268;0;3;1;2;3;0;2;1;0
22534; 68.4 ; 205.3 ; 12.0 ;3;89;89;0;3;2;1;2;1;0;0;3
22535; 20.0 ; 40.1 ; 7.6 ;2;53;248;0;2;1;1;1;1;2;0;0
22536; 49.4 ; 246.9 ; 9.6 ;5;100;15;0;5;1;4;5;0;0;3;2
22537; 43.0 ; 172.1 ; 26.0 ;4;15;41;0;4;2;2;3;1;1;2;1
22538; 54.9 ; 274.7 ; 8.2 ;5;32;5;0;5;1;4;2;3;0;3;2
22539; 21.9 ; 131.6 ; 9.1 ;6;13;232;0;6;0;6;3;3;4;2;0
22540; 74.9 ; 149.8 ; 25.1 ;2;74;5;0;2;0;2;2;0;0;0;2
22541; 17.1 ; 85.6 ; 1.7 ;5;28;8;0;5;1;4;3;2;5;0;0
22542; 17.7 ; 159.3 ; 1.0 ;9;5;78;0;9;4;5;4;5;9;0;0
22543; 86.4 ; 432.1 ; 43.2 ;5;38;38;5;0;3;2;2;3;0;0;5
22544; 17.9 ; 286.0 ; 8.1 ;16;19;5;0;16;0;16;11;5;16;0;0
22545; 27.2 ; 544.9 ; 14.3 ;20;15;26;0;20;11;9;14;6;13;7;0
22546; 31.4 ; 846.9 ; 11.4 ;27;12;2;0;27;17;10;4;23;9;18;0
22547; 46.5 ; 279.2 ; 28.6 ;6;18;173;0;6;0;6;1;5;2;2;2
22548; 15.0 ; 30.0 ; -   ;2;5;38;0;2;0;2;0;2;2;0;0
22549; 18.1 ; 54.3 ; 2.9 ;3;26;354;0;3;1;2;3;0;3;0;0
22550; 17.0 ; 85.0 ; 4.8 ;5;45;45;0;5;1;4;3;2;5;0;0
22551; 17.7 ; 70.7 ; 1.9 ;4;47;155;0;4;2;2;4;0;4;0;0
22552; 41.1 ; 82.2 ; 0.3 ;2;126;141;0;2;0;2;2;0;0;2;0
22553; 36.3 ; 72.5 ; 16.8 ;2;83;30;0;2;1;1;1;1;1;1;0
22554; 31.6 ; 315.9 ; 11.1 ;10;28;7;0;10;6;4;3;7;3;7;0
22555; 18.4 ; 184.2 ; 4.8 ;10;3;115;1;9;5;5;3;7;10;0;0
22556; 48.2 ; 96.3 ; 2.1 ;2;31;236;0;2;0;2;0;2;0;2;0
22557; 51.0 ; 102.0 ; 15.7 ;2;5;196;0;2;1;1;0;2;0;1;1
22558; 35.9 ; 179.6 ; 13.7 ;5;79;14;0;5;1;4;3;2;2;3;0
22559; 62.4 ; 187.3 ; 25.0 ;3;40;197;0;3;1;2;0;3;0;0;3
22560; 34.3 ; 171.7 ; 18.7 ;5;55;37;0;5;3;2;5;0;2;3;0
22561; 15.4 ; 123.1 ; 1.3 ;8;15;263;0;8;5;3;2;6;8;0;0
22562; 65.6 ; 196.7 ; 21.2 ;3;14;69;0;3;1;2;1;2;0;0;3
22563; 40.0 ; 119.9 ; 6.2 ;3;155;20;0;3;0;3;3;0;0;3;0
22564; 66.6 ; 133.1 ; 16.5 ;2;3;267;0;2;1;1;1;1;0;0;2
22565; 40.5 ; 324.4 ; 11.4 ;8;29;43;0;8;3;5;3;5;3;5;0
22566; 37.2 ; 223.0 ; 17.3 ;6;51;15;0;6;2;4;4;2;2;4;0
22567; 70.0 ; 909.6 ; 55.8 ;13;24;11;0;13;11;2;11;2;4;0;9
22568; 30.1 ; 633.1 ; 15.1 ;21;18;9;0;21;9;12;7;14;7;14;0
22569; 48.1 ; 288.5 ; 6.1 ;6;22;162;1;5;0;6;6;0;0;6;0
22570; 59.0 ; 531.2 ; 18.4 ;9;39;10;0;9;0;9;9;0;0;0;9
22571; 47.3 ; 94.6 ; 0.8 ;2;1;259;0;2;2;0;1;1;0;2;0
22572; 24.5 ; 514.1 ; 15.2 ;21;15;0;0;21;4;17;11;10;14;7;0
22573; 51.1 ; 255.6 ; 12.0 ;5;20;125;0;5;3;2;3;2;0;3;2
22574; 36.1 ; 830.7 ; 15.8 ;23;15;28;0;23;9;14;12;11;8;15;0
22575; 51.1 ; 153.2 ; 2.6 ;3;72;5;1;2;0;3;2;1;0;3;0
22576; 27.4 ; 328.6 ; 10.9 ;12;36;5;0;12;0;12;12;0;8;4;0
22577; 90.1 ; 450.7 ; 54.6 ;5;31;41;5;0;5;0;1;4;0;0;5
22578; 38.5 ; 76.9 ; 12.4 ;2;74;185;0;2;1;1;1;1;1;1;0
22579; 46.8 ; 93.5 ; -   ;2;4;155;0;2;1;1;0;2;0;2;0
22580; 37.0 ; 185.0 ; 15.7 ;5;22;152;0;5;3;2;1;4;2;3;0
22581; 26.7 ; 80.1 ; 7.4 ;3;122;185;0;3;0;3;0;3;2;1;0
22582; 61.9 ; 247.8 ; 15.0 ;4;59;22;0;4;2;2;4;0;0;0;4
22583; 49.6 ; 297.8 ; 29.5 ;6;14;47;0;6;1;5;4;2;2;2;2
22584; 55.9 ; 111.7 ; 16.0 ;2;2;291;0;2;1;1;1;1;0;0;2
22585; 15.0 ; 45.0 ; -   ;3;67;105;0;3;0;3;2;1;3;0;0
22586; 50.4 ; 402.8 ; 25.7 ;8;29;6;0;8;2;6;3;5;3;2;3
22587; 43.7 ; 743.5 ; 22.5 ;17;13;9;0;17;8;9;5;12;6;5;6
22588; 51.8 ; 621.3 ; 11.4 ;12;27;131;0;12;0;12;9;3;0;8;4
22589; 24.0 ; 95.8 ; 8.6 ;4;2;10;4;0;1;3;4;0;3;1;0
22590; 29.8 ; 119.3 ; -   ;4;6;249;0;4;3;1;4;0;4;0;0
22591; 56.4 ; 112.9 ; 0.5 ;2;94;116;0;2;0;2;2;0;0;0;2
22592; 39.7 ; 79.5 ; 17.7 ;2;18;182;0;2;2;0;0;2;1;0;1
22593; 29.8 ; 238.3 ; 13.1 ;8;35;69;1;7;3;5;2;6;5;3;0
22594; 26.2 ; 236.0 ; 12.9 ;9;30;15;0;9;1;8;7;2;6;3;0
22595; 39.5 ; 197.7 ; 13.3 ;5;19;11;0;5;0;5;4;1;2;3;0
22596; 26.0 ; 104.2 ; 14.9 ;4;41;5;0;4;2;2;1;3;3;1;0
22597; 79.5 ; 397.3 ; 4.7 ;5;52;78;0;5;0;5;1;4;0;0;5
22598; 35.5 ; 71.0 ; 24.1 ;2;74;189;0;2;1;1;0;2;1;0;1
22599; 28.4 ; 85.1 ; 5.4 ;3;35;7;1;2;3;0;1;2;2;1;0
22600; 55.6 ; 166.8 ; 15.6 ;3;29;58;0;3;0;3;1;2;0;0;3
22601; 35.8 ; 107.3 ; 20.0 ;3;38;199;0;3;1;2;2;1;1;1;1
22602; 25.4 ; 50.9 ; 0.5 ;2;5;83;0;2;2;0;2;0;2;0;0
22603; 27.2 ; 54.4 ; 3.2 ;2;17;26;0;2;1;1;2;0;1;1;0
22604; 54.5 ; 217.9 ; 35.9 ;4;5;252;0;4;0;4;2;2;1;2;1
22605; 47.2 ; 2,217.2 ; 18.7 ;47;10;17;0;47;6;41;12;35;16;15;16
22606; 64.1 ; 192.3 ; 11.4 ;3;126;10;2;1;1;2;3;0;0;0;3
22607; 78.0 ; 312.1 ; 34.7 ;4;107;131;0;4;2;2;2;2;0;0;4
22608; 47.0 ; 141.0 ; 0.4 ;3;84;28;0;3;2;1;1;2;0;3;0
22609; 41.9 ; 209.3 ; 10.2 ;5;63;48;0;5;1;4;3;2;0;5;0
22610; 40.9 ; 163.7 ; 18.4 ;4;11;147;0;4;1;3;4;0;1;2;1
22611; 48.2 ; 96.5 ; 2.6 ;2;66;161;0;2;2;0;2;0;0;2;0
22612; 45.4 ; 90.8 ; 21.2 ;2;232;27;0;2;0;2;1;1;1;0;1
22613; 58.3 ; 174.9 ; 39.1 ;3;85;131;0;3;1;2;1;2;1;0;2
22614; 53.8 ; 376.3 ; 32.7 ;7;41;10;1;6;1;6;5;2;2;3;2
22615; 47.0 ; 141.0 ; 0.4 ;3;56;47;3;0;0;3;3;0;0;3;0
22616; 46.8 ; 93.5 ; -   ;2;6;189;0;2;0;2;2;0;0;2;0
22617; 29.0 ; 145.2 ; 12.0 ;5;25;8;0;5;3;2;3;2;3;2;0
22618; 30.9 ; 154.7 ; 15.1 ;5;34;5;0;5;1;4;2;3;2;3;0
22619; 18.3 ; 55.0 ; 6.2 ;3;10;71;0;3;3;0;2;1;3;0;0
22620; 31.5 ; 504.2 ; 18.3 ;16;18;1;0;16;1;15;4;12;5;11;0
22621; 32.3 ; 64.5 ; 21.7 ;2;5;194;0;2;1;1;2;0;1;1;0
22622; 39.2 ; 274.2 ; 17.9 ;7;27;9;7;0;6;1;1;6;2;3;2
22623; 36.9 ; 110.6 ; 7.4 ;3;45;182;0;3;1;2;1;2;1;2;0
22624; 43.6 ; 87.2 ; 11.1 ;2;11;143;0;2;0;2;2;0;0;2;0
22625; 94.3 ; 282.8 ; 14.1 ;3;50;183;0;3;0;3;3;0;0;0;3
22626; 37.0 ; 110.9 ; 10.3 ;3;50;236;0;3;1;2;0;3;1;2;0
22627; 22.7 ; 45.3 ; 6.6 ;2;12;9;0;2;2;0;0;2;2;0;0
22628; 40.9 ; 122.6 ; 26.3 ;3;5;90;0;3;1;2;1;2;1;1;1
22629; 38.8 ; 77.7 ; 12.9 ;2;93;96;0;2;1;1;1;1;1;1;0
22630; 20.3 ; 101.4 ; 3.1 ;5;55;85;0;5;3;2;2;3;5;0;0
22631; 69.6 ; 348.1 ; 41.0 ;5;14;9;0;5;4;1;3;2;2;0;3
22632; 31.2 ; 124.9 ; 19.9 ;4;28;35;0;4;2;2;2;2;1;3;0
22633; 18.4 ; 92.1 ; 3.1 ;5;23;68;0;5;0;5;1;4;5;0;0
22634; 56.3 ; 168.9 ; 43.8 ;3;5;336;0;3;2;1;3;0;1;0;2
22635; 17.3 ; 86.7 ; 1.9 ;5;65;10;0;5;0;5;5;0;5;0;0
22636; 23.1 ; 115.3 ; 4.8 ;5;34;11;0;5;0;5;2;3;5;0;0
22637; 18.6 ; 37.2 ; 1.2 ;2;228;37;0;2;0;2;2;0;2;0;0
22638; 42.4 ; 84.8 ; 9.4 ;2;16;113;0;2;1;1;1;1;0;2;0
22639; 84.0 ; 252.0 ; 97.1 ;3;101;93;1;2;1;2;3;0;1;0;2
22640; 20.8 ; 62.4 ; 5.3 ;3;94;45;0;3;3;0;1;2;3;0;0
22641; 55.1 ; 440.7 ; 13.3 ;8;30;11;8;0;1;7;5;3;0;0;8
22642; 56.6 ; 113.2 ; 29.9 ;2;19;110;0;2;0;2;2;0;1;0;1
22643; 42.1 ; 252.6 ; 13.8 ;6;78;5;0;6;1;5;4;2;2;2;2
22644; 31.7 ; 1,015.6 ; 4.5 ;32;11;3;0;32;22;10;6;26;11;21;0
22645; 47.3 ; 567.6 ; 21.0 ;12;7;281;0;12;10;2;8;4;4;4;4
22646; 27.7 ; 138.4 ; 11.7 ;5;12;31;0;5;0;5;3;2;3;2;0
22647; 40.6 ; 325.1 ; 7.1 ;8;38;17;0;8;6;2;7;1;0;8;0
22648; 48.0 ; 623.9 ; 5.7 ;13;11;38;1;12;3;10;6;7;0;13;0
22649; 43.8 ; 87.7 ; 20.4 ;2;76;28;2;0;2;0;0;2;1;0;1
22650; 15.0 ; 30.0 ; -   ;2;43;33;0;2;1;1;2;0;2;0;0
22651; 63.5 ; 127.1 ; 44.9 ;2;7;257;0;2;1;1;1;1;1;0;1
22652; 33.8 ; 135.4 ; 19.0 ;4;4;14;0;4;4;0;3;1;1;3;0
22653; 76.1 ; 380.5 ; 47.3 ;5;44;36;0;5;0;5;1;4;2;0;3
22654; 34.0 ; 102.0 ; 12.0 ;3;54;224;0;3;2;1;2;1;1;2;0
22655; 33.1 ; 496.6 ; 15.6 ;15;21;10;0;15;3;12;8;7;5;10;0
22656; 57.4 ; 344.3 ; 30.1 ;6;14;50;6;0;5;1;1;5;2;0;4
22657; 27.0 ; 134.8 ; 21.7 ;5;2;182;0;5;4;1;3;2;3;2;0
22658; 31.6 ; 63.2 ; 2.4 ;2;4;7;0;2;1;1;2;0;1;1;0
22659; 30.2 ; 332.0 ; -   ;11;25;81;0;11;6;5;6;5;0;11;0
22660; 35.4 ; 990.3 ; 18.9 ;28;14;0;0;28;12;16;11;17;9;19;0
22661; 27.1 ; 54.2 ; 18.5 ;2;5;233;0;2;1;1;2;0;1;1;0
22662; 51.3 ; 564.5 ; 15.4 ;11;42;0;0;11;3;8;6;5;0;7;4
22663; 47.1 ; 94.2 ; 0.5 ;2;209;99;0;2;0;2;1;1;0;2;0
22664; 27.7 ; 138.4 ; 15.6 ;5;26;149;0;5;3;2;4;1;3;2;0
22665; 44.5 ; 177.9 ; 13.7 ;4;16;6;0;4;0;4;1;3;0;3;1
22666; 43.5 ; 999.6 ; 15.2 ;23;13;63;0;23;0;23;19;4;8;7;8
22667; 40.5 ; 81.0 ; 18.0 ;2;43;200;0;2;0;2;1;1;1;0;1
22668; 37.1 ; 111.4 ; 21.9 ;3;126;5;0;3;0;3;3;0;1;1;1
22669; 36.6 ; 73.2 ; -   ;2;6;5;0;2;0;2;1;1;0;2;0
22670; 36.0 ; 504.4 ; 29.5 ;14;14;30;0;14;13;1;1;13;5;4;5
22671; 21.7 ; 65.1 ; 6.2 ;3;14;212;0;3;2;1;3;0;3;0;0
22672; 38.5 ; 76.9 ; 12.4 ;2;6;204;0;2;0;2;2;0;1;1;0
22673; 36.2 ; 579.6 ; 11.3 ;16;19;5;0;16;2;14;14;2;5;11;0
22674; 18.9 ; 37.9 ; -   ;2;80;143;0;2;0;2;2;0;2;0;0
22675; 22.9 ; 206.4 ; 8.9 ;9;5;227;0;9;3;6;7;2;6;3;0
22676; 24.9 ; 149.4 ; 10.2 ;6;25;30;0;6;3;3;2;4;4;2;0
22677; 64.8 ; 259.3 ; 41.8 ;4;25;151;0;4;2;2;4;0;1;0;3
22678; 15.0 ; 30.0 ; -   ;2;131;14;0;2;2;0;1;1;2;0;0
22679; 70.1 ; 911.8 ; 26.0 ;13;18;5;0;13;2;11;10;3;0;0;13
22680; 67.2 ; 134.4 ; 30.6 ;2;14;146;0;2;1;1;2;0;0;0;2
22681; 17.5 ; 122.6 ; 4.9 ;7;18;38;0;7;3;4;7;0;7;0;0
22682; 54.6 ; 218.5 ; 4.8 ;4;23;119;0;4;3;1;2;2;0;3;1
22683; 24.8 ; 173.4 ; 4.8 ;7;13;69;0;7;2;5;0;7;7;0;0
22684; 37.1 ; 74.1 ; 15.3 ;2;1;273;0;2;0;2;0;2;1;1;0
22685; 30.2 ; 60.4 ; -   ;2;25;104;0;2;0;2;0;2;0;2;0
22686; 51.7 ; 103.3 ; 15.1 ;2;19;16;0;2;0;2;1;1;0;1;1
22687; 18.8 ; 300.0 ; 9.7 ;16;26;17;0;16;7;9;7;9;16;0;0
22688; 34.9 ; 174.6 ; 6.6 ;5;72;5;3;2;0;5;4;1;2;3;0
22689; 51.8 ; 155.3 ; 2.0 ;3;4;104;3;0;1;2;2;1;0;3;0
22690; 27.2 ; 54.3 ; 10.7 ;2;63;267;0;2;0;2;1;1;1;1;0
22691; 45.8 ; 687.0 ; 4.5 ;15;5;11;0;15;3;12;3;12;0;15;0
22692; 33.4 ; 133.6 ; 16.9 ;4;118;5;0;4;2;2;3;1;1;3;0
22693; 43.1 ; 818.0 ; 9.0 ;19;18;0;0;19;6;13;5;14;0;19;0
22694; 31.6 ; 94.9 ; 1.4 ;3;26;173;0;3;2;1;1;2;0;3;0
22695; 24.2 ; 508.2 ; 10.5 ;21;11;11;0;21;10;11;9;12;14;7;0
22696; 85.6 ; 770.7 ; 32.5 ;9;47;19;0;9;1;8;3;6;0;0;9
22697; 47.4 ; 331.6 ; 15.4 ;7;32;86;0;7;1;6;1;6;0;5;2
22698; 18.4 ; 73.4 ; 1.8 ;4;90;170;0;4;3;1;4;0;4;0;0
22699; 56.2 ; 168.5 ; 33.6 ;3;44;168;0;3;1;2;3;0;1;0;2
22700; 19.2 ; 38.4 ; 3.2 ;2;16;162;2;0;1;1;0;2;2;0;0
22701; 37.4 ; 112.3 ; 20.6 ;3;48;119;3;0;1;2;1;2;1;1;1
22702; 25.1 ; 75.4 ; 9.3 ;3;29;141;0;3;0;3;3;0;2;1;0
22703; 40.7 ; 122.0 ; 9.9 ;3;27;160;0;3;1;2;2;1;0;3;0
22704; 35.8 ; 286.3 ; 14.3 ;8;22;21;0;8;0;8;8;0;3;5;0
22705; 15.0 ; 30.0 ; -   ;2;52;84;0;2;1;1;1;1;2;0;0
22706; 124.1 ; 248.2 ; 111.9 ;2;44;188;0;2;0;2;1;1;1;0;1
22707; 103.0 ; 1,750.6 ; 52.2 ;17;16;5;0;17;1;16;9;8;0;0;17
22708; 36.9 ; 73.8 ; 17.7 ;2;16;270;0;2;1;1;0;2;1;1;0
22709; 17.3 ; 34.7 ; 3.5 ;2;54;61;0;2;2;0;0;2;2;0;0
22710; 73.5 ; 367.3 ; 17.3 ;5;48;22;5;0;0;5;3;2;0;0;5
22711; 122.4 ; 489.7 ; 19.5 ;4;1;248;0;4;2;2;2;2;0;0;4
22712; 44.7 ; 134.0 ; 7.4 ;3;32;314;0;3;0;3;1;2;0;3;0
22713; 94.4 ; 377.5 ; 30.7 ;4;65;68;0;4;0;4;4;0;0;0;4
22714; 16.5 ; 231.0 ; 2.3 ;14;13;163;2;12;2;12;10;4;14;0;0
22715; 40.3 ; 80.7 ; 26.2 ;2;2;255;0;2;1;1;1;1;1;0;1
22716; 17.9 ; 107.5 ; 3.2 ;6;32;54;0;6;5;1;1;5;6;0;0
22717; 27.3 ; 54.7 ; 11.5 ;2;19;278;0;2;0;2;1;1;1;1;0
22718; 22.5 ; 179.7 ; 4.8 ;8;16;20;0;8;2;6;3;5;8;0;0
22719; 32.8 ; 393.4 ; 19.3 ;12;22;167;0;12;10;2;11;1;4;8;0
22720; 30.0 ; 149.8 ; 10.3 ;5;21;103;4;1;2;3;2;3;3;2;0
22721; 48.9 ; 97.8 ; 2.1 ;2;5;41;0;2;0;2;2;0;0;2;0
22722; 99.3 ; 397.4 ; 9.4 ;4;23;59;0;4;2;2;4;0;0;0;4
22723; 15.5 ; 247.4 ; 1.2 ;16;18;4;0;16;5;11;14;2;16;0;0
22724; 22.2 ; 111.2 ; 10.8 ;5;21;254;0;5;3;2;2;3;3;2;0
22725; 28.3 ; 367.5 ; 7.5 ;13;35;3;0;13;6;7;4;9;9;4;0
22726; 70.9 ; 141.8 ; 36.1 ;2;79;161;0;2;2;0;1;1;0;0;2
22727; 42.9 ; 128.6 ; 16.5 ;3;88;2;1;2;2;1;1;2;1;1;1
22728; 70.2 ; 772.2 ; 19.6 ;11;25;53;0;11;0;11;10;1;0;0;11
22729; 47.0 ; 1,362.9 ; 0.5 ;29;10;10;0;29;0;29;28;1;0;29;0
22730; 27.5 ; 55.0 ; 3.7 ;2;38;32;0;2;0;2;0;2;1;1;0
22731; 38.6 ; 77.3 ; 20.3 ;2;32;79;0;2;0;2;1;1;1;0;1
22732; 32.9 ; 131.5 ; 10.9 ;4;97;83;0;4;2;2;3;1;1;3;0
22733; 21.0 ; 84.0 ; 4.6 ;4;16;210;0;4;2;2;2;2;4;0;0
22734; 19.4 ; 116.5 ; 7.3 ;6;33;93;0;6;4;2;2;4;6;0;0
22735; 46.8 ; 93.7 ; 32.6 ;2;112;17;0;2;0;2;1;1;1;0;1
22736; 20.6 ; 102.9 ; 5.9 ;5;18;44;0;5;4;1;5;0;5;0;0
22737; 15.0 ; 59.9 ; -   ;4;27;104;0;4;3;1;3;1;4;0;0
22738; 20.1 ; 201.1 ; 8.1 ;10;36;48;0;10;1;9;2;8;10;0;0
22739; 45.5 ; 273.2 ; 2.4 ;6;70;47;0;6;0;6;4;2;0;6;0
22740; 34.8 ; 104.4 ; 27.6 ;3;61;10;0;3;1;2;1;2;1;1;1
22741; 49.5 ; 99.0 ; 4.5 ;2;150;273;0;2;0;2;1;1;0;2;0
22742; 53.9 ; 323.2 ; 11.2 ;6;38;58;0;6;1;5;3;3;0;4;2
22743; 43.7 ; 480.3 ; 11.3 ;11;30;22;0;11;2;9;8;3;0;11;0
22744; 20.0 ; 40.1 ; 7.6 ;2;13;116;0;2;0;2;1;1;2;0;0
22745; 31.2 ; 93.7 ; 11.3 ;3;43;17;3;0;2;1;1;2;1;2;0
22746; 18.1 ; 90.5 ; 1.9 ;5;25;243;0;5;5;0;5;0;5;0;0
22747; 26.0 ; 130.1 ; 13.1 ;5;82;37;0;5;2;3;2;3;3;2;0
22748; 20.0 ; 40.1 ; 7.6 ;2;57;227;0;2;1;1;1;1;2;0;0
22749; 48.0 ; 239.9 ; 1.2 ;5;67;36;0;5;1;4;4;1;0;5;0
22750; 28.7 ; 143.4 ; 4.2 ;5;56;10;0;5;0;5;3;2;3;2;0
22751; 35.9 ; 71.8 ; 16.2 ;2;33;184;0;2;1;1;1;1;1;1;0
22752; 39.4 ; 78.9 ; 13.9 ;2;13;157;0;2;0;2;1;1;1;1;0
22753; 15.0 ; 30.0 ; -   ;2;6;315;0;2;0;2;2;0;2;0;0
22754; 30.0 ; 119.9 ; 4.1 ;4;14;278;0;4;1;3;1;3;3;1;0
22755; 42.6 ; 595.7 ; 9.8 ;14;33;2;0;14;9;5;7;7;0;14;0
22756; 37.2 ; 74.5 ; 9.5 ;2;62;20;0;2;0;2;0;2;1;1;0
22757; 29.0 ; 348.3 ; 17.0 ;12;28;2;0;12;7;5;8;4;8;4;0
22758; 58.6 ; 117.1 ; 9.1 ;2;41;154;0;2;2;0;2;0;0;0;2
22759; 46.1 ; 138.3 ; 17.9 ;3;59;99;0;3;0;3;2;1;1;1;1
22760; 35.0 ; 736.0 ; 11.4 ;21;14;5;0;21;0;21;19;2;7;14;0
22761; 15.0 ; 59.9 ; -   ;4;107;99;0;4;1;3;1;3;4;0;0
22762; 58.8 ; 1,057.7 ; 16.7 ;18;18;115;0;18;14;4;18;0;0;0;18
22763; 32.7 ; 98.2 ; 14.9 ;3;83;66;0;3;1;2;3;0;1;2;0
22764; 51.2 ; 204.9 ; 8.0 ;4;113;0;0;4;0;4;3;1;0;3;1
22765; 67.1 ; 335.5 ; 13.5 ;5;35;42;0;5;0;5;3;2;0;0;5
22766; 24.4 ; 268.5 ; 7.5 ;11;18;3;0;11;8;3;7;4;7;4;0
22767; 27.0 ; 242.9 ; 16.5 ;9;32;21;0;9;3;6;2;7;6;3;0
22768; 90.7 ; 181.4 ; 57.2 ;2;29;332;0;2;0;2;2;0;0;0;2
22769; 64.2 ; 513.7 ; 14.6 ;8;25;56;0;8;3;5;1;7;0;0;8
22770; 68.4 ; 205.1 ; 26.7 ;3;101;158;0;3;1;2;1;2;0;0;3
22771; 61.0 ; 122.0 ; 36.5 ;2;394;42;0;2;1;1;1;1;1;0;1
22772; 62.8 ; 314.1 ; 28.4 ;5;102;16;0;5;1;4;2;3;0;0;5
22773; 34.3 ; 103.0 ; 11.8 ;3;38;206;0;3;0;3;1;2;1;2;0
22774; 34.2 ; 170.9 ; 4.0 ;5;13;26;0;5;0;5;2;3;0;5;0
22775; 23.6 ; 118.2 ; 8.5 ;5;9;230;0;5;2;3;1;4;3;2;0
22776; 47.5 ; 94.9 ; -   ;2;3;59;2;0;1;1;2;0;0;2;0
22777; 55.3 ; 110.7 ; 12.8 ;2;13;262;0;2;0;2;2;0;0;0;2
22778; 20.9 ; 229.9 ; 7.6 ;11;29;1;0;11;1;10;6;5;11;0;0
22779; 40.3 ; 805.8 ; 16.8 ;20;15;99;0;20;0;20;12;8;7;6;7
22780; 19.4 ; 135.9 ; 7.0 ;7;47;9;0;7;4;3;3;4;7;0;0
22781; 37.8 ; 264.9 ; 6.8 ;7;12;1;0;7;1;6;2;5;0;7;0
22782; 36.6 ; 73.2 ; -   ;2;5;129;0;2;2;0;0;2;0;2;0
22783; 74.2 ; 148.3 ; 30.3 ;2;11;21;0;2;0;2;2;0;0;0;2
22784; 31.6 ; 158.1 ; 8.5 ;5;92;11;0;5;0;5;1;4;2;3;0
22785; 18.0 ; 143.9 ; 3.6 ;8;23;104;0;8;5;3;3;5;8;0;0
22786; 51.9 ; 103.9 ; 1.4 ;2;11;170;0;2;1;1;1;1;0;2;0
22787; 23.4 ; 585.2 ; 22.8 ;25;12;10;0;25;0;25;5;20;17;8;0
22788; 24.3 ; 48.6 ; 2.7 ;2;77;124;1;1;2;0;1;1;2;0;0
22789; 27.1 ; 162.4 ; 16.7 ;6;25;15;0;6;0;6;5;1;4;2;0
22790; 20.7 ; 103.7 ; -   ;5;29;64;0;5;2;3;4;1;5;0;0
22791; 41.9 ; 125.7 ; 15.4 ;3;25;31;3;0;1;2;2;1;1;1;1
22792; 35.9 ; 71.8 ; 16.2 ;2;64;284;0;2;1;1;2;0;1;1;0
22793; 34.9 ; 69.9 ; 14.8 ;2;257;85;0;2;0;2;0;2;1;1;0
22794; 41.3 ; 82.6 ; 24.3 ;2;25;73;0;2;0;2;1;1;1;0;1
22795; 24.6 ; 590.4 ; 5.3 ;24;9;2;0;24;9;15;13;11;24;0;0
22796; 36.9 ; 73.8 ; 17.7 ;2;7;337;0;2;1;1;0;2;1;1;0
22797; 39.5 ; 118.6 ; 13.3 ;3;135;53;0;3;0;3;2;1;1;2;0
22798; 61.1 ; 183.2 ; 7.8 ;3;29;215;0;3;0;3;2;1;0;0;3
22799; 15.0 ; 45.0 ; -   ;3;49;43;0;3;2;1;1;2;3;0;0
22800; 56.4 ; 169.3 ; 10.6 ;3;29;307;0;3;2;1;0;3;0;0;3
22801; 26.8 ; 53.7 ; 10.7 ;2;14;275;0;2;2;0;0;2;1;1;0
22802; 56.8 ; 113.5 ; -   ;2;6;292;0;2;2;0;0;2;0;0;2
22803; 20.0 ; 40.1 ; 7.6 ;2;5;158;0;2;0;2;1;1;2;0;0
22804; 46.8 ; 93.5 ; -   ;2;34;129;1;1;1;1;2;0;0;2;0
22805; 76.0 ; 152.0 ; 28.4 ;2;77;90;0;2;1;1;1;1;0;0;2
22806; 38.6 ; 154.6 ; 11.7 ;4;67;80;0;4;1;3;4;0;1;3;0
22807; 25.1 ; 50.1 ; -   ;2;32;32;0;2;0;2;2;0;2;0;0
22808; 28.6 ; 57.2 ; 20.4 ;2;95;14;0;2;1;1;2;0;1;1;0
22809; 48.0 ; 239.9 ; 10.1 ;5;52;5;0;5;0;5;3;2;0;3;2
22810; 46.3 ; 277.6 ; 10.2 ;6;13;248;0;6;4;2;5;1;0;4;2
22811; 49.6 ; 247.8 ; 21.5 ;5;15;149;0;5;4;1;3;2;2;1;2
22812; 42.8 ; 128.3 ; 10.0 ;3;4;6;0;3;0;3;0;3;0;3;0
22813; 65.5 ; 196.4 ; 26.2 ;3;69;110;0;3;0;3;1;2;0;0;3
22814; 59.2 ; 296.1 ; 24.5 ;5;79;32;1;4;2;3;4;1;0;0;5
22815; 46.8 ; 93.5 ; -   ;2;3;259;0;2;2;0;1;1;0;2;0
22816; 46.2 ; 92.4 ; 1.9 ;2;35;63;0;2;1;1;2;0;0;2;0
22817; 18.3 ; 55.0 ; 6.2 ;3;16;167;0;3;1;2;2;1;3;0;0
22818; 77.2 ; 1,004.1 ; 11.9 ;13;24;12;0;13;1;12;13;0;0;0;13
22819; 78.4 ; 235.2 ; 13.1 ;3;25;192;0;3;3;0;0;3;0;0;3
22820; 59.1 ; 118.3 ; 3.9 ;2;22;246;0;2;1;1;1;1;0;0;2
22821; 70.9 ; 212.7 ; 65.8 ;3;92;16;0;3;0;3;1;2;1;0;2
22822; 36.6 ; 146.4 ; -   ;4;4;286;0;4;2;2;0;4;0;4;0
22823; 23.3 ; 93.1 ; 6.7 ;4;4;22;0;4;0;4;2;2;4;0;0
22824; 19.7 ; 78.9 ; 8.2 ;4;37;99;0;4;3;1;4;0;4;0;0
22825; 46.0 ; 367.8 ; 9.3 ;8;22;39;0;8;3;5;4;4;0;5;3
22826; 47.3 ; 473.5 ; 19.2 ;10;16;3;0;10;2;8;4;6;3;4;3
22827; 47.5 ; 94.9 ; -   ;2;63;43;0;2;1;1;0;2;0;2;0
22828; 20.7 ; 41.5 ; -   ;2;7;247;0;2;1;1;0;2;2;0;0
22829; 32.4 ; 64.8 ; 6.1 ;2;2;2;0;2;2;0;1;1;1;1;0
22830; 47.3 ; 94.7 ; -   ;2;13;36;0;2;0;2;2;0;0;2;0
22831; 30.2 ; 90.6 ; 15.4 ;3;97;63;0;3;1;2;0;3;1;2;0
22832; 50.6 ; 910.4 ; 22.2 ;18;18;5;0;18;3;15;8;10;6;6;6
22833; 22.6 ; 90.2 ; 5.3 ;4;38;179;0;4;0;4;3;1;4;0;0
22834; 50.1 ; 100.2 ; 23.5 ;2;12;105;2;0;0;2;2;0;1;0;1
22835; 53.8 ; 430.5 ; 24.3 ;8;39;5;0;8;0;8;6;2;3;2;3
22836; 15.2 ; 682.8 ; 1.0 ;45;6;11;0;45;26;19;17;28;45;0;0
22837; 23.5 ; 46.9 ; 5.7 ;2;5;7;0;2;1;1;1;1;2;0;0
22838; 34.9 ; 313.9 ; 7.7 ;9;22;0;0;9;2;7;5;4;3;6;0
22839; 20.3 ; 81.1 ; 4.8 ;4;16;131;0;4;3;1;0;4;4;0;0
22840; 22.2 ; 44.3 ; 4.4 ;2;217;59;0;2;1;1;2;0;2;0;0
22841; 59.9 ; 179.8 ; 42.0 ;3;5;89;0;3;2;1;2;1;1;0;2
22842; 50.4 ; 151.3 ; 29.2 ;3;76;223;0;3;3;0;3;0;1;1;1
22843; 54.6 ; 272.8 ; 12.9 ;5;76;15;1;4;1;4;4;1;0;3;2
22844; 40.8 ; 367.1 ; 15.5 ;9;21;200;0;9;6;3;8;1;3;3;3
22845; 48.2 ; 240.9 ; 1.3 ;5;27;2;0;5;4;1;5;0;0;5;0
22846; 25.4 ; 788.1 ; 12.7 ;31;9;131;0;31;10;21;28;3;21;10;0
22847; 46.1 ; 92.3 ; 4.9 ;2;183;241;0;2;0;2;0;2;0;2;0
22848; 26.1 ; 52.3 ; -   ;2;41;117;0;2;1;1;1;1;2;0;0
22849; 52.1 ; 156.3 ; 5.5 ;3;101;73;0;3;0;3;3;0;0;2;1
22850; 15.0 ; 30.0 ; -   ;2;7;87;0;2;1;1;1;1;2;0;0
22851; 33.0 ; 461.4 ; 9.6 ;14;10;188;0;14;6;8;8;6;5;9;0
22852; 41.3 ; 330.1 ; 12.5 ;8;29;11;0;8;0;8;5;3;3;5;0
22853; 22.9 ; 91.7 ; 16.8 ;4;3;275;0;4;4;0;1;3;3;1;0
22854; 30.2 ; 90.5 ; 23.8 ;3;29;32;0;3;0;3;3;0;1;2;0
22855; 32.3 ; 96.9 ; 13.3 ;3;66;116;0;3;0;3;1;2;1;2;0
22856; 111.6 ; 223.2 ; 19.3 ;2;12;38;0;2;1;1;0;2;0;0;2
22857; 52.5 ; 105.1 ; 19.1 ;2;315;115;0;2;0;2;0;2;0;1;1
22858; 67.6 ; 135.2 ; 22.6 ;2;25;257;0;2;0;2;2;0;0;0;2
22859; 41.1 ; 82.1 ; 9.6 ;2;10;71;0;2;2;0;1;1;0;2;0
22860; 46.1 ; 184.2 ; 23.0 ;4;15;111;0;4;2;2;2;2;1;2;1
22861; 38.0 ; 114.0 ; 19.8 ;3;26;22;0;3;1;2;2;1;1;1;1
22862; 41.9 ; 209.7 ; 6.5 ;5;75;5;0;5;0;5;1;4;0;5;0
22863; 49.6 ; 148.7 ; 22.2 ;3;32;136;0;3;0;3;3;0;1;1;1
22864; 54.6 ; 109.2 ; 4.3 ;2;28;78;0;2;1;1;1;1;0;1;1
22865; 64.0 ; 128.1 ; 3.4 ;2;1;41;0;2;1;1;0;2;0;0;2
22866; 45.4 ; 226.8 ; 13.8 ;5;76;20;0;5;0;5;3;2;0;3;2
22867; 15.0 ; 30.0 ; -   ;2;23;70;0;2;1;1;2;0;2;0;0
22868; 23.7 ; 166.1 ; 12.3 ;7;38;6;0;7;5;2;5;2;5;2;0
22869; 30.9 ; 61.7 ; 23.8 ;2;95;35;1;1;1;1;2;0;1;1;0
22870; 39.1 ; 78.2 ; 14.3 ;2;2;246;0;2;1;1;1;1;1;1;0
22871; 15.4 ; 92.3 ; 1.1 ;6;41;187;0;6;3;3;4;2;6;0;0
22872; 46.3 ; 231.4 ; 9.8 ;5;59;10;1;4;0;5;2;3;0;3;2
22873; 20.6 ; 1,773.4 ; 3.0 ;86;4;25;0;86;70;16;85;1;86;0;0
22874; 19.5 ; 312.0 ; 10.4 ;16;19;15;16;0;2;14;8;8;16;0;0
22875; 31.8 ; 3,467.9 ; 12.4 ;109;3;0;0;109;42;67;35;74;36;73;0
22876; 49.3 ; 147.9 ; 5.9 ;3;5;361;0;3;1;2;2;1;0;2;1
22877; 17.1 ; 34.2 ; 3.2 ;2;77;125;0;2;0;2;1;1;2;0;0
22878; 34.1 ; 68.2 ; 23.2 ;2;110;192;0;2;1;1;1;1;1;0;1
22879; 17.3 ; 51.9 ; 3.0 ;3;160;34;2;1;1;2;1;2;3;0;0
22880; 28.4 ; 113.5 ; 2.6 ;4;61;116;0;4;2;2;1;3;3;1;0
22881; 56.7 ; 283.6 ; 24.4 ;5;59;5;0;5;0;5;3;2;0;0;5
22882; 15.0 ; 45.0 ; -   ;3;49;105;0;3;2;1;1;2;3;0;0
22883; 41.1 ; 123.4 ; 28.0 ;3;42;105;0;3;2;1;1;2;1;1;1
22884; 42.9 ; 128.6 ; 11.8 ;3;110;89;0;3;0;3;2;1;0;3;0
22885; 17.7 ; 35.4 ; 1.3 ;2;18;104;0;2;0;2;0;2;2;0;0
22886; 65.6 ; 196.9 ; 68.2 ;3;5;147;0;3;0;3;3;0;1;0;2
22887; 15.9 ; 158.5 ; 1.4 ;10;8;90;0;10;4;6;2;8;10;0;0
22888; 21.6 ; 107.9 ; 8.2 ;5;3;160;0;5;4;1;2;3;5;0;0
22889; 42.0 ; 84.1 ; 8.1 ;2;191;81;0;2;1;1;0;2;0;2;0
22890; 38.3 ; 76.5 ; 1.6 ;2;5;169;0;2;0;2;2;0;0;2;0
22891; 33.4 ; 66.8 ; 4.8 ;2;18;220;0;2;0;2;2;0;1;1;0
22892; 19.6 ; 117.3 ; 5.6 ;6;41;41;0;6;5;1;1;5;6;0;0
22893; 43.2 ; 216.1 ; 8.7 ;5;42;16;0;5;2;3;4;1;0;5;0
;;;;;;;;;;;;;;;
